date,amount,category,in_out,counterparty,balance,invoice_date,due_date
2025-02-20,8165.86,asset_sale,in,Counterparty_11,20529130.93,,
2025-02-20,25474.33,payroll,out,Counterparty_86,20503656.6,2025-02-04,2025-03-11
2025-02-20,59601.01,refund,in,Counterparty_92,20563257.61,,
2025-02-20,9519.0,customer_payment,in,Counterparty_90,20572776.61,,
2025-02-20,37402.43,asset_sale,in,Counterparty_3,20610179.04,,
2025-02-20,2123.84,credit,in,Counterparty_50,20612302.88,,
2025-02-20,11783.54,asset_sale,in,Counterparty_28,20624086.42,,
2025-02-20,2596.67,rent,out,Counterparty_86,20621489.75,2025-02-03,2025-03-09
2025-02-20,2793.9,marketing_spend,out,Counterparty_46,20618695.85,2025-01-08,2025-02-15
2025-02-20,29837.57,utilities,out,Counterparty_15,20588858.28,2025-01-18,2025-02-15
2025-02-20,22095.14,rent,out,Counterparty_60,20566763.14,2025-01-21,2025-02-28
2025-02-20,2234.2,rent,out,Counterparty_80,20564528.94,2025-01-10,2025-02-15
2025-02-20,19267.49,credit,in,Counterparty_55,20583796.43,,
2025-02-20,14318.19,tax_payment,out,Counterparty_21,20569478.24,2025-01-25,2025-02-25
2025-02-20,9158.25,software_subscription,out,Counterparty_28,20560319.99,2025-01-15,2025-02-10
2025-02-20,667.95,tax_payment,out,Counterparty_73,20559652.04,2025-01-16,2025-02-15
2025-02-20,168.36,customer_payment,in,Counterparty_73,20559820.4,,
2025-02-20,1304.02,customer_payment,in,Counterparty_12,20561124.42,,
2025-02-20,10116.69,refund,in,Counterparty_13,20571241.11,,
2025-02-20,16606.48,customer_payment,in,Counterparty_5,20587847.59,,
2025-02-20,101710.0,utilities,out,Counterparty_7,20486137.59,2025-01-11,2025-02-16
2025-02-20,11392.51,refund,in,Counterparty_13,20497530.1,,
2025-02-20,6104.15,asset_sale,in,Counterparty_8,20503634.25,,
2025-02-20,5020.73,refund,in,Counterparty_78,20508654.98,,
2025-02-20,2254.21,customer_payment,in,Counterparty_68,20510909.19,,
2025-02-20,28102.9,payroll,out,Counterparty_28,20482806.29,2025-01-10,2025-02-14
2025-02-20,52304.1,asset_sale,in,Counterparty_16,20535110.39,,
2025-02-20,17089.91,refund,in,Counterparty_10,20552200.3,,
2025-02-20,30633.32,customer_payment,in,Counterparty_8,20582833.62,,
2025-02-20,25896.28,loan_repayment,out,Counterparty_38,20556937.34,2025-01-08,2025-02-04
2025-02-20,5336.01,utilities,out,Counterparty_29,20551601.33,2025-02-02,2025-03-11
2025-02-20,9359.31,investment_income,in,Counterparty_82,20560960.64,,
2025-02-20,24948.94,asset_sale,in,Counterparty_91,20585909.58,,
2025-02-20,5450.08,utilities,out,Counterparty_29,20580459.5,2025-01-23,2025-02-17
2025-02-21,76154.48,asset_sale,in,Counterparty_86,20656613.98,,
2025-02-21,14420.23,refund,in,Counterparty_61,20671034.21,,
2025-02-21,36246.65,customer_payment,in,Counterparty_14,20707280.86,,
2025-02-21,35801.62,marketing_spend,out,Counterparty_37,20671479.24,2025-01-25,2025-03-05
2025-02-21,3731.17,customer_payment,in,Counterparty_6,20675210.41,,
2025-02-21,36544.85,payroll,out,Counterparty_93,20638665.56,2025-01-20,2025-02-17
2025-02-21,10144.17,customer_payment,in,Counterparty_79,20648809.73,,
2025-02-21,13491.66,refund,in,Counterparty_85,20662301.39,,
2025-02-21,31118.74,supplier_payment,out,Counterparty_94,20631182.65,2025-01-20,2025-02-18
2025-02-21,32949.71,investment_income,in,Counterparty_8,20664132.36,,
2025-02-21,15486.88,customer_payment,in,Counterparty_52,20679619.24,,
2025-02-21,6702.21,refund,in,Counterparty_88,20686321.45,,
2025-02-21,18780.37,utilities,out,Counterparty_17,20667541.08,2025-01-31,2025-03-03
2025-02-21,34741.59,asset_sale,in,Counterparty_27,20702282.67,,
2025-02-21,8642.75,investment_income,in,Counterparty_87,20710925.42,,
2025-02-21,44292.02,utilities,out,Counterparty_88,20666633.4,2025-01-28,2025-02-28
2025-02-21,12622.64,customer_payment,in,Counterparty_81,20679256.04,,
2025-02-21,25166.59,customer_payment,in,Counterparty_20,20704422.63,,
2025-02-21,12770.69,customer_payment,in,Counterparty_47,20717193.32,,
2025-02-21,8465.17,refund,in,Counterparty_85,20725658.49,,
2025-02-21,6049.66,customer_payment,in,Counterparty_13,20731708.15,,
2025-02-21,602.93,customer_payment,in,Counterparty_86,20732311.08,,
2025-02-21,21976.84,customer_payment,in,Counterparty_18,20754287.92,,
2025-02-21,45928.54,customer_payment,in,Counterparty_81,20800216.46,,
2025-02-21,14247.98,customer_payment,in,Counterparty_74,20814464.44,,
2025-02-21,1654.07,payroll,out,Counterparty_48,20812810.37,2025-01-16,2025-02-23
2025-02-21,6363.96,investment_income,in,Counterparty_6,20819174.33,,
2025-02-21,24069.56,asset_sale,in,Counterparty_10,20843243.89,,
2025-02-21,6015.12,loan_repayment,out,Counterparty_98,20837228.77,2025-01-30,2025-03-10
2025-02-21,3929.7,supplier_payment,out,Counterparty_30,20833299.07,2025-01-30,2025-03-03
2025-02-21,20034.71,investment_income,in,Counterparty_52,20853333.78,,
2025-02-21,6066.28,credit,in,Counterparty_82,20859400.06,,
2025-02-21,27403.94,credit,in,Counterparty_4,20886804.0,,
2025-02-21,19370.23,loan_repayment,out,Counterparty_69,20867433.77,2025-01-23,2025-02-27
2025-02-21,15217.59,supplier_payment,out,Counterparty_81,20852216.18,2025-02-02,2025-03-13
2025-02-21,23179.24,tax_payment,out,Counterparty_9,20829036.94,2025-02-04,2025-03-02
2025-02-21,5615.01,tax_payment,out,Counterparty_51,20823421.93,2025-02-03,2025-03-06
2025-02-21,30030.73,investment_income,in,Counterparty_88,20853452.66,,
2025-02-21,1341.91,loan_repayment,out,Counterparty_81,20852110.75,2025-02-06,2025-03-17
2025-02-21,31571.13,software_subscription,out,Counterparty_13,20820539.62,2025-01-28,2025-02-24
2025-02-21,44469.74,marketing_spend,out,Counterparty_49,20776069.88,2025-01-15,2025-02-09
2025-02-21,26168.13,utilities,out,Counterparty_96,20749901.75,2025-01-08,2025-02-13
2025-02-21,10422.84,rent,out,Counterparty_25,20739478.91,2025-01-26,2025-02-22
2025-02-21,3450.51,T&E,out,Counterparty_86,20736028.4,2025-01-08,2025-02-11
2025-02-22,988.83,loan_repayment,out,Counterparty_99,20735039.57,2025-01-30,2025-03-01
2025-02-22,18832.99,rent,out,Counterparty_90,20716206.58,2025-01-17,2025-02-21
2025-02-22,2146.28,tax_payment,out,Counterparty_20,20714060.3,2025-01-18,2025-02-12
2025-02-22,11684.84,refund,in,Counterparty_95,20725745.14,,
2025-02-22,10069.66,tax_payment,out,Counterparty_22,20715675.48,2025-01-23,2025-02-23
2025-02-22,25491.53,refund,in,Counterparty_23,20741167.01,,
2025-02-22,19464.41,credit,in,Counterparty_73,20760631.42,,
2025-02-22,3038.97,T&E,out,Counterparty_18,20757592.45,2025-01-18,2025-02-21
2025-02-22,16603.43,credit,in,Counterparty_47,20774195.88,,
2025-02-22,528.98,asset_sale,in,Counterparty_90,20774724.86,,
2025-02-22,8430.04,utilities,out,Counterparty_70,20766294.82,2025-01-30,2025-03-01
2025-02-22,16856.5,supplier_payment,out,Counterparty_47,20749438.32,2025-01-12,2025-02-11
2025-02-22,16441.21,T&E,out,Counterparty_37,20732997.11,2025-01-31,2025-02-27
2025-02-22,5448.92,tax_payment,out,Counterparty_53,20727548.19,2025-01-29,2025-02-25
2025-02-22,2809.3,investment_income,in,Counterparty_25,20730357.49,,
2025-02-22,14498.24,supplier_payment,out,Counterparty_34,20715859.25,2025-01-25,2025-02-26
2025-02-22,16953.26,refund,in,Counterparty_17,20732812.51,,
2025-02-22,4997.81,refund,in,Counterparty_5,20737810.32,,
2025-02-22,40814.3,utilities,out,Counterparty_72,20696996.02,2025-02-07,2025-03-09
2025-02-22,4243.14,T&E,out,Counterparty_72,20692752.88,2025-01-30,2025-02-28
2025-02-22,17004.09,credit,in,Counterparty_70,20709756.97,,
2025-02-22,12350.72,customer_payment,in,Counterparty_11,20722107.69,,
2025-02-22,28006.27,rent,out,Counterparty_92,20694101.42,2025-01-12,2025-02-18
2025-02-22,24233.04,software_subscription,out,Counterparty_13,20669868.38,2025-01-12,2025-02-19
2025-02-22,1427.54,asset_sale,in,Counterparty_98,20671295.92,,
2025-02-22,16043.2,investment_income,in,Counterparty_11,20687339.12,,
2025-02-22,28346.59,utilities,out,Counterparty_32,20658992.53,2025-01-20,2025-02-17
2025-02-22,17005.15,asset_sale,in,Counterparty_95,20675997.68,,
2025-02-22,42142.83,investment_income,in,Counterparty_52,20718140.51,,
2025-02-22,73297.59,software_subscription,out,Counterparty_86,20644842.92,2025-02-04,2025-03-03
2025-02-22,4531.38,marketing_spend,out,Counterparty_4,20640311.54,2025-01-29,2025-03-06
2025-02-22,6963.28,customer_payment,in,Counterparty_59,20647274.82,,
2025-02-22,10874.67,tax_payment,out,Counterparty_15,20636400.15,2025-02-04,2025-03-05
2025-02-22,2902.54,software_subscription,out,Counterparty_42,20633497.61,2025-01-30,2025-03-02
2025-02-22,17058.44,investment_income,in,Counterparty_93,20650556.05,,
2025-02-22,16157.79,credit,in,Counterparty_68,20666713.84,,
2025-02-22,3323.66,investment_income,in,Counterparty_78,20670037.5,,
2025-02-22,31197.98,marketing_spend,out,Counterparty_87,20638839.52,2025-01-28,2025-03-08
2025-02-22,3036.23,loan_repayment,out,Counterparty_96,20635803.29,2025-01-12,2025-02-16
2025-02-22,2687.27,credit,in,Counterparty_5,20638490.56,,
2025-02-22,15455.18,refund,in,Counterparty_71,20653945.74,,
2025-02-22,32949.36,customer_payment,in,Counterparty_98,20686895.1,,
2025-02-22,8304.8,credit,in,Counterparty_16,20695199.9,,
2025-02-22,53417.51,customer_payment,in,Counterparty_97,20748617.41,,
2025-02-22,2901.66,tax_payment,out,Counterparty_90,20745715.75,2025-02-02,2025-03-10
2025-02-22,7498.07,credit,in,Counterparty_26,20753213.82,,
2025-02-22,13773.24,refund,in,Counterparty_52,20766987.06,,
2025-02-22,11264.04,investment_income,in,Counterparty_70,20778251.1,,
2025-02-22,11745.55,software_subscription,out,Counterparty_58,20766505.55,2025-02-06,2025-03-09
2025-02-22,19644.63,utilities,out,Counterparty_35,20746860.92,2025-01-21,2025-02-24
2025-02-22,2955.91,refund,in,Counterparty_32,20749816.83,,
2025-02-22,843.33,rent,out,Counterparty_58,20748973.5,2025-02-01,2025-03-06
2025-02-22,37935.51,software_subscription,out,Counterparty_47,20711037.99,2025-01-09,2025-02-15
2025-02-22,16861.08,tax_payment,out,Counterparty_15,20694176.91,2025-01-09,2025-02-06
2025-02-23,5432.09,marketing_spend,out,Counterparty_93,20688744.82,2025-01-31,2025-03-06
2025-02-23,22970.25,software_subscription,out,Counterparty_21,20665774.57,2025-01-20,2025-02-27
2025-02-23,10393.12,tax_payment,out,Counterparty_22,20655381.45,2025-01-19,2025-02-17
2025-02-23,67784.19,rent,out,Counterparty_3,20587597.26,2025-01-18,2025-02-15
2025-02-23,41126.18,utilities,out,Counterparty_42,20546471.08,2025-01-10,2025-02-05
2025-02-23,4381.64,tax_payment,out,Counterparty_72,20542089.44,2025-01-24,2025-02-23
2025-02-23,368.45,asset_sale,in,Counterparty_43,20542457.89,,
2025-02-23,5363.35,utilities,out,Counterparty_71,20537094.54,2025-01-31,2025-03-11
2025-02-23,28624.38,credit,in,Counterparty_3,20565718.92,,
2025-02-23,9064.66,customer_payment,in,Counterparty_23,20574783.58,,
2025-02-23,29701.76,credit,in,Counterparty_62,20604485.34,,
2025-02-23,8782.68,customer_payment,in,Counterparty_21,20613268.02,,
2025-02-23,21527.19,refund,in,Counterparty_93,20634795.21,,
2025-02-23,74524.28,asset_sale,in,Counterparty_68,20709319.49,,
2025-02-23,21525.81,refund,in,Counterparty_23,20730845.3,,
2025-02-23,3177.57,asset_sale,in,Counterparty_63,20734022.87,,
2025-02-23,19049.03,rent,out,Counterparty_37,20714973.84,2025-01-25,2025-02-26
2025-02-23,3168.33,customer_payment,in,Counterparty_71,20718142.17,,
2025-02-23,38439.09,refund,in,Counterparty_93,20756581.26,,
2025-02-23,28218.5,investment_income,in,Counterparty_74,20784799.76,,
2025-02-23,143.03,tax_payment,out,Counterparty_45,20784656.73,2025-02-04,2025-03-03
2025-02-23,8201.1,supplier_payment,out,Counterparty_53,20776455.63,2025-01-23,2025-02-25
2025-02-23,3666.46,supplier_payment,out,Counterparty_24,20772789.17,2025-01-27,2025-02-23
2025-02-23,43009.12,asset_sale,in,Counterparty_34,20815798.29,,
2025-02-23,11991.64,loan_repayment,out,Counterparty_34,20803806.65,2025-01-23,2025-02-19
2025-02-23,14333.1,credit,in,Counterparty_86,20818139.75,,
2025-02-23,16156.98,loan_repayment,out,Counterparty_99,20801982.77,2025-01-27,2025-03-04
2025-02-23,16681.91,customer_payment,in,Counterparty_72,20818664.68,,
2025-02-23,2131.7,investment_income,in,Counterparty_63,20820796.38,,
2025-02-23,25467.04,refund,in,Counterparty_81,20846263.42,,
2025-02-23,3935.16,investment_income,in,Counterparty_29,20850198.58,,
2025-02-23,10654.79,refund,in,Counterparty_30,20860853.37,,
2025-02-23,8852.78,investment_income,in,Counterparty_27,20869706.15,,
2025-02-23,10225.39,supplier_payment,out,Counterparty_43,20859480.76,2025-01-14,2025-02-22
2025-02-23,37937.65,credit,in,Counterparty_33,20897418.41,,
2025-02-23,8847.53,credit,in,Counterparty_88,20906265.94,,
2025-02-23,511.14,credit,in,Counterparty_83,20906777.08,,
2025-02-23,48708.81,asset_sale,in,Counterparty_42,20955485.89,,
2025-02-23,37468.37,customer_payment,in,Counterparty_59,20992954.26,,
2025-02-23,4815.16,investment_income,in,Counterparty_14,20997769.42,,
2025-02-23,11521.75,customer_payment,in,Counterparty_86,21009291.17,,
2025-02-23,14836.88,rent,out,Counterparty_76,20994454.29,2025-01-10,2025-02-18
2025-02-23,33230.42,credit,in,Counterparty_41,21027684.71,,
2025-02-23,740.9,investment_income,in,Counterparty_32,21028425.61,,
2025-02-23,18912.15,asset_sale,in,Counterparty_55,21047337.76,,
2025-02-23,1530.62,investment_income,in,Counterparty_98,21048868.38,,
2025-02-23,25229.09,refund,in,Counterparty_26,21074097.47,,
2025-02-23,28548.04,asset_sale,in,Counterparty_37,21102645.51,,
2025-02-23,13427.66,rent,out,Counterparty_19,21089217.85,2025-02-05,2025-03-13
2025-02-23,3532.17,customer_payment,in,Counterparty_60,21092750.02,,
2025-02-24,33330.91,investment_income,in,Counterparty_66,21126080.93,,
2025-02-24,27504.21,investment_income,in,Counterparty_16,21153585.14,,
2025-02-24,21368.1,asset_sale,in,Counterparty_1,21174953.24,,
2025-02-24,6031.52,payroll,out,Counterparty_6,21168921.72,2025-01-16,2025-02-20
2025-02-24,18301.3,refund,in,Counterparty_12,21187223.02,,
2025-02-24,777.29,refund,in,Counterparty_3,21188000.31,,
2025-02-24,27189.18,credit,in,Counterparty_1,21215189.49,,
2025-02-24,21017.19,credit,in,Counterparty_66,21236206.68,,
2025-02-24,21917.36,tax_payment,out,Counterparty_11,21214289.32,2025-01-13,2025-02-11
2025-02-24,17613.92,asset_sale,in,Counterparty_25,21231903.24,,
2025-02-24,80064.11,customer_payment,in,Counterparty_46,21311967.35,,
2025-02-24,280.52,credit,in,Counterparty_3,21312247.87,,
2025-02-24,50755.55,asset_sale,in,Counterparty_26,21363003.42,,
2025-02-24,31527.41,rent,out,Counterparty_15,21331476.01,2025-01-25,2025-03-01
2025-02-24,1415.86,payroll,out,Counterparty_46,21330060.15,2025-01-13,2025-02-09
2025-02-24,7277.61,customer_payment,in,Counterparty_6,21337337.76,,
2025-02-24,97505.55,investment_income,in,Counterparty_30,21434843.31,,
2025-02-24,9585.8,utilities,out,Counterparty_38,21425257.51,2025-01-24,2025-02-22
2025-02-24,35903.83,investment_income,in,Counterparty_84,21461161.34,,
2025-02-24,19094.95,supplier_payment,out,Counterparty_73,21442066.39,2025-01-30,2025-03-07
2025-02-24,1645.46,T&E,out,Counterparty_54,21440420.93,2025-01-18,2025-02-12
2025-02-24,23098.93,refund,in,Counterparty_61,21463519.86,,
2025-02-24,603.64,customer_payment,in,Counterparty_44,21464123.5,,
2025-02-24,18427.95,refund,in,Counterparty_81,21482551.45,,
2025-02-24,1247.26,utilities,out,Counterparty_17,21481304.19,2025-02-03,2025-03-02
2025-02-24,788.39,customer_payment,in,Counterparty_26,21482092.58,,
2025-02-24,45739.88,asset_sale,in,Counterparty_39,21527832.46,,
2025-02-24,23036.59,credit,in,Counterparty_1,21550869.05,,
2025-02-24,5254.4,asset_sale,in,Counterparty_58,21556123.45,,
2025-02-24,14840.97,asset_sale,in,Counterparty_60,21570964.42,,
2025-02-24,31711.43,investment_income,in,Counterparty_59,21602675.85,,
2025-02-24,22723.33,investment_income,in,Counterparty_46,21625399.18,,
2025-02-24,24197.81,customer_payment,in,Counterparty_95,21649596.99,,
2025-02-24,45794.54,asset_sale,in,Counterparty_61,21695391.53,,
2025-02-24,28323.4,credit,in,Counterparty_15,21723714.93,,
2025-02-24,4323.85,credit,in,Counterparty_52,21728038.78,,
2025-02-24,13629.64,credit,in,Counterparty_41,21741668.42,,
2025-02-24,47977.15,asset_sale,in,Counterparty_49,21789645.57,,
2025-02-24,17340.79,asset_sale,in,Counterparty_64,21806986.36,,
2025-02-24,6332.42,asset_sale,in,Counterparty_16,21813318.78,,
2025-02-24,18425.82,utilities,out,Counterparty_78,21794892.96,2025-02-02,2025-03-09
2025-02-24,6497.65,loan_repayment,out,Counterparty_81,21788395.31,2025-02-02,2025-02-28
2025-02-24,7560.93,asset_sale,in,Counterparty_7,21795956.24,,
2025-02-24,20352.18,customer_payment,in,Counterparty_52,21816308.42,,
2025-02-24,7189.79,software_subscription,out,Counterparty_52,21809118.63,2025-01-11,2025-02-17
2025-02-24,91444.03,credit,in,Counterparty_24,21900562.66,,
2025-02-24,41873.25,marketing_spend,out,Counterparty_42,21858689.41,2025-01-29,2025-03-05
2025-02-24,25175.76,payroll,out,Counterparty_45,21833513.65,2025-01-13,2025-02-14
2025-02-25,4776.5,rent,out,Counterparty_49,21828737.15,2025-01-16,2025-02-17
2025-02-25,1325.33,payroll,out,Counterparty_12,21827411.82,2025-01-22,2025-02-25
2025-02-25,13456.24,marketing_spend,out,Counterparty_75,21813955.58,2025-02-04,2025-03-08
2025-02-25,4251.65,investment_income,in,Counterparty_61,21818207.23,,
2025-02-25,1218.03,software_subscription,out,Counterparty_65,21816989.2,2025-02-07,2025-03-06
2025-02-25,7660.84,loan_repayment,out,Counterparty_62,21809328.36,2025-01-15,2025-02-18
2025-02-25,7567.62,credit,in,Counterparty_9,21816895.98,,
2025-02-25,51.79,software_subscription,out,Counterparty_65,21816844.19,2025-01-30,2025-03-01
2025-02-25,75421.8,T&E,out,Counterparty_49,21741422.39,2025-01-23,2025-02-21
2025-02-25,5182.34,tax_payment,out,Counterparty_69,21736240.05,2025-01-29,2025-02-25
2025-02-25,37223.31,marketing_spend,out,Counterparty_54,21699016.74,2025-01-18,2025-02-22
2025-02-25,4336.83,customer_payment,in,Counterparty_64,21703353.57,,
2025-02-25,7086.92,investment_income,in,Counterparty_27,21710440.49,,
2025-02-25,2019.93,software_subscription,out,Counterparty_22,21708420.56,2025-01-15,2025-02-10
2025-02-25,18693.65,asset_sale,in,Counterparty_54,21727114.21,,
2025-02-25,17262.62,marketing_spend,out,Counterparty_86,21709851.59,2025-02-10,2025-03-08
2025-02-25,110350.45,credit,in,Counterparty_95,21820202.04,,
2025-02-25,11884.72,refund,in,Counterparty_10,21832086.76,,
2025-02-25,26036.45,customer_payment,in,Counterparty_9,21858123.21,,
2025-02-25,10745.93,software_subscription,out,Counterparty_92,21847377.28,2025-01-31,2025-03-08
2025-02-25,502.38,marketing_spend,out,Counterparty_47,21846874.9,2025-01-24,2025-02-21
2025-02-25,30618.75,tax_payment,out,Counterparty_41,21816256.15,2025-02-02,2025-02-28
2025-02-25,4782.16,rent,out,Counterparty_90,21811473.99,2025-01-28,2025-03-08
2025-02-25,16807.92,refund,in,Counterparty_8,21828281.91,,
2025-02-25,26688.52,credit,in,Counterparty_88,21854970.43,,
2025-02-25,4253.31,refund,in,Counterparty_20,21859223.74,,
2025-02-25,13665.74,investment_income,in,Counterparty_96,21872889.48,,
2025-02-25,2133.78,refund,in,Counterparty_60,21875023.26,,
2025-02-25,16405.98,investment_income,in,Counterparty_8,21891429.24,,
2025-02-25,1146.54,credit,in,Counterparty_85,21892575.78,,
2025-02-25,35742.77,investment_income,in,Counterparty_74,21928318.55,,
2025-02-25,54040.81,asset_sale,in,Counterparty_96,21982359.36,,
2025-02-25,7115.35,refund,in,Counterparty_21,21989474.71,,
2025-02-25,15394.98,refund,in,Counterparty_22,22004869.69,,
2025-02-25,24495.82,software_subscription,out,Counterparty_4,21980373.87,2025-01-31,2025-03-09
2025-02-25,4271.67,marketing_spend,out,Counterparty_8,21976102.2,2025-01-26,2025-02-25
2025-02-25,25896.1,credit,in,Counterparty_56,22001998.3,,
2025-02-25,10606.44,credit,in,Counterparty_49,22012604.74,,
2025-02-25,12828.09,tax_payment,out,Counterparty_77,21999776.65,2025-01-25,2025-02-22
2025-02-25,1092.13,marketing_spend,out,Counterparty_3,21998684.52,2025-02-05,2025-03-14
2025-02-25,34387.96,refund,in,Counterparty_90,22033072.48,,
2025-02-25,19545.87,credit,in,Counterparty_22,22052618.35,,
2025-02-25,67419.58,T&E,out,Counterparty_27,21985198.77,2025-01-24,2025-02-24
2025-02-25,21157.87,loan_repayment,out,Counterparty_76,21964040.9,2025-01-30,2025-02-25
2025-02-25,41463.94,T&E,out,Counterparty_40,21922576.96,2025-01-21,2025-02-25
2025-02-26,33879.03,software_subscription,out,Counterparty_81,21888697.93,2025-01-26,2025-03-04
2025-02-26,49708.42,software_subscription,out,Counterparty_91,21838989.51,2025-02-11,2025-03-20
2025-02-26,32362.99,marketing_spend,out,Counterparty_29,21806626.52,2025-01-16,2025-02-20
2025-02-26,2552.18,software_subscription,out,Counterparty_96,21804074.34,2025-01-13,2025-02-14
2025-02-26,10918.55,tax_payment,out,Counterparty_84,21793155.79,2025-01-19,2025-02-16
2025-02-26,21018.44,marketing_spend,out,Counterparty_37,21772137.35,2025-01-14,2025-02-21
2025-02-26,12243.38,utilities,out,Counterparty_60,21759893.97,2025-02-04,2025-03-15
2025-02-26,8371.76,T&E,out,Counterparty_49,21751522.21,2025-01-26,2025-03-01
2025-02-26,23795.59,loan_repayment,out,Counterparty_83,21727726.62,2025-02-05,2025-03-15
2025-02-26,10530.14,payroll,out,Counterparty_36,21717196.48,2025-02-08,2025-03-10
2025-02-26,7852.28,rent,out,Counterparty_48,21709344.2,2025-02-04,2025-03-04
2025-02-26,13642.36,T&E,out,Counterparty_27,21695701.84,2025-01-22,2025-02-26
2025-02-26,17709.23,T&E,out,Counterparty_46,21677992.61,2025-02-04,2025-03-05
2025-02-26,7185.97,loan_repayment,out,Counterparty_32,21670806.64,2025-01-15,2025-02-09
2025-02-26,1511.64,credit,in,Counterparty_85,21672318.28,,
2025-02-26,1770.88,supplier_payment,out,Counterparty_20,21670547.4,2025-02-03,2025-03-13
2025-02-26,2619.65,customer_payment,in,Counterparty_52,21673167.05,,
2025-02-26,2218.7,supplier_payment,out,Counterparty_66,21670948.35,2025-02-07,2025-03-18
2025-02-26,2881.72,credit,in,Counterparty_69,21673830.07,,
2025-02-26,4147.33,customer_payment,in,Counterparty_34,21677977.4,,
2025-02-26,13894.26,investment_income,in,Counterparty_85,21691871.66,,
2025-02-26,45501.28,asset_sale,in,Counterparty_64,21737372.94,,
2025-02-26,2275.75,asset_sale,in,Counterparty_36,21739648.69,,
2025-02-26,24801.34,refund,in,Counterparty_13,21764450.03,,
2025-02-26,59394.96,asset_sale,in,Counterparty_95,21823844.99,,
2025-02-26,31853.31,investment_income,in,Counterparty_31,21855698.3,,
2025-02-26,18797.99,customer_payment,in,Counterparty_1,21874496.29,,
2025-02-26,4664.57,refund,in,Counterparty_46,21879160.86,,
2025-02-26,25965.88,asset_sale,in,Counterparty_57,21905126.74,,
2025-02-26,33826.37,asset_sale,in,Counterparty_45,21938953.11,,
2025-02-26,37526.93,investment_income,in,Counterparty_74,21976480.04,,
2025-02-26,317.54,customer_payment,in,Counterparty_85,21976797.58,,
2025-02-26,1492.73,refund,in,Counterparty_95,21978290.31,,
2025-02-26,21159.81,refund,in,Counterparty_36,21999450.12,,
2025-02-26,8593.06,T&E,out,Counterparty_86,21990857.06,2025-02-05,2025-03-07
2025-02-26,29979.96,refund,in,Counterparty_87,22020837.02,,
2025-02-26,21692.02,payroll,out,Counterparty_44,21999145.0,2025-01-30,2025-02-27
2025-02-26,21203.77,asset_sale,in,Counterparty_65,22020348.77,,
2025-02-26,28149.45,marketing_spend,out,Counterparty_45,21992199.32,2025-02-09,2025-03-09
2025-02-26,35209.13,utilities,out,Counterparty_57,21956990.19,2025-02-10,2025-03-18
2025-02-26,8871.19,T&E,out,Counterparty_34,21948119.0,2025-02-03,2025-03-04
2025-02-26,2090.65,tax_payment,out,Counterparty_35,21946028.35,2025-01-31,2025-03-05
2025-02-26,12141.26,customer_payment,in,Counterparty_77,21958169.61,,
2025-02-26,2661.09,customer_payment,in,Counterparty_37,21960830.7,,
2025-02-27,274.42,tax_payment,out,Counterparty_21,21960556.28,2025-01-19,2025-02-25
2025-02-27,5051.67,credit,in,Counterparty_68,21965607.95,,
2025-02-27,18565.66,customer_payment,in,Counterparty_77,21984173.61,,
2025-02-27,3654.28,rent,out,Counterparty_50,21980519.33,2025-01-20,2025-02-24
2025-02-27,5487.81,credit,in,Counterparty_58,21986007.14,,
2025-02-27,13546.18,customer_payment,in,Counterparty_69,21999553.32,,
2025-02-27,14030.73,software_subscription,out,Counterparty_27,21985522.59,2025-01-26,2025-02-22
2025-02-27,4128.7,refund,in,Counterparty_45,21989651.29,,
2025-02-27,10062.59,supplier_payment,out,Counterparty_71,21979588.7,2025-01-27,2025-02-22
2025-02-27,22926.84,investment_income,in,Counterparty_46,22002515.54,,
2025-02-27,60683.55,rent,out,Counterparty_27,21941831.99,2025-01-14,2025-02-15
2025-02-27,16407.23,supplier_payment,out,Counterparty_42,21925424.76,2025-01-18,2025-02-16
2025-02-27,9320.62,refund,in,Counterparty_3,21934745.38,,
2025-02-27,3428.6,utilities,out,Counterparty_81,21931316.78,2025-01-25,2025-02-22
2025-02-27,31123.49,software_subscription,out,Counterparty_15,21900193.29,2025-01-19,2025-02-16
2025-02-27,1760.18,loan_repayment,out,Counterparty_71,21898433.11,2025-01-28,2025-02-22
2025-02-27,9251.43,asset_sale,in,Counterparty_50,21907684.54,,
2025-02-27,98992.21,investment_income,in,Counterparty_83,22006676.75,,
2025-02-27,4536.78,investment_income,in,Counterparty_74,22011213.53,,
2025-02-27,2058.07,refund,in,Counterparty_87,22013271.6,,
2025-02-27,20341.45,marketing_spend,out,Counterparty_79,21992930.15,2025-01-14,2025-02-22
2025-02-27,12353.59,T&E,out,Counterparty_29,21980576.56,2025-02-02,2025-03-02
2025-02-27,138.96,payroll,out,Counterparty_53,21980437.6,2025-02-08,2025-03-16
2025-02-27,1625.22,credit,in,Counterparty_13,21982062.82,,
2025-02-27,7864.58,rent,out,Counterparty_60,21974198.24,2025-01-17,2025-02-12
2025-02-27,39699.58,tax_payment,out,Counterparty_80,21934498.66,2025-01-28,2025-03-05
2025-02-27,21531.55,rent,out,Counterparty_39,21912967.11,2025-01-21,2025-02-24
2025-02-27,65232.36,tax_payment,out,Counterparty_2,21847734.75,2025-01-15,2025-02-20
2025-02-27,58132.16,loan_repayment,out,Counterparty_59,21789602.59,2025-02-09,2025-03-19
2025-02-27,20395.23,T&E,out,Counterparty_45,21769207.36,2025-01-15,2025-02-18
2025-02-27,107512.23,supplier_payment,out,Counterparty_87,21661695.13,2025-01-29,2025-03-05
2025-02-27,2875.34,tax_payment,out,Counterparty_75,21658819.79,2025-01-24,2025-02-27
2025-02-27,3461.68,loan_repayment,out,Counterparty_33,21655358.11,2025-02-11,2025-03-19
2025-02-27,6338.14,investment_income,in,Counterparty_82,21661696.25,,
2025-02-27,70092.28,refund,in,Counterparty_82,21731788.53,,
2025-02-27,14560.59,investment_income,in,Counterparty_51,21746349.12,,
2025-02-27,9005.3,investment_income,in,Counterparty_89,21755354.42,,
2025-02-27,11022.34,supplier_payment,out,Counterparty_12,21744332.08,2025-02-04,2025-03-10
2025-02-27,29603.42,rent,out,Counterparty_11,21714728.66,2025-02-12,2025-03-21
2025-02-27,218.62,asset_sale,in,Counterparty_89,21714947.28,,
2025-02-27,10677.2,credit,in,Counterparty_90,21725624.48,,
2025-02-28,15523.21,investment_income,in,Counterparty_11,21741147.69,,
2025-02-28,115.6,investment_income,in,Counterparty_14,21741263.29,,
2025-02-28,29254.16,asset_sale,in,Counterparty_65,21770517.45,,
2025-02-28,3821.45,investment_income,in,Counterparty_2,21774338.9,,
2025-02-28,449.56,investment_income,in,Counterparty_15,21774788.46,,
2025-02-28,14917.62,credit,in,Counterparty_43,21789706.08,,
2025-02-28,13563.97,marketing_spend,out,Counterparty_91,21776142.11,2025-02-10,2025-03-14
2025-02-28,3598.34,investment_income,in,Counterparty_26,21779740.45,,
2025-02-28,18875.8,software_subscription,out,Counterparty_98,21760864.65,2025-01-23,2025-03-01
2025-02-28,20880.12,credit,in,Counterparty_17,21781744.77,,
2025-02-28,53490.14,investment_income,in,Counterparty_74,21835234.91,,
2025-02-28,53647.98,rent,out,Counterparty_95,21781586.93,2025-01-23,2025-02-17
2025-02-28,19429.6,software_subscription,out,Counterparty_41,21762157.33,2025-01-23,2025-02-21
2025-02-28,20594.24,software_subscription,out,Counterparty_73,21741563.09,2025-01-24,2025-02-25
2025-02-28,4414.04,rent,out,Counterparty_49,21737149.05,2025-02-11,2025-03-13
2025-02-28,10198.14,customer_payment,in,Counterparty_31,21747347.19,,
2025-02-28,7168.46,asset_sale,in,Counterparty_74,21754515.65,,
2025-02-28,34920.56,marketing_spend,out,Counterparty_32,21719595.09,2025-01-17,2025-02-16
2025-02-28,4429.71,tax_payment,out,Counterparty_80,21715165.38,2025-01-18,2025-02-16
2025-02-28,15128.91,marketing_spend,out,Counterparty_1,21700036.47,2025-01-17,2025-02-12
2025-02-28,81333.76,credit,in,Counterparty_50,21781370.23,,
2025-02-28,7588.33,refund,in,Counterparty_27,21788958.56,,
2025-02-28,13896.45,customer_payment,in,Counterparty_17,21802855.01,,
2025-02-28,11816.08,tax_payment,out,Counterparty_84,21791038.93,2025-01-30,2025-03-10
2025-02-28,13685.54,rent,out,Counterparty_10,21777353.39,2025-02-05,2025-03-12
2025-02-28,7186.49,tax_payment,out,Counterparty_18,21770166.9,2025-01-16,2025-02-16
2025-02-28,20943.78,refund,in,Counterparty_70,21791110.68,,
2025-02-28,5159.18,payroll,out,Counterparty_34,21785951.5,2025-01-23,2025-02-23
2025-02-28,16161.1,tax_payment,out,Counterparty_48,21769790.4,2025-01-28,2025-02-24
2025-02-28,7797.02,supplier_payment,out,Counterparty_58,21761993.38,2025-02-10,2025-03-21
2025-02-28,4921.67,T&E,out,Counterparty_23,21757071.71,2025-01-25,2025-02-27
2025-02-28,19070.86,loan_repayment,out,Counterparty_44,21738000.85,2025-01-27,2025-03-06
2025-02-28,5824.04,loan_repayment,out,Counterparty_97,21732176.81,2025-01-28,2025-03-08
2025-02-28,9366.3,tax_payment,out,Counterparty_90,21722810.51,2025-02-06,2025-03-16
2025-02-28,32276.33,software_subscription,out,Counterparty_22,21690534.18,2025-02-02,2025-03-02
2025-02-28,8342.99,refund,in,Counterparty_22,21698877.17,,
2025-02-28,4217.4,asset_sale,in,Counterparty_5,21703094.57,,
2025-02-28,21841.13,asset_sale,in,Counterparty_51,21724935.7,,
2025-02-28,5397.13,customer_payment,in,Counterparty_12,21730332.83,,
2025-02-28,15664.37,credit,in,Counterparty_88,21745997.2,,
2025-02-28,4203.16,refund,in,Counterparty_29,21750200.36,,
2025-02-28,4796.9,utilities,out,Counterparty_67,21745403.46,2025-02-04,2025-03-08
2025-02-28,12657.63,asset_sale,in,Counterparty_99,21758061.09,,
2025-02-28,21038.98,asset_sale,in,Counterparty_56,21779100.07,,
2025-02-28,8255.65,asset_sale,in,Counterparty_54,21787355.72,,
2025-02-28,15193.6,investment_income,in,Counterparty_70,21802549.32,,
2025-02-28,2567.8,rent,out,Counterparty_45,21799981.52,2025-02-10,2025-03-15
2025-02-28,9955.87,utilities,out,Counterparty_66,21790025.65,2025-02-04,2025-03-06
2025-02-28,2388.41,asset_sale,in,Counterparty_16,21792414.06,,
2025-02-28,4962.36,tax_payment,out,Counterparty_41,21787451.7,2025-02-04,2025-03-01
2025-02-28,7292.01,investment_income,in,Counterparty_5,21794743.71,,
2025-02-28,4589.85,payroll,out,Counterparty_8,21790153.86,2025-01-28,2025-03-08
2025-02-28,70779.69,asset_sale,in,Counterparty_72,21860933.55,,
2025-02-28,10731.15,investment_income,in,Counterparty_92,21871664.7,,
2025-03-01,14136.79,investment_income,in,Counterparty_8,21885801.49,,
2025-03-01,7715.92,software_subscription,out,Counterparty_77,21878085.57,2025-01-24,2025-03-02
2025-03-01,2273.15,investment_income,in,Counterparty_36,21880358.72,,
2025-03-01,1480.06,asset_sale,in,Counterparty_85,21881838.78,,
2025-03-01,446.73,tax_payment,out,Counterparty_62,21881392.05,2025-02-13,2025-03-19
2025-03-01,5091.87,rent,out,Counterparty_27,21876300.18,2025-02-01,2025-03-03
2025-03-01,134.85,rent,out,Counterparty_22,21876165.33,2025-01-27,2025-03-05
2025-03-01,271.23,payroll,out,Counterparty_54,21875894.1,2025-01-16,2025-02-18
2025-03-01,1291.4,rent,out,Counterparty_92,21874602.7,2025-01-16,2025-02-17
2025-03-01,1766.71,rent,out,Counterparty_47,21872835.99,2025-02-03,2025-03-05
2025-03-01,2732.87,loan_repayment,out,Counterparty_22,21870103.12,2025-02-08,2025-03-15
2025-03-01,5578.88,T&E,out,Counterparty_4,21864524.24,2025-02-04,2025-03-01
2025-03-01,1466.76,payroll,out,Counterparty_60,21863057.48,2025-02-04,2025-03-05
2025-03-01,3244.35,supplier_payment,out,Counterparty_92,21859813.13,2025-02-01,2025-02-27
2025-03-01,2475.06,tax_payment,out,Counterparty_66,21857338.07,2025-02-08,2025-03-17
2025-03-01,223.14,T&E,out,Counterparty_90,21857114.93,2025-01-21,2025-02-23
2025-03-01,1498.11,credit,in,Counterparty_93,21858613.04,,
2025-03-01,20562.95,credit,in,Counterparty_84,21879175.99,,
2025-03-01,6698.92,marketing_spend,out,Counterparty_81,21872477.07,2025-02-08,2025-03-10
2025-03-01,2328.28,supplier_payment,out,Counterparty_85,21870148.79,2025-02-03,2025-03-03
2025-03-01,5663.77,utilities,out,Counterparty_56,21864485.02,2025-01-17,2025-02-18
2025-03-01,39371.69,credit,in,Counterparty_31,21903856.71,,
2025-03-01,1136.63,customer_payment,in,Counterparty_92,21904993.34,,
2025-03-01,542.72,refund,in,Counterparty_91,21905536.06,,
2025-03-01,186.88,asset_sale,in,Counterparty_56,21905722.94,,
2025-03-01,118.29,investment_income,in,Counterparty_14,21905841.23,,
2025-03-01,2068.2,credit,in,Counterparty_73,21907909.43,,
2025-03-01,341.09,refund,in,Counterparty_54,21908250.52,,
2025-03-01,11903.34,supplier_payment,out,Counterparty_18,21896347.18,2025-02-06,2025-03-13
2025-03-01,757.35,refund,in,Counterparty_11,21897104.53,,
2025-03-01,8721.03,asset_sale,in,Counterparty_92,21905825.56,,
2025-03-01,16309.94,asset_sale,in,Counterparty_61,21922135.5,,
2025-03-01,4330.45,customer_payment,in,Counterparty_90,21926465.95,,
2025-03-01,533.26,software_subscription,out,Counterparty_86,21925932.69,2025-01-18,2025-02-17
2025-03-01,5017.03,T&E,out,Counterparty_91,21920915.66,2025-01-19,2025-02-14
2025-03-01,1505.47,investment_income,in,Counterparty_49,21922421.13,,
2025-03-01,611.79,credit,in,Counterparty_12,21923032.92,,
2025-03-01,4267.86,loan_repayment,out,Counterparty_73,21918765.06,2025-01-26,2025-02-26
2025-03-01,106.13,supplier_payment,out,Counterparty_42,21918658.93,2025-02-13,2025-03-12
2025-03-01,2172.69,loan_repayment,out,Counterparty_96,21916486.24,2025-01-27,2025-03-04
2025-03-01,1913.36,tax_payment,out,Counterparty_88,21914572.88,2025-01-22,2025-02-25
2025-03-01,1429.1,loan_repayment,out,Counterparty_14,21913143.78,2025-02-02,2025-03-12
2025-03-01,16084.58,refund,in,Counterparty_50,21929228.36,,
2025-03-01,6010.47,software_subscription,out,Counterparty_27,21923217.89,2025-01-18,2025-02-24
2025-03-01,822.51,loan_repayment,out,Counterparty_85,21922395.38,2025-01-24,2025-03-01
2025-03-01,24.13,marketing_spend,out,Counterparty_15,21922371.25,2025-01-28,2025-02-23
2025-03-01,6218.86,loan_repayment,out,Counterparty_65,21916152.39,2025-01-31,2025-02-28
2025-03-01,3326.74,T&E,out,Counterparty_11,21912825.65,2025-02-03,2025-03-10
2025-03-01,139.5,software_subscription,out,Counterparty_5,21912686.15,2025-02-09,2025-03-10
2025-03-01,1951.25,payroll,out,Counterparty_17,21910734.9,2025-01-23,2025-02-24
2025-03-01,3622.02,tax_payment,out,Counterparty_57,21907112.88,2025-02-10,2025-03-16
2025-03-01,2232.68,loan_repayment,out,Counterparty_62,21904880.2,2025-01-27,2025-02-24
2025-03-01,1532.05,loan_repayment,out,Counterparty_15,21903348.15,2025-01-22,2025-02-27
2025-03-01,3079.56,supplier_payment,out,Counterparty_40,21900268.59,2025-01-21,2025-02-21
2025-03-01,4533.93,investment_income,in,Counterparty_5,21904802.52,,
2025-03-01,96.49,marketing_spend,out,Counterparty_93,21904706.03,2025-01-18,2025-02-23
2025-03-01,1103.03,loan_repayment,out,Counterparty_66,21903603.0,2025-01-19,2025-02-24
2025-03-02,634.62,tax_payment,out,Counterparty_3,21902968.38,2025-02-05,2025-03-10
2025-03-02,2148.44,payroll,out,Counterparty_17,21900819.94,2025-02-05,2025-03-06
2025-03-02,5081.98,rent,out,Counterparty_91,21895737.96,2025-02-14,2025-03-16
2025-03-02,6891.87,supplier_payment,out,Counterparty_53,21888846.09,2025-02-14,2025-03-22
2025-03-02,9024.49,supplier_payment,out,Counterparty_66,21879821.6,2025-02-10,2025-03-11
2025-03-02,4670.49,marketing_spend,out,Counterparty_69,21875151.11,2025-02-13,2025-03-18
2025-03-02,5862.03,asset_sale,in,Counterparty_83,21881013.14,,
2025-03-02,807.65,supplier_payment,out,Counterparty_35,21880205.49,2025-01-23,2025-02-21
2025-03-02,2905.45,asset_sale,in,Counterparty_28,21883110.94,,
2025-03-02,1395.59,T&E,out,Counterparty_97,21881715.35,2025-01-29,2025-03-06
2025-03-02,2243.25,rent,out,Counterparty_4,21879472.1,2025-02-01,2025-03-04
2025-03-02,362.26,utilities,out,Counterparty_83,21879109.84,2025-02-08,2025-03-13
2025-03-02,2106.22,loan_repayment,out,Counterparty_87,21877003.62,2025-01-19,2025-02-22
2025-03-02,4161.21,payroll,out,Counterparty_63,21872842.41,2025-01-24,2025-02-26
2025-03-02,3554.54,T&E,out,Counterparty_16,21869287.87,2025-02-01,2025-03-08
2025-03-02,3128.77,rent,out,Counterparty_38,21866159.1,2025-02-02,2025-02-28
2025-03-02,2341.59,supplier_payment,out,Counterparty_39,21863817.51,2025-02-10,2025-03-09
2025-03-02,525.2,marketing_spend,out,Counterparty_62,21863292.31,2025-02-10,2025-03-11
2025-03-02,3208.35,loan_repayment,out,Counterparty_74,21860083.96,2025-01-17,2025-02-24
2025-03-02,561.53,utilities,out,Counterparty_28,21859522.43,2025-02-11,2025-03-09
2025-03-02,709.09,rent,out,Counterparty_51,21858813.34,2025-02-10,2025-03-09
2025-03-02,4480.97,utilities,out,Counterparty_38,21854332.37,2025-02-14,2025-03-21
2025-03-02,546.68,T&E,out,Counterparty_20,21853785.69,2025-02-07,2025-03-10
2025-03-02,204.02,rent,out,Counterparty_15,21853581.67,2025-01-22,2025-02-24
2025-03-02,4228.52,supplier_payment,out,Counterparty_66,21849353.15,2025-01-17,2025-02-22
2025-03-02,510.86,utilities,out,Counterparty_59,21848842.29,2025-01-30,2025-03-04
2025-03-02,1659.3,utilities,out,Counterparty_85,21847182.99,2025-01-27,2025-02-27
2025-03-02,326.27,supplier_payment,out,Counterparty_76,21846856.72,2025-01-23,2025-03-03
2025-03-02,8290.42,supplier_payment,out,Counterparty_86,21838566.3,2025-02-10,2025-03-21
2025-03-02,2718.69,T&E,out,Counterparty_98,21835847.61,2025-02-04,2025-03-13
2025-03-02,2130.47,utilities,out,Counterparty_60,21833717.14,2025-01-22,2025-02-28
2025-03-02,2626.25,software_subscription,out,Counterparty_72,21831090.89,2025-01-24,2025-02-27
2025-03-02,1660.53,tax_payment,out,Counterparty_52,21829430.36,2025-01-27,2025-03-04
2025-03-02,724.1,tax_payment,out,Counterparty_4,21828706.26,2025-01-17,2025-02-12
2025-03-02,236.31,rent,out,Counterparty_40,21828469.95,2025-01-24,2025-03-03
2025-03-02,2400.94,tax_payment,out,Counterparty_49,21826069.01,2025-02-03,2025-03-07
2025-03-02,10310.71,asset_sale,in,Counterparty_45,21836379.72,,
2025-03-02,268.15,payroll,out,Counterparty_75,21836111.57,2025-02-07,2025-03-15
2025-03-02,2995.26,payroll,out,Counterparty_46,21833116.31,2025-02-10,2025-03-18
2025-03-02,1025.07,software_subscription,out,Counterparty_62,21832091.24,2025-02-10,2025-03-08
2025-03-02,236.94,T&E,out,Counterparty_12,21831854.3,2025-01-23,2025-02-26
2025-03-02,9845.84,credit,in,Counterparty_96,21841700.14,,
2025-03-02,92.22,T&E,out,Counterparty_97,21841607.92,2025-02-02,2025-03-11
2025-03-02,4726.47,loan_repayment,out,Counterparty_4,21836881.45,2025-01-21,2025-02-24
2025-03-02,751.39,payroll,out,Counterparty_25,21836130.06,2025-02-06,2025-03-17
2025-03-02,5273.97,credit,in,Counterparty_81,21841404.03,,
2025-03-02,16421.5,refund,in,Counterparty_51,21857825.53,,
2025-03-02,2339.14,tax_payment,out,Counterparty_82,21855486.39,2025-02-11,2025-03-20
2025-03-02,1539.16,asset_sale,in,Counterparty_67,21857025.55,,
2025-03-02,5749.41,credit,in,Counterparty_15,21862774.96,,
2025-03-02,10898.5,customer_payment,in,Counterparty_98,21873673.46,,
2025-03-02,14541.78,payroll,out,Counterparty_57,21859131.68,2025-02-07,2025-03-12
2025-03-02,4231.92,payroll,out,Counterparty_14,21854899.76,2025-02-13,2025-03-17
2025-03-02,107.57,payroll,out,Counterparty_29,21854792.19,2025-01-22,2025-02-23
2025-03-02,6841.6,refund,in,Counterparty_37,21861633.79,,
2025-03-02,16733.01,investment_income,in,Counterparty_72,21878366.8,,
2025-03-02,6166.69,payroll,out,Counterparty_47,21872200.11,2025-01-28,2025-02-23
2025-03-02,3502.07,payroll,out,Counterparty_83,21868698.04,2025-01-18,2025-02-23
2025-03-03,5590.81,tax_payment,out,Counterparty_83,21863107.23,2025-02-07,2025-03-09
2025-03-03,1592.04,software_subscription,out,Counterparty_35,21861515.19,2025-01-26,2025-02-26
2025-03-03,6124.42,payroll,out,Counterparty_38,21855390.77,2025-01-28,2025-02-26
2025-03-03,22423.0,asset_sale,in,Counterparty_56,21877813.77,,
2025-03-03,15395.39,customer_payment,in,Counterparty_17,21893209.16,,
2025-03-03,17364.15,investment_income,in,Counterparty_89,21910573.31,,
2025-03-03,2108.27,customer_payment,in,Counterparty_25,21912681.58,,
2025-03-03,48037.06,asset_sale,in,Counterparty_98,21960718.64,,
2025-03-03,1706.8,asset_sale,in,Counterparty_35,21962425.44,,
2025-03-03,2459.24,credit,in,Counterparty_24,21964884.68,,
2025-03-03,1081.7,utilities,out,Counterparty_10,21963802.98,2025-02-12,2025-03-22
2025-03-03,1205.57,loan_repayment,out,Counterparty_89,21962597.41,2025-01-24,2025-03-01
2025-03-03,5971.98,loan_repayment,out,Counterparty_43,21956625.43,2025-01-25,2025-02-24
2025-03-03,8978.36,T&E,out,Counterparty_58,21947647.07,2025-02-15,2025-03-25
2025-03-03,5254.32,investment_income,in,Counterparty_59,21952901.39,,
2025-03-03,2023.58,supplier_payment,out,Counterparty_65,21950877.81,2025-02-09,2025-03-07
2025-03-03,3048.46,supplier_payment,out,Counterparty_44,21947829.35,2025-02-10,2025-03-13
2025-03-03,7279.98,investment_income,in,Counterparty_85,21955109.33,,
2025-03-03,8545.07,software_subscription,out,Counterparty_24,21946564.26,2025-02-08,2025-03-12
2025-03-03,721.49,marketing_spend,out,Counterparty_18,21945842.77,2025-02-02,2025-03-08
2025-03-03,1548.01,software_subscription,out,Counterparty_55,21944294.76,2025-02-14,2025-03-24
2025-03-03,4007.73,software_subscription,out,Counterparty_44,21940287.03,2025-02-10,2025-03-09
2025-03-03,968.11,loan_repayment,out,Counterparty_34,21939318.92,2025-01-28,2025-02-24
2025-03-03,492.36,customer_payment,in,Counterparty_29,21939811.28,,
2025-03-03,4627.31,credit,in,Counterparty_90,21944438.59,,
2025-03-03,4898.93,investment_income,in,Counterparty_14,21949337.52,,
2025-03-03,881.55,software_subscription,out,Counterparty_58,21948455.97,2025-02-09,2025-03-13
2025-03-03,1027.7,tax_payment,out,Counterparty_12,21947428.27,2025-02-02,2025-03-01
2025-03-03,3766.21,software_subscription,out,Counterparty_2,21943662.06,2025-01-18,2025-02-26
2025-03-03,3367.86,credit,in,Counterparty_71,21947029.92,,
2025-03-03,6554.98,investment_income,in,Counterparty_80,21953584.9,,
2025-03-03,1445.61,customer_payment,in,Counterparty_11,21955030.51,,
2025-03-03,1079.02,refund,in,Counterparty_22,21956109.53,,
2025-03-03,4947.33,rent,out,Counterparty_89,21951162.2,2025-01-25,2025-03-03
2025-03-03,317.62,T&E,out,Counterparty_93,21950844.58,2025-02-03,2025-03-14
2025-03-03,1440.04,supplier_payment,out,Counterparty_10,21949404.54,2025-02-03,2025-03-09
2025-03-03,2401.77,payroll,out,Counterparty_77,21947002.77,2025-02-05,2025-03-02
2025-03-03,1252.87,asset_sale,in,Counterparty_91,21948255.64,,
2025-03-03,828.18,T&E,out,Counterparty_20,21947427.46,2025-02-06,2025-03-15
2025-03-03,2305.16,software_subscription,out,Counterparty_3,21945122.3,2025-02-02,2025-03-13
2025-03-03,24321.68,asset_sale,in,Counterparty_7,21969443.98,,
2025-03-03,1519.29,refund,in,Counterparty_30,21970963.27,,
2025-03-03,586.12,tax_payment,out,Counterparty_82,21970377.15,2025-02-06,2025-03-14
2025-03-03,847.23,supplier_payment,out,Counterparty_43,21969529.92,2025-02-13,2025-03-13
2025-03-03,335.1,payroll,out,Counterparty_18,21969194.82,2025-01-24,2025-02-21
2025-03-03,2644.53,tax_payment,out,Counterparty_41,21966550.29,2025-02-02,2025-03-06
2025-03-03,7428.51,investment_income,in,Counterparty_74,21973978.8,,
2025-03-03,562.46,T&E,out,Counterparty_31,21973416.34,2025-02-01,2025-03-04
2025-03-03,3248.36,software_subscription,out,Counterparty_41,21970167.98,2025-02-01,2025-02-27
2025-03-03,1951.68,investment_income,in,Counterparty_80,21972119.66,,
2025-03-03,135.54,rent,out,Counterparty_64,21971984.12,2025-01-18,2025-02-26
2025-03-03,954.06,payroll,out,Counterparty_96,21971030.06,2025-02-09,2025-03-16
2025-03-03,8933.76,credit,in,Counterparty_84,21979963.82,,
2025-03-03,4146.49,refund,in,Counterparty_73,21984110.31,,
2025-03-03,12493.9,utilities,out,Counterparty_97,21971616.41,2025-01-31,2025-03-10
2025-03-03,1191.65,marketing_spend,out,Counterparty_69,21970424.76,2025-02-06,2025-03-15
2025-03-03,2682.7,supplier_payment,out,Counterparty_74,21967742.06,2025-01-25,2025-03-01
2025-03-03,16380.29,investment_income,in,Counterparty_49,21984122.35,,
2025-03-03,12061.08,investment_income,in,Counterparty_55,21996183.43,,
2025-03-03,8816.05,loan_repayment,out,Counterparty_39,21987367.38,2025-01-26,2025-02-27
2025-03-03,8494.87,investment_income,in,Counterparty_84,21995862.25,,
2025-03-03,1800.39,marketing_spend,out,Counterparty_97,21994061.86,2025-01-20,2025-02-26
2025-03-03,984.85,credit,in,Counterparty_25,21995046.71,,
2025-03-03,1480.85,supplier_payment,out,Counterparty_14,21993565.86,2025-01-29,2025-03-09
2025-03-04,2707.29,asset_sale,in,Counterparty_78,21996273.15,,
2025-03-04,20406.34,customer_payment,in,Counterparty_7,22016679.49,,
2025-03-04,35090.96,supplier_payment,out,Counterparty_94,21981588.53,2025-02-14,2025-03-19
2025-03-04,7292.45,credit,in,Counterparty_89,21988880.98,,
2025-03-04,1360.41,utilities,out,Counterparty_40,21987520.57,2025-01-31,2025-03-02
2025-03-04,1317.32,payroll,out,Counterparty_27,21986203.25,2025-02-11,2025-03-18
2025-03-04,4901.65,loan_repayment,out,Counterparty_94,21981301.6,2025-02-10,2025-03-09
2025-03-04,3445.12,credit,in,Counterparty_87,21984746.72,,
2025-03-04,4786.53,credit,in,Counterparty_34,21989533.25,,
2025-03-04,3720.5,rent,out,Counterparty_85,21985812.75,2025-02-06,2025-03-12
2025-03-04,156.88,customer_payment,in,Counterparty_88,21985969.63,,
2025-03-04,3260.45,customer_payment,in,Counterparty_38,21989230.08,,
2025-03-04,8209.73,customer_payment,in,Counterparty_13,21997439.81,,
2025-03-04,3221.31,asset_sale,in,Counterparty_91,22000661.12,,
2025-03-04,2767.15,supplier_payment,out,Counterparty_35,21997893.97,2025-01-24,2025-03-03
2025-03-04,10333.52,customer_payment,in,Counterparty_97,22008227.49,,
2025-03-04,2974.35,refund,in,Counterparty_17,22011201.84,,
2025-03-04,3686.58,marketing_spend,out,Counterparty_86,22007515.26,2025-02-03,2025-03-04
2025-03-04,3712.08,T&E,out,Counterparty_68,22003803.18,2025-02-11,2025-03-20
2025-03-04,1345.68,asset_sale,in,Counterparty_1,22005148.86,,
2025-03-04,4914.49,loan_repayment,out,Counterparty_74,22000234.37,2025-02-06,2025-03-07
2025-03-04,74.77,loan_repayment,out,Counterparty_18,22000159.6,2025-02-04,2025-03-12
2025-03-04,846.66,payroll,out,Counterparty_99,21999312.94,2025-01-20,2025-02-16
2025-03-04,2650.19,payroll,out,Counterparty_59,21996662.75,2025-02-11,2025-03-15
2025-03-04,1370.58,payroll,out,Counterparty_98,21995292.17,2025-01-26,2025-02-21
2025-03-04,5490.59,tax_payment,out,Counterparty_72,21989801.58,2025-02-05,2025-03-10
2025-03-04,2908.17,customer_payment,in,Counterparty_15,21992709.75,,
2025-03-04,6600.28,rent,out,Counterparty_53,21986109.47,2025-01-25,2025-03-04
2025-03-04,28115.82,credit,in,Counterparty_81,22014225.29,,
2025-03-04,4013.08,asset_sale,in,Counterparty_45,22018238.37,,
2025-03-04,520.7,customer_payment,in,Counterparty_31,22018759.07,,
2025-03-04,822.11,utilities,out,Counterparty_16,22017936.96,2025-01-19,2025-02-18
2025-03-04,1848.61,T&E,out,Counterparty_64,22016088.35,2025-02-07,2025-03-05
2025-03-04,3995.86,T&E,out,Counterparty_52,22012092.49,2025-02-09,2025-03-11
2025-03-04,6897.72,marketing_spend,out,Counterparty_68,22005194.77,2025-01-21,2025-02-21
2025-03-04,2413.97,credit,in,Counterparty_11,22007608.74,,
2025-03-04,2060.34,investment_income,in,Counterparty_42,22009669.08,,
2025-03-04,702.48,refund,in,Counterparty_61,22010371.56,,
2025-03-04,4078.5,T&E,out,Counterparty_51,22006293.06,2025-02-15,2025-03-20
2025-03-04,2336.61,marketing_spend,out,Counterparty_29,22003956.45,2025-01-30,2025-02-25
2025-03-04,6076.45,loan_repayment,out,Counterparty_41,21997880.0,2025-02-16,2025-03-16
2025-03-04,354.14,utilities,out,Counterparty_13,21997525.86,2025-01-19,2025-02-16
2025-03-04,558.59,tax_payment,out,Counterparty_46,21996967.27,2025-01-19,2025-02-24
2025-03-04,187.51,tax_payment,out,Counterparty_34,21996779.76,2025-01-22,2025-02-20
2025-03-04,8218.39,investment_income,in,Counterparty_58,22004998.15,,
2025-03-04,2213.56,tax_payment,out,Counterparty_99,22002784.59,2025-02-04,2025-03-12
2025-03-04,5100.29,investment_income,in,Counterparty_2,22007884.88,,
2025-03-04,1171.93,investment_income,in,Counterparty_41,22009056.81,,
2025-03-04,20919.74,credit,in,Counterparty_44,22029976.55,,
2025-03-04,3347.11,T&E,out,Counterparty_50,22026629.44,2025-02-10,2025-03-16
2025-03-04,3108.52,software_subscription,out,Counterparty_39,22023520.92,2025-02-07,2025-03-15
2025-03-04,7037.83,refund,in,Counterparty_48,22030558.75,,
2025-03-04,1517.51,tax_payment,out,Counterparty_91,22029041.24,2025-02-06,2025-03-11
2025-03-04,14050.65,refund,in,Counterparty_72,22043091.89,,
2025-03-04,19501.58,customer_payment,in,Counterparty_26,22062593.47,,
2025-03-04,7972.32,customer_payment,in,Counterparty_28,22070565.79,,
2025-03-04,623.33,supplier_payment,out,Counterparty_63,22069942.46,2025-02-04,2025-03-08
2025-03-04,7718.64,refund,in,Counterparty_86,22077661.1,,
2025-03-04,1576.42,loan_repayment,out,Counterparty_63,22076084.68,2025-02-17,2025-03-19
2025-03-04,1729.84,T&E,out,Counterparty_36,22074354.84,2025-01-25,2025-02-27
2025-03-04,585.08,utilities,out,Counterparty_25,22073769.76,2025-02-08,2025-03-16
2025-03-04,4387.86,T&E,out,Counterparty_90,22069381.9,2025-01-27,2025-03-04
2025-03-04,1938.45,utilities,out,Counterparty_52,22067443.45,2025-02-02,2025-03-02
2025-03-04,3132.37,payroll,out,Counterparty_74,22064311.08,2025-02-02,2025-02-28
2025-03-04,6523.14,customer_payment,in,Counterparty_67,22070834.22,,
2025-03-04,5998.84,customer_payment,in,Counterparty_58,22076833.06,,
2025-03-04,994.71,tax_payment,out,Counterparty_8,22075838.35,2025-02-02,2025-02-28
2025-03-04,2308.87,credit,in,Counterparty_71,22078147.22,,
2025-03-04,6291.43,customer_payment,in,Counterparty_76,22084438.65,,
2025-03-04,7474.84,customer_payment,in,Counterparty_56,22091913.49,,
2025-03-05,10111.42,asset_sale,in,Counterparty_67,22102024.91,,
2025-03-05,334.33,asset_sale,in,Counterparty_62,22102359.24,,
2025-03-05,3529.75,T&E,out,Counterparty_38,22098829.49,2025-01-24,2025-02-22
2025-03-05,6490.53,refund,in,Counterparty_75,22105320.02,,
2025-03-05,2184.44,credit,in,Counterparty_98,22107504.46,,
2025-03-05,1062.39,marketing_spend,out,Counterparty_61,22106442.07,2025-01-20,2025-02-14
2025-03-05,2191.04,software_subscription,out,Counterparty_55,22104251.03,2025-02-09,2025-03-11
2025-03-05,1871.42,rent,out,Counterparty_9,22102379.61,2025-02-10,2025-03-10
2025-03-05,2764.7,utilities,out,Counterparty_12,22099614.91,2025-01-25,2025-02-25
2025-03-05,13482.04,asset_sale,in,Counterparty_16,22113096.95,,
2025-03-05,3978.68,credit,in,Counterparty_85,22117075.63,,
2025-03-05,177.08,supplier_payment,out,Counterparty_35,22116898.55,2025-02-15,2025-03-17
2025-03-05,470.94,software_subscription,out,Counterparty_68,22116427.61,2025-02-15,2025-03-18
2025-03-05,1068.74,credit,in,Counterparty_32,22117496.35,,
2025-03-05,5720.08,investment_income,in,Counterparty_14,22123216.43,,
2025-03-05,776.71,rent,out,Counterparty_30,22122439.72,2025-01-22,2025-02-24
2025-03-05,1311.28,refund,in,Counterparty_60,22123751.0,,
2025-03-05,5310.69,rent,out,Counterparty_2,22118440.31,2025-02-10,2025-03-14
2025-03-05,19517.41,asset_sale,in,Counterparty_79,22137957.72,,
2025-03-05,3215.58,credit,in,Counterparty_84,22141173.3,,
2025-03-05,4498.33,asset_sale,in,Counterparty_10,22145671.63,,
2025-03-05,694.22,utilities,out,Counterparty_34,22144977.41,2025-02-10,2025-03-13
2025-03-05,10305.99,asset_sale,in,Counterparty_97,22155283.4,,
2025-03-05,13947.73,credit,in,Counterparty_82,22169231.13,,
2025-03-05,1690.67,rent,out,Counterparty_58,22167540.46,2025-02-16,2025-03-17
2025-03-05,2383.92,investment_income,in,Counterparty_10,22169924.38,,
2025-03-05,6475.22,asset_sale,in,Counterparty_3,22176399.6,,
2025-03-05,1480.58,rent,out,Counterparty_5,22174919.02,2025-02-09,2025-03-17
2025-03-05,259.31,rent,out,Counterparty_96,22174659.71,2025-02-17,2025-03-16
2025-03-05,18964.86,credit,in,Counterparty_27,22193624.57,,
2025-03-05,3013.54,loan_repayment,out,Counterparty_62,22190611.03,2025-02-17,2025-03-14
2025-03-05,4834.64,refund,in,Counterparty_13,22195445.67,,
2025-03-05,3625.85,payroll,out,Counterparty_1,22191819.82,2025-02-15,2025-03-20
2025-03-05,9112.28,customer_payment,in,Counterparty_9,22200932.1,,
2025-03-05,2530.92,credit,in,Counterparty_14,22203463.02,,
2025-03-05,3579.27,marketing_spend,out,Counterparty_92,22199883.75,2025-02-13,2025-03-11
2025-03-05,905.19,utilities,out,Counterparty_77,22198978.56,2025-02-17,2025-03-19
2025-03-05,3512.32,supplier_payment,out,Counterparty_15,22195466.24,2025-02-05,2025-03-09
2025-03-05,360.74,utilities,out,Counterparty_41,22195105.5,2025-01-28,2025-02-28
2025-03-05,567.53,loan_repayment,out,Counterparty_80,22194537.97,2025-02-08,2025-03-17
2025-03-05,2314.51,marketing_spend,out,Counterparty_25,22192223.46,2025-01-31,2025-02-28
2025-03-05,708.28,tax_payment,out,Counterparty_46,22191515.18,2025-01-25,2025-02-27
2025-03-05,211.5,supplier_payment,out,Counterparty_88,22191303.68,2025-02-02,2025-03-11
2025-03-05,3183.28,loan_repayment,out,Counterparty_9,22188120.4,2025-01-20,2025-02-18
2025-03-05,2345.21,marketing_spend,out,Counterparty_2,22185775.19,2025-01-27,2025-02-24
2025-03-05,2823.8,loan_repayment,out,Counterparty_41,22182951.39,2025-02-02,2025-03-06
2025-03-05,5968.23,loan_repayment,out,Counterparty_57,22176983.16,2025-02-13,2025-03-22
2025-03-05,16417.01,customer_payment,in,Counterparty_55,22193400.17,,
2025-03-05,10820.86,refund,in,Counterparty_7,22204221.03,,
2025-03-05,18270.19,customer_payment,in,Counterparty_61,22222491.22,,
2025-03-05,2089.3,T&E,out,Counterparty_79,22220401.92,2025-02-18,2025-03-22
2025-03-05,1913.05,refund,in,Counterparty_71,22222314.97,,
2025-03-05,476.3,marketing_spend,out,Counterparty_49,22221838.67,2025-02-07,2025-03-05
2025-03-05,2668.33,T&E,out,Counterparty_8,22219170.34,2025-01-27,2025-03-05
2025-03-05,668.33,credit,in,Counterparty_88,22219838.67,,
2025-03-05,77.57,supplier_payment,out,Counterparty_93,22219761.1,2025-02-10,2025-03-09
2025-03-05,4000.11,marketing_spend,out,Counterparty_70,22215760.99,2025-02-07,2025-03-10
2025-03-05,9061.84,refund,in,Counterparty_40,22224822.83,,
2025-03-05,168.42,rent,out,Counterparty_35,22224654.41,2025-01-31,2025-03-03
2025-03-05,2254.78,utilities,out,Counterparty_72,22222399.63,2025-01-26,2025-02-26
2025-03-05,1294.42,customer_payment,in,Counterparty_95,22223694.05,,
2025-03-06,15362.87,asset_sale,in,Counterparty_4,22239056.92,,
2025-03-06,10370.95,investment_income,in,Counterparty_62,22249427.87,,
2025-03-06,2719.72,T&E,out,Counterparty_11,22246708.15,2025-01-26,2025-03-06
2025-03-06,1023.14,asset_sale,in,Counterparty_89,22247731.29,,
2025-03-06,3309.34,supplier_payment,out,Counterparty_8,22244421.95,2025-02-16,2025-03-25
2025-03-06,666.75,asset_sale,in,Counterparty_26,22245088.7,,
2025-03-06,1218.71,loan_repayment,out,Counterparty_74,22243869.99,2025-02-10,2025-03-15
2025-03-06,10937.88,T&E,out,Counterparty_30,22232932.11,2025-01-28,2025-03-04
2025-03-06,1196.76,customer_payment,in,Counterparty_36,22234128.87,,
2025-03-06,1947.7,utilities,out,Counterparty_37,22232181.17,2025-02-03,2025-03-11
2025-03-06,1289.98,T&E,out,Counterparty_16,22230891.19,2025-02-01,2025-03-05
2025-03-06,6633.48,software_subscription,out,Counterparty_48,22224257.71,2025-02-09,2025-03-18
2025-03-06,7130.36,marketing_spend,out,Counterparty_83,22217127.35,2025-02-13,2025-03-11
2025-03-06,6697.51,customer_payment,in,Counterparty_93,22223824.86,,
2025-03-06,97.5,loan_repayment,out,Counterparty_93,22223727.36,2025-02-17,2025-03-19
2025-03-06,2312.42,marketing_spend,out,Counterparty_45,22221414.94,2025-02-13,2025-03-11
2025-03-06,455.23,payroll,out,Counterparty_80,22220959.71,2025-02-11,2025-03-21
2025-03-06,943.22,supplier_payment,out,Counterparty_35,22220016.49,2025-02-18,2025-03-20
2025-03-06,423.38,payroll,out,Counterparty_94,22219593.11,2025-02-02,2025-03-10
2025-03-06,3521.21,credit,in,Counterparty_41,22223114.32,,
2025-03-06,6679.01,tax_payment,out,Counterparty_41,22216435.31,2025-02-13,2025-03-16
2025-03-06,453.19,payroll,out,Counterparty_98,22215982.12,2025-01-23,2025-02-27
2025-03-06,1707.1,supplier_payment,out,Counterparty_43,22214275.02,2025-01-22,2025-02-16
2025-03-06,11343.93,tax_payment,out,Counterparty_46,22202931.09,2025-02-15,2025-03-15
2025-03-06,12519.72,supplier_payment,out,Counterparty_95,22190411.37,2025-01-27,2025-03-07
2025-03-06,5431.02,utilities,out,Counterparty_94,22184980.35,2025-02-11,2025-03-13
2025-03-06,2199.12,utilities,out,Counterparty_61,22182781.23,2025-02-14,2025-03-25
2025-03-06,2206.66,T&E,out,Counterparty_61,22180574.57,2025-01-26,2025-03-05
2025-03-06,5762.97,credit,in,Counterparty_61,22186337.54,,
2025-03-06,9582.49,rent,out,Counterparty_45,22176755.05,2025-02-12,2025-03-21
2025-03-06,3165.58,T&E,out,Counterparty_32,22173589.47,2025-01-21,2025-02-25
2025-03-06,304.77,T&E,out,Counterparty_23,22173284.7,2025-02-13,2025-03-11
2025-03-06,127.51,loan_repayment,out,Counterparty_39,22173157.19,2025-01-23,2025-02-20
2025-03-06,1014.87,customer_payment,in,Counterparty_70,22174172.06,,
2025-03-06,5672.89,investment_income,in,Counterparty_62,22179844.95,,
2025-03-06,3609.3,refund,in,Counterparty_39,22183454.25,,
2025-03-06,1999.74,supplier_payment,out,Counterparty_76,22181454.51,2025-01-25,2025-03-03
2025-03-06,4553.66,credit,in,Counterparty_63,22186008.17,,
2025-03-06,6697.79,investment_income,in,Counterparty_42,22192705.96,,
2025-03-06,4192.6,payroll,out,Counterparty_57,22188513.36,2025-02-01,2025-03-09
2025-03-06,22.5,credit,in,Counterparty_43,22188535.86,,
2025-03-06,8652.48,refund,in,Counterparty_87,22197188.34,,
2025-03-06,136.86,rent,out,Counterparty_83,22197051.48,2025-02-14,2025-03-12
2025-03-06,12680.24,investment_income,in,Counterparty_48,22209731.72,,
2025-03-06,358.3,T&E,out,Counterparty_10,22209373.42,2025-02-17,2025-03-18
2025-03-06,2742.97,supplier_payment,out,Counterparty_84,22206630.45,2025-01-23,2025-02-28
2025-03-06,1011.83,rent,out,Counterparty_50,22205618.62,2025-02-03,2025-03-01
2025-03-06,9241.25,refund,in,Counterparty_83,22214859.87,,
2025-03-06,11037.18,asset_sale,in,Counterparty_36,22225897.05,,
2025-03-06,3113.51,software_subscription,out,Counterparty_7,22222783.54,2025-01-30,2025-02-24
2025-03-06,7488.85,asset_sale,in,Counterparty_31,22230272.39,,
2025-03-06,1518.3,tax_payment,out,Counterparty_17,22228754.09,2025-02-16,2025-03-17
2025-03-06,13770.63,rent,out,Counterparty_79,22214983.46,2025-02-02,2025-02-28
2025-03-06,3006.65,payroll,out,Counterparty_51,22211976.81,2025-01-26,2025-03-03
2025-03-06,5177.93,investment_income,in,Counterparty_46,22217154.74,,
2025-03-06,1863.07,customer_payment,in,Counterparty_40,22219017.81,,
2025-03-06,2054.47,marketing_spend,out,Counterparty_33,22216963.34,2025-01-24,2025-03-02
2025-03-06,1304.62,T&E,out,Counterparty_5,22215658.72,2025-01-24,2025-02-24
2025-03-06,5459.5,software_subscription,out,Counterparty_33,22210199.22,2025-02-04,2025-03-15
2025-03-06,5267.18,customer_payment,in,Counterparty_72,22215466.4,,
2025-03-06,416.02,investment_income,in,Counterparty_8,22215882.42,,
2025-03-06,65.49,payroll,out,Counterparty_79,22215816.93,2025-02-04,2025-03-06
2025-03-06,2558.53,marketing_spend,out,Counterparty_25,22213258.4,2025-02-03,2025-03-01
2025-03-06,12361.81,refund,in,Counterparty_21,22225620.21,,
2025-03-06,782.1,marketing_spend,out,Counterparty_49,22224838.11,2025-01-26,2025-03-03
2025-03-06,2936.17,customer_payment,in,Counterparty_26,22227774.28,,
2025-03-06,4276.46,software_subscription,out,Counterparty_21,22223497.82,2025-02-11,2025-03-08
2025-03-06,319.49,tax_payment,out,Counterparty_72,22223178.33,2025-01-29,2025-02-23
2025-03-06,1325.25,asset_sale,in,Counterparty_98,22224503.58,,
2025-03-06,2586.54,supplier_payment,out,Counterparty_1,22221917.04,2025-01-29,2025-03-08
2025-03-07,2539.41,rent,out,Counterparty_7,22219377.63,2025-02-04,2025-03-03
2025-03-07,495.51,investment_income,in,Counterparty_13,22219873.14,,
2025-03-07,1463.18,payroll,out,Counterparty_6,22218409.96,2025-01-26,2025-02-24
2025-03-07,3063.89,marketing_spend,out,Counterparty_81,22215346.07,2025-01-25,2025-03-05
2025-03-07,662.17,payroll,out,Counterparty_6,22214683.9,2025-02-11,2025-03-13
2025-03-07,12910.46,asset_sale,in,Counterparty_98,22227594.36,,
2025-03-07,6262.72,T&E,out,Counterparty_18,22221331.64,2025-02-02,2025-03-11
2025-03-07,3458.66,asset_sale,in,Counterparty_66,22224790.3,,
2025-03-07,1060.87,loan_repayment,out,Counterparty_99,22223729.43,2025-02-13,2025-03-10
2025-03-07,8348.17,investment_income,in,Counterparty_54,22232077.6,,
2025-03-07,226.32,credit,in,Counterparty_58,22232303.92,,
2025-03-07,311.61,supplier_payment,out,Counterparty_9,22231992.31,2025-02-08,2025-03-19
2025-03-07,15739.01,asset_sale,in,Counterparty_62,22247731.32,,
2025-03-07,4747.35,tax_payment,out,Counterparty_74,22242983.97,2025-02-11,2025-03-08
2025-03-07,3754.0,asset_sale,in,Counterparty_43,22246737.97,,
2025-03-07,386.01,asset_sale,in,Counterparty_81,22247123.98,,
2025-03-07,2216.65,investment_income,in,Counterparty_98,22249340.63,,
2025-03-07,1126.7,utilities,out,Counterparty_69,22248213.93,2025-01-28,2025-03-01
2025-03-07,2678.14,customer_payment,in,Counterparty_25,22250892.07,,
2025-03-07,8662.69,utilities,out,Counterparty_9,22242229.38,2025-01-29,2025-03-02
2025-03-07,3328.64,investment_income,in,Counterparty_42,22245558.02,,
2025-03-07,1708.43,marketing_spend,out,Counterparty_52,22243849.59,2025-02-07,2025-03-18
2025-03-07,8021.35,investment_income,in,Counterparty_41,22251870.94,,
2025-03-07,1012.8,customer_payment,in,Counterparty_87,22252883.74,,
2025-03-07,5912.58,asset_sale,in,Counterparty_52,22258796.32,,
2025-03-07,1274.43,customer_payment,in,Counterparty_6,22260070.75,,
2025-03-07,5812.15,customer_payment,in,Counterparty_27,22265882.9,,
2025-03-07,6281.74,rent,out,Counterparty_50,22259601.16,2025-02-03,2025-03-05
2025-03-07,1102.07,credit,in,Counterparty_92,22260703.23,,
2025-03-07,3794.55,refund,in,Counterparty_51,22264497.78,,
2025-03-07,6503.77,credit,in,Counterparty_67,22271001.55,,
2025-03-07,6393.14,tax_payment,out,Counterparty_31,22264608.41,2025-01-31,2025-03-10
2025-03-07,385.75,payroll,out,Counterparty_82,22264222.66,2025-01-25,2025-03-02
2025-03-07,5927.76,refund,in,Counterparty_58,22270150.42,,
2025-03-07,1610.24,asset_sale,in,Counterparty_57,22271760.66,,
2025-03-07,373.92,software_subscription,out,Counterparty_37,22271386.74,2025-01-26,2025-03-03
2025-03-07,5433.11,marketing_spend,out,Counterparty_22,22265953.63,2025-02-05,2025-03-09
2025-03-07,5673.88,customer_payment,in,Counterparty_82,22271627.51,,
2025-03-07,5828.85,investment_income,in,Counterparty_93,22277456.36,,
2025-03-07,4349.75,supplier_payment,out,Counterparty_49,22273106.61,2025-01-24,2025-02-25
2025-03-07,1986.53,customer_payment,in,Counterparty_22,22275093.14,,
2025-03-07,384.84,refund,in,Counterparty_44,22275477.98,,
2025-03-07,7474.02,marketing_spend,out,Counterparty_62,22268003.96,2025-02-08,2025-03-17
2025-03-07,8387.15,customer_payment,in,Counterparty_6,22276391.11,,
2025-03-07,8845.56,software_subscription,out,Counterparty_41,22267545.55,2025-02-13,2025-03-22
2025-03-07,4.11,payroll,out,Counterparty_72,22267541.44,2025-01-27,2025-02-26
2025-03-07,1348.0,utilities,out,Counterparty_41,22266193.44,2025-01-25,2025-03-04
2025-03-07,5710.93,refund,in,Counterparty_3,22271904.37,,
2025-03-07,5955.7,customer_payment,in,Counterparty_85,22277860.07,,
2025-03-07,5601.89,credit,in,Counterparty_16,22283461.96,,
2025-03-07,9250.61,investment_income,in,Counterparty_69,22292712.57,,
2025-03-07,2548.52,utilities,out,Counterparty_82,22290164.05,2025-02-18,2025-03-28
2025-03-07,1864.51,supplier_payment,out,Counterparty_94,22288299.54,2025-01-22,2025-02-27
2025-03-08,64.08,asset_sale,in,Counterparty_37,22288363.62,,
2025-03-08,986.7,software_subscription,out,Counterparty_35,22287376.92,2025-01-28,2025-02-24
2025-03-08,5041.25,tax_payment,out,Counterparty_2,22282335.67,2025-02-20,2025-03-22
2025-03-08,5146.63,utilities,out,Counterparty_67,22277189.04,2025-02-05,2025-03-05
2025-03-08,3155.06,software_subscription,out,Counterparty_64,22274033.98,2025-01-27,2025-02-25
2025-03-08,4696.86,software_subscription,out,Counterparty_96,22269337.12,2025-02-11,2025-03-12
2025-03-08,20777.24,customer_payment,in,Counterparty_64,22290114.36,,
2025-03-08,2210.01,asset_sale,in,Counterparty_24,22292324.37,,
2025-03-08,1864.77,asset_sale,in,Counterparty_98,22294189.14,,
2025-03-08,6166.44,customer_payment,in,Counterparty_21,22300355.58,,
2025-03-08,5481.93,T&E,out,Counterparty_54,22294873.65,2025-01-31,2025-02-26
2025-03-08,764.24,payroll,out,Counterparty_53,22294109.41,2025-02-02,2025-03-01
2025-03-08,1075.78,loan_repayment,out,Counterparty_1,22293033.63,2025-02-16,2025-03-27
2025-03-08,1191.45,supplier_payment,out,Counterparty_52,22291842.18,2025-02-12,2025-03-09
2025-03-08,14600.47,refund,in,Counterparty_26,22306442.65,,
2025-03-08,5889.79,rent,out,Counterparty_92,22300552.86,2025-02-15,2025-03-23
2025-03-08,520.35,marketing_spend,out,Counterparty_83,22300032.51,2025-02-18,2025-03-23
2025-03-08,178.61,supplier_payment,out,Counterparty_47,22299853.9,2025-02-20,2025-03-22
2025-03-08,2630.07,asset_sale,in,Counterparty_90,22302483.97,,
2025-03-08,1654.22,refund,in,Counterparty_23,22304138.19,,
2025-03-08,2749.65,rent,out,Counterparty_16,22301388.54,2025-02-05,2025-03-16
2025-03-08,232.53,asset_sale,in,Counterparty_2,22301621.07,,
2025-03-08,1304.64,credit,in,Counterparty_26,22302925.71,,
2025-03-08,5780.91,credit,in,Counterparty_96,22308706.62,,
2025-03-08,5676.62,refund,in,Counterparty_25,22314383.24,,
2025-03-08,997.67,software_subscription,out,Counterparty_95,22313385.57,2025-02-09,2025-03-17
2025-03-08,795.23,investment_income,in,Counterparty_11,22314180.8,,
2025-03-08,186.1,supplier_payment,out,Counterparty_28,22313994.7,2025-02-08,2025-03-19
2025-03-08,1366.48,software_subscription,out,Counterparty_90,22312628.22,2025-01-31,2025-02-26
2025-03-08,2527.23,tax_payment,out,Counterparty_24,22310100.99,2025-02-11,2025-03-22
2025-03-08,3377.13,software_subscription,out,Counterparty_50,22306723.86,2025-02-16,2025-03-22
2025-03-08,326.78,payroll,out,Counterparty_83,22306397.08,2025-02-05,2025-03-07
2025-03-08,541.27,marketing_spend,out,Counterparty_5,22305855.81,2025-02-15,2025-03-26
2025-03-08,918.89,rent,out,Counterparty_60,22304936.92,2025-02-12,2025-03-23
2025-03-08,6502.11,credit,in,Counterparty_84,22311439.03,,
2025-03-08,4902.34,utilities,out,Counterparty_15,22306536.69,2025-02-19,2025-03-29
2025-03-08,4453.27,investment_income,in,Counterparty_2,22310989.96,,
2025-03-08,1413.81,tax_payment,out,Counterparty_17,22309576.15,2025-02-03,2025-03-11
2025-03-08,62.17,payroll,out,Counterparty_98,22309513.98,2025-02-06,2025-03-09
2025-03-08,101.87,refund,in,Counterparty_7,22309615.85,,
2025-03-08,14692.6,refund,in,Counterparty_8,22324308.45,,
2025-03-08,1719.74,supplier_payment,out,Counterparty_46,22322588.71,2025-02-20,2025-03-31
2025-03-08,9598.06,credit,in,Counterparty_47,22332186.77,,
2025-03-08,2037.26,investment_income,in,Counterparty_54,22334224.03,,
2025-03-08,1956.07,software_subscription,out,Counterparty_19,22332267.96,2025-02-08,2025-03-16
2025-03-08,1551.97,investment_income,in,Counterparty_8,22333819.93,,
2025-03-08,665.8,payroll,out,Counterparty_1,22333154.13,2025-01-25,2025-02-22
2025-03-09,2422.87,payroll,out,Counterparty_50,22330731.26,2025-02-02,2025-03-11
2025-03-09,5064.28,credit,in,Counterparty_73,22335795.54,,
2025-03-09,9113.04,credit,in,Counterparty_19,22344908.58,,
2025-03-09,733.36,tax_payment,out,Counterparty_49,22344175.22,2025-01-30,2025-03-03
2025-03-09,1414.11,loan_repayment,out,Counterparty_29,22342761.11,2025-02-08,2025-03-11
2025-03-09,7728.39,investment_income,in,Counterparty_36,22350489.5,,
2025-03-09,2531.9,utilities,out,Counterparty_35,22347957.6,2025-01-30,2025-03-02
2025-03-09,3798.61,customer_payment,in,Counterparty_21,22351756.21,,
2025-03-09,6251.11,rent,out,Counterparty_82,22345505.1,2025-02-01,2025-02-26
2025-03-09,20981.43,investment_income,in,Counterparty_55,22366486.53,,
2025-03-09,10663.24,customer_payment,in,Counterparty_97,22377149.77,,
2025-03-09,4953.69,supplier_payment,out,Counterparty_86,22372196.08,2025-02-08,2025-03-06
2025-03-09,126.65,tax_payment,out,Counterparty_94,22372069.43,2025-02-22,2025-03-31
2025-03-09,3783.96,software_subscription,out,Counterparty_26,22368285.47,2025-01-28,2025-03-07
2025-03-09,1823.57,utilities,out,Counterparty_39,22366461.9,2025-02-01,2025-02-26
2025-03-09,1774.74,refund,in,Counterparty_56,22368236.64,,
2025-03-09,264.95,utilities,out,Counterparty_69,22367971.69,2025-01-24,2025-02-25
2025-03-09,982.66,supplier_payment,out,Counterparty_97,22366989.03,2025-02-14,2025-03-13
2025-03-09,1338.85,customer_payment,in,Counterparty_88,22368327.88,,
2025-03-09,4164.14,supplier_payment,out,Counterparty_97,22364163.74,2025-01-26,2025-02-23
2025-03-09,155.81,supplier_payment,out,Counterparty_10,22364007.93,2025-02-14,2025-03-19
2025-03-09,3858.76,payroll,out,Counterparty_41,22360149.17,2025-02-04,2025-03-06
2025-03-09,1350.85,supplier_payment,out,Counterparty_8,22358798.32,2025-01-29,2025-02-23
2025-03-09,336.2,payroll,out,Counterparty_73,22358462.12,2025-02-16,2025-03-15
2025-03-09,4077.36,credit,in,Counterparty_23,22362539.48,,
2025-03-09,4973.19,asset_sale,in,Counterparty_29,22367512.67,,
2025-03-09,349.16,supplier_payment,out,Counterparty_59,22367163.51,2025-02-05,2025-03-15
2025-03-09,6688.53,investment_income,in,Counterparty_88,22373852.04,,
2025-03-09,7520.28,supplier_payment,out,Counterparty_42,22366331.76,2025-02-03,2025-02-28
2025-03-09,6324.8,refund,in,Counterparty_12,22372656.56,,
2025-03-09,3536.03,software_subscription,out,Counterparty_30,22369120.53,2025-02-10,2025-03-14
2025-03-09,1629.04,utilities,out,Counterparty_49,22367491.49,2025-01-25,2025-02-27
2025-03-09,1306.55,tax_payment,out,Counterparty_42,22366184.94,2025-01-26,2025-02-25
2025-03-09,984.98,utilities,out,Counterparty_20,22365199.96,2025-01-24,2025-03-04
2025-03-09,1070.14,supplier_payment,out,Counterparty_69,22364129.82,2025-02-22,2025-03-19
2025-03-09,10189.34,asset_sale,in,Counterparty_11,22374319.16,,
2025-03-09,27610.39,refund,in,Counterparty_83,22401929.55,,
2025-03-09,1402.42,credit,in,Counterparty_43,22403331.97,,
2025-03-09,3936.54,tax_payment,out,Counterparty_58,22399395.43,2025-01-24,2025-02-19
2025-03-09,259.72,tax_payment,out,Counterparty_1,22399135.71,2025-02-16,2025-03-24
2025-03-09,3400.39,software_subscription,out,Counterparty_95,22395735.32,2025-02-12,2025-03-22
2025-03-09,212.88,utilities,out,Counterparty_69,22395522.44,2025-02-21,2025-04-01
2025-03-09,2215.98,supplier_payment,out,Counterparty_20,22393306.46,2025-02-20,2025-03-28
2025-03-09,1721.47,customer_payment,in,Counterparty_36,22395027.93,,
2025-03-09,1870.01,investment_income,in,Counterparty_5,22396897.94,,
2025-03-09,19639.23,customer_payment,in,Counterparty_49,22416537.17,,
2025-03-09,2305.46,rent,out,Counterparty_91,22414231.71,2025-02-20,2025-03-25
2025-03-09,107.15,supplier_payment,out,Counterparty_47,22414124.56,2025-02-01,2025-03-03
2025-03-09,3695.93,utilities,out,Counterparty_85,22410428.63,2025-01-30,2025-03-05
2025-03-09,10441.91,investment_income,in,Counterparty_53,22420870.54,,
2025-03-09,1419.94,investment_income,in,Counterparty_29,22422290.48,,
2025-03-09,7985.75,marketing_spend,out,Counterparty_81,22414304.73,2025-01-26,2025-03-05
2025-03-09,404.09,loan_repayment,out,Counterparty_64,22413900.64,2025-02-19,2025-03-22
2025-03-09,74.63,tax_payment,out,Counterparty_39,22413826.01,2025-02-21,2025-03-20
2025-03-09,2338.35,payroll,out,Counterparty_65,22411487.66,2025-02-02,2025-03-08
2025-03-09,11951.98,rent,out,Counterparty_17,22399535.68,2025-02-20,2025-03-21
2025-03-09,1251.52,utilities,out,Counterparty_28,22398284.16,2025-02-05,2025-03-09
2025-03-09,3127.7,loan_repayment,out,Counterparty_30,22395156.46,2025-02-20,2025-03-22
2025-03-09,2921.42,supplier_payment,out,Counterparty_30,22392235.04,2025-02-09,2025-03-10
2025-03-09,7167.6,marketing_spend,out,Counterparty_48,22385067.44,2025-01-24,2025-02-20
2025-03-09,11008.37,marketing_spend,out,Counterparty_29,22374059.07,2025-02-07,2025-03-16
2025-03-09,6511.93,T&E,out,Counterparty_38,22367547.14,2025-02-14,2025-03-23
2025-03-09,3063.58,utilities,out,Counterparty_69,22364483.56,2025-01-28,2025-03-05
2025-03-10,5466.2,loan_repayment,out,Counterparty_83,22359017.36,2025-02-15,2025-03-18
2025-03-10,10017.66,utilities,out,Counterparty_77,22348999.7,2025-02-12,2025-03-15
2025-03-10,661.87,utilities,out,Counterparty_99,22348337.83,2025-02-20,2025-03-24
2025-03-10,432.91,rent,out,Counterparty_12,22347904.92,2025-01-30,2025-03-08
2025-03-10,581.08,refund,in,Counterparty_49,22348486.0,,
2025-03-10,4182.09,refund,in,Counterparty_49,22352668.09,,
2025-03-10,2426.57,credit,in,Counterparty_85,22355094.66,,
2025-03-10,4763.82,tax_payment,out,Counterparty_17,22350330.84,2025-01-30,2025-03-03
2025-03-10,2519.86,software_subscription,out,Counterparty_75,22347810.98,2025-02-20,2025-03-20
2025-03-10,4654.65,investment_income,in,Counterparty_63,22352465.63,,
2025-03-10,2886.52,T&E,out,Counterparty_72,22349579.11,2025-01-27,2025-03-01
2025-03-10,930.32,utilities,out,Counterparty_23,22348648.79,2025-01-29,2025-03-03
2025-03-10,8024.79,credit,in,Counterparty_77,22356673.58,,
2025-03-10,654.57,credit,in,Counterparty_71,22357328.15,,
2025-03-10,4924.61,investment_income,in,Counterparty_84,22362252.76,,
2025-03-10,10970.17,supplier_payment,out,Counterparty_81,22351282.59,2025-02-16,2025-03-27
2025-03-10,1051.28,loan_repayment,out,Counterparty_53,22350231.31,2025-02-21,2025-03-26
2025-03-10,5490.58,loan_repayment,out,Counterparty_4,22344740.73,2025-02-22,2025-03-26
2025-03-10,6264.66,software_subscription,out,Counterparty_17,22338476.07,2025-02-07,2025-03-08
2025-03-10,1493.25,supplier_payment,out,Counterparty_81,22336982.82,2025-02-12,2025-03-23
2025-03-10,12912.66,tax_payment,out,Counterparty_56,22324070.16,2025-01-27,2025-02-27
2025-03-10,4202.65,credit,in,Counterparty_61,22328272.81,,
2025-03-10,6209.75,marketing_spend,out,Counterparty_57,22322063.06,2025-02-16,2025-03-22
2025-03-10,13463.49,investment_income,in,Counterparty_86,22335526.55,,
2025-03-10,4878.3,software_subscription,out,Counterparty_81,22330648.25,2025-02-03,2025-03-01
2025-03-10,5889.63,loan_repayment,out,Counterparty_86,22324758.62,2025-02-09,2025-03-09
2025-03-10,2774.64,rent,out,Counterparty_53,22321983.98,2025-01-29,2025-03-02
2025-03-10,3364.06,credit,in,Counterparty_81,22325348.04,,
2025-03-10,8331.11,rent,out,Counterparty_91,22317016.93,2025-01-25,2025-02-22
2025-03-10,639.99,customer_payment,in,Counterparty_18,22317656.92,,
2025-03-10,426.15,loan_repayment,out,Counterparty_48,22317230.77,2025-02-08,2025-03-07
2025-03-10,1272.89,refund,in,Counterparty_11,22318503.66,,
2025-03-10,7076.15,credit,in,Counterparty_16,22325579.81,,
2025-03-10,1240.47,supplier_payment,out,Counterparty_27,22324339.34,2025-01-30,2025-03-08
2025-03-10,8064.05,investment_income,in,Counterparty_16,22332403.39,,
2025-03-10,1133.73,software_subscription,out,Counterparty_19,22331269.66,2025-01-31,2025-03-01
2025-03-10,29466.82,refund,in,Counterparty_85,22360736.48,,
2025-03-10,3409.6,refund,in,Counterparty_97,22364146.08,,
2025-03-10,4850.57,asset_sale,in,Counterparty_29,22368996.65,,
2025-03-10,15736.54,customer_payment,in,Counterparty_80,22384733.19,,
2025-03-10,873.79,rent,out,Counterparty_9,22383859.4,2025-02-07,2025-03-13
2025-03-10,4889.71,investment_income,in,Counterparty_83,22388749.11,,
2025-03-10,2377.31,loan_repayment,out,Counterparty_36,22386371.8,2025-02-20,2025-03-28
2025-03-10,3272.46,refund,in,Counterparty_37,22389644.26,,
2025-03-10,1073.41,credit,in,Counterparty_11,22390717.67,,
2025-03-10,15437.72,utilities,out,Counterparty_36,22375279.95,2025-01-27,2025-02-23
2025-03-10,3312.12,marketing_spend,out,Counterparty_33,22371967.83,2025-02-22,2025-03-27
2025-03-10,3912.36,utilities,out,Counterparty_5,22368055.47,2025-02-12,2025-03-20
2025-03-10,3071.19,software_subscription,out,Counterparty_43,22364984.28,2025-02-11,2025-03-16
2025-03-10,2412.89,tax_payment,out,Counterparty_69,22362571.39,2025-02-02,2025-03-09
2025-03-10,1054.18,marketing_spend,out,Counterparty_46,22361517.21,2025-02-19,2025-03-18
2025-03-10,2803.39,marketing_spend,out,Counterparty_63,22358713.82,2025-02-07,2025-03-15
2025-03-10,13758.06,refund,in,Counterparty_62,22372471.88,,
2025-03-11,7503.42,payroll,out,Counterparty_47,22364968.46,2025-02-18,2025-03-20
2025-03-11,6234.07,utilities,out,Counterparty_94,22358734.39,2025-02-03,2025-03-05
2025-03-11,1452.84,T&E,out,Counterparty_51,22357281.55,2025-02-13,2025-03-15
2025-03-11,11888.59,software_subscription,out,Counterparty_50,22345392.96,2025-02-17,2025-03-28
2025-03-11,25433.66,asset_sale,in,Counterparty_22,22370826.62,,
2025-03-11,364.8,credit,in,Counterparty_36,22371191.42,,
2025-03-11,1103.83,payroll,out,Counterparty_35,22370087.59,2025-01-30,2025-03-01
2025-03-11,752.55,investment_income,in,Counterparty_72,22370840.14,,
2025-03-11,932.03,customer_payment,in,Counterparty_27,22371772.17,,
2025-03-11,1896.71,asset_sale,in,Counterparty_43,22373668.88,,
2025-03-11,1741.06,utilities,out,Counterparty_26,22371927.82,2025-02-03,2025-03-09
2025-03-11,492.27,loan_repayment,out,Counterparty_58,22371435.55,2025-01-28,2025-02-24
2025-03-11,5144.46,asset_sale,in,Counterparty_78,22376580.01,,
2025-03-11,872.01,software_subscription,out,Counterparty_37,22375708.0,2025-02-23,2025-03-25
2025-03-11,1890.51,refund,in,Counterparty_29,22377598.51,,
2025-03-11,119.69,software_subscription,out,Counterparty_9,22377478.82,2025-02-18,2025-03-25
2025-03-11,11622.52,credit,in,Counterparty_62,22389101.34,,
2025-03-11,9644.28,refund,in,Counterparty_80,22398745.62,,
2025-03-11,4730.51,software_subscription,out,Counterparty_90,22394015.11,2025-02-17,2025-03-21
2025-03-11,12176.01,asset_sale,in,Counterparty_20,22406191.12,,
2025-03-11,12706.28,refund,in,Counterparty_75,22418897.4,,
2025-03-11,4347.64,supplier_payment,out,Counterparty_67,22414549.76,2025-02-19,2025-03-19
2025-03-11,2409.92,credit,in,Counterparty_26,22416959.68,,
2025-03-11,22324.99,investment_income,in,Counterparty_67,22439284.67,,
2025-03-11,4619.19,software_subscription,out,Counterparty_77,22434665.48,2025-02-12,2025-03-17
2025-03-11,399.8,marketing_spend,out,Counterparty_81,22434265.68,2025-02-15,2025-03-17
2025-03-11,3643.17,refund,in,Counterparty_21,22437908.85,,
2025-03-11,11941.17,investment_income,in,Counterparty_22,22449850.02,,
2025-03-11,2776.87,software_subscription,out,Counterparty_12,22447073.15,2025-02-03,2025-03-14
2025-03-11,715.46,payroll,out,Counterparty_76,22446357.69,2025-01-30,2025-03-03
2025-03-11,5444.36,software_subscription,out,Counterparty_54,22440913.33,2025-02-21,2025-03-20
2025-03-11,4140.42,utilities,out,Counterparty_26,22436772.91,2025-02-01,2025-02-26
2025-03-11,654.98,supplier_payment,out,Counterparty_97,22436117.93,2025-02-04,2025-03-10
2025-03-11,1702.07,software_subscription,out,Counterparty_2,22434415.86,2025-02-03,2025-03-09
2025-03-11,751.55,supplier_payment,out,Counterparty_10,22433664.31,2025-01-30,2025-02-25
2025-03-11,1988.8,marketing_spend,out,Counterparty_24,22431675.51,2025-02-16,2025-03-15
2025-03-11,2412.65,tax_payment,out,Counterparty_99,22429262.86,2025-02-05,2025-03-09
2025-03-11,19928.85,asset_sale,in,Counterparty_73,22449191.71,,
2025-03-11,5978.17,utilities,out,Counterparty_23,22443213.54,2025-02-12,2025-03-19
2025-03-11,2411.35,investment_income,in,Counterparty_59,22445624.89,,
2025-03-11,10334.66,asset_sale,in,Counterparty_66,22455959.55,,
2025-03-11,3495.74,credit,in,Counterparty_54,22459455.29,,
2025-03-11,887.98,investment_income,in,Counterparty_13,22460343.27,,
2025-03-11,9577.55,asset_sale,in,Counterparty_77,22469920.82,,
2025-03-11,5227.87,refund,in,Counterparty_10,22475148.69,,
2025-03-11,23387.27,refund,in,Counterparty_49,22498535.96,,
2025-03-11,327.68,software_subscription,out,Counterparty_31,22498208.28,2025-01-29,2025-02-25
2025-03-11,2182.68,customer_payment,in,Counterparty_56,22500390.96,,
2025-03-11,278.24,tax_payment,out,Counterparty_20,22500112.72,2025-02-11,2025-03-08
2025-03-11,4111.28,software_subscription,out,Counterparty_54,22496001.44,2025-02-16,2025-03-15
2025-03-11,4933.18,software_subscription,out,Counterparty_9,22491068.26,2025-02-01,2025-03-07
2025-03-12,782.27,payroll,out,Counterparty_15,22490285.99,2025-02-07,2025-03-09
2025-03-12,476.51,rent,out,Counterparty_87,22489809.48,2025-02-22,2025-04-02
2025-03-12,5399.37,refund,in,Counterparty_27,22495208.85,,
2025-03-12,20503.47,refund,in,Counterparty_13,22515712.32,,
2025-03-12,4310.4,supplier_payment,out,Counterparty_29,22511401.92,2025-02-17,2025-03-15
2025-03-12,1175.66,rent,out,Counterparty_20,22510226.26,2025-02-18,2025-03-26
2025-03-12,7544.07,supplier_payment,out,Counterparty_90,22502682.19,2025-02-20,2025-03-29
2025-03-12,4939.48,supplier_payment,out,Counterparty_89,22497742.71,2025-02-10,2025-03-20
2025-03-12,817.71,investment_income,in,Counterparty_14,22498560.42,,
2025-03-12,3617.03,rent,out,Counterparty_2,22494943.39,2025-02-13,2025-03-14
2025-03-12,2519.51,payroll,out,Counterparty_49,22492423.88,2025-02-16,2025-03-22
2025-03-12,3277.84,tax_payment,out,Counterparty_17,22489146.04,2025-02-03,2025-03-04
2025-03-12,72.7,rent,out,Counterparty_88,22489073.34,2025-02-07,2025-03-04
2025-03-12,132.13,utilities,out,Counterparty_85,22488941.21,2025-01-30,2025-03-05
2025-03-12,326.82,rent,out,Counterparty_45,22488614.39,2025-01-31,2025-02-25
2025-03-12,1057.55,utilities,out,Counterparty_81,22487556.84,2025-02-25,2025-04-01
2025-03-12,1868.54,software_subscription,out,Counterparty_4,22485688.3,2025-02-25,2025-04-01
2025-03-12,204.03,T&E,out,Counterparty_35,22485484.27,2025-02-07,2025-03-17
2025-03-12,3983.75,marketing_spend,out,Counterparty_97,22481500.52,2025-02-06,2025-03-03
2025-03-12,2041.28,payroll,out,Counterparty_34,22479459.24,2025-02-09,2025-03-09
2025-03-12,9062.59,marketing_spend,out,Counterparty_37,22470396.65,2025-02-23,2025-03-25
2025-03-12,2338.38,software_subscription,out,Counterparty_58,22468058.27,2025-01-28,2025-03-03
2025-03-12,13982.1,refund,in,Counterparty_1,22482040.37,,
2025-03-12,39.3,software_subscription,out,Counterparty_70,22482001.07,2025-02-11,2025-03-08
2025-03-12,1433.69,loan_repayment,out,Counterparty_38,22480567.38,2025-01-31,2025-03-11
2025-03-12,4065.49,tax_payment,out,Counterparty_92,22476501.89,2025-01-28,2025-03-05
2025-03-12,4860.77,T&E,out,Counterparty_34,22471641.12,2025-02-22,2025-03-30
2025-03-12,6529.35,software_subscription,out,Counterparty_63,22465111.77,2025-01-29,2025-02-27
2025-03-12,577.79,loan_repayment,out,Counterparty_2,22464533.98,2025-02-01,2025-03-01
2025-03-12,208.17,utilities,out,Counterparty_36,22464325.81,2025-02-02,2025-03-06
2025-03-12,573.13,supplier_payment,out,Counterparty_69,22463752.68,2025-01-30,2025-02-26
2025-03-12,119.61,marketing_spend,out,Counterparty_35,22463633.07,2025-02-01,2025-02-27
2025-03-12,1690.72,customer_payment,in,Counterparty_45,22465323.79,,
2025-03-12,4045.81,supplier_payment,out,Counterparty_47,22461277.98,2025-02-01,2025-03-01
2025-03-12,18016.2,asset_sale,in,Counterparty_3,22479294.18,,
2025-03-12,548.33,payroll,out,Counterparty_6,22478745.85,2025-02-24,2025-03-23
2025-03-12,1300.24,supplier_payment,out,Counterparty_58,22477445.61,2025-02-15,2025-03-12
2025-03-12,5838.4,credit,in,Counterparty_9,22483284.01,,
2025-03-12,6008.63,refund,in,Counterparty_12,22489292.64,,
2025-03-12,2049.31,utilities,out,Counterparty_90,22487243.33,2025-02-22,2025-03-28
2025-03-12,8952.47,investment_income,in,Counterparty_92,22496195.8,,
2025-03-12,2093.25,credit,in,Counterparty_47,22498289.05,,
2025-03-12,3388.77,loan_repayment,out,Counterparty_90,22494900.28,2025-01-27,2025-03-05
2025-03-12,1356.58,software_subscription,out,Counterparty_76,22493543.7,2025-02-06,2025-03-13
2025-03-12,14892.54,customer_payment,in,Counterparty_20,22508436.24,,
2025-03-12,15109.75,customer_payment,in,Counterparty_54,22523545.99,,
2025-03-12,970.84,marketing_spend,out,Counterparty_54,22522575.15,2025-01-30,2025-03-01
2025-03-12,8852.99,investment_income,in,Counterparty_19,22531428.14,,
2025-03-12,6617.14,refund,in,Counterparty_85,22538045.28,,
2025-03-12,1921.15,supplier_payment,out,Counterparty_18,22536124.13,2025-02-04,2025-03-01
2025-03-12,5644.14,loan_repayment,out,Counterparty_32,22530479.99,2025-02-19,2025-03-28
2025-03-12,18123.32,customer_payment,in,Counterparty_30,22548603.31,,
2025-03-12,1206.87,T&E,out,Counterparty_38,22547396.44,2025-02-17,2025-03-26
2025-03-12,6154.7,asset_sale,in,Counterparty_22,22553551.14,,
2025-03-12,10639.12,investment_income,in,Counterparty_4,22564190.26,,
2025-03-12,4016.68,investment_income,in,Counterparty_34,22568206.94,,
2025-03-12,9616.1,asset_sale,in,Counterparty_93,22577823.04,,
2025-03-12,4425.74,refund,in,Counterparty_1,22582248.78,,
2025-03-12,375.36,investment_income,in,Counterparty_26,22582624.14,,
2025-03-12,3971.02,supplier_payment,out,Counterparty_17,22578653.12,2025-02-09,2025-03-18
2025-03-12,2435.14,utilities,out,Counterparty_53,22576217.98,2025-01-28,2025-02-28
2025-03-13,6315.74,customer_payment,in,Counterparty_15,22582533.72,,
2025-03-13,757.78,supplier_payment,out,Counterparty_81,22581775.94,2025-01-31,2025-03-02
2025-03-13,2453.6,software_subscription,out,Counterparty_6,22579322.34,2025-02-09,2025-03-15
2025-03-13,3922.01,utilities,out,Counterparty_94,22575400.33,2025-02-01,2025-02-27
2025-03-13,3660.55,refund,in,Counterparty_13,22579060.88,,
2025-03-13,1813.79,utilities,out,Counterparty_57,22577247.09,2025-02-13,2025-03-21
2025-03-13,8691.88,marketing_spend,out,Counterparty_56,22568555.21,2025-02-24,2025-03-24
2025-03-13,96.02,T&E,out,Counterparty_94,22568459.19,2025-02-26,2025-04-04
2025-03-13,7949.13,refund,in,Counterparty_21,22576408.32,,
2025-03-13,238.93,rent,out,Counterparty_26,22576169.39,2025-02-07,2025-03-18
2025-03-13,3366.57,tax_payment,out,Counterparty_41,22572802.82,2025-02-24,2025-03-31
2025-03-13,2096.66,payroll,out,Counterparty_6,22570706.16,2025-02-05,2025-03-06
2025-03-13,1834.34,payroll,out,Counterparty_48,22568871.82,2025-01-28,2025-02-24
2025-03-13,5848.0,refund,in,Counterparty_68,22574719.82,,
2025-03-13,9140.0,T&E,out,Counterparty_15,22565579.82,2025-02-16,2025-03-21
2025-03-13,240.69,loan_repayment,out,Counterparty_15,22565339.13,2025-02-22,2025-03-28
2025-03-13,13893.28,marketing_spend,out,Counterparty_3,22551445.85,2025-02-22,2025-03-30
2025-03-13,4771.59,utilities,out,Counterparty_14,22546674.26,2025-02-06,2025-03-12
2025-03-13,1082.99,refund,in,Counterparty_44,22547757.25,,
2025-03-13,3696.91,asset_sale,in,Counterparty_80,22551454.16,,
2025-03-13,1060.3,credit,in,Counterparty_67,22552514.46,,
2025-03-13,1502.74,payroll,out,Counterparty_99,22551011.72,2025-01-29,2025-03-02
2025-03-13,2641.49,credit,in,Counterparty_86,22553653.21,,
2025-03-13,14301.51,credit,in,Counterparty_70,22567954.72,,
2025-03-13,20195.69,refund,in,Counterparty_72,22588150.41,,
2025-03-13,1700.48,payroll,out,Counterparty_66,22586449.93,2025-02-14,2025-03-18
2025-03-13,2247.04,payroll,out,Counterparty_37,22584202.89,2025-02-25,2025-03-31
2025-03-13,3614.03,payroll,out,Counterparty_1,22580588.86,2025-02-09,2025-03-15
2025-03-13,1630.08,rent,out,Counterparty_27,22578958.78,2025-02-21,2025-03-27
2025-03-13,3538.34,software_subscription,out,Counterparty_47,22575420.44,2025-02-01,2025-03-07
2025-03-13,2021.52,payroll,out,Counterparty_51,22573398.92,2025-02-04,2025-03-06
2025-03-13,1984.08,refund,in,Counterparty_92,22575383.0,,
2025-03-13,5361.45,tax_payment,out,Counterparty_36,22570021.55,2025-02-12,2025-03-12
2025-03-13,1047.95,payroll,out,Counterparty_44,22568973.6,2025-01-28,2025-02-27
2025-03-13,14995.07,asset_sale,in,Counterparty_62,22583968.67,,
2025-03-13,2611.29,utilities,out,Counterparty_10,22581357.38,2025-02-23,2025-03-27
2025-03-13,7581.44,payroll,out,Counterparty_51,22573775.94,2025-02-03,2025-03-04
2025-03-13,3822.75,refund,in,Counterparty_87,22577598.69,,
2025-03-13,1615.63,supplier_payment,out,Counterparty_85,22575983.06,2025-02-16,2025-03-24
2025-03-13,244.51,investment_income,in,Counterparty_65,22576227.57,,
2025-03-13,884.97,investment_income,in,Counterparty_56,22577112.54,,
2025-03-13,962.32,rent,out,Counterparty_60,22576150.22,2025-02-21,2025-03-23
2025-03-13,161.49,supplier_payment,out,Counterparty_88,22575988.73,2025-02-12,2025-03-11
2025-03-13,3214.19,software_subscription,out,Counterparty_26,22572774.54,2025-02-06,2025-03-13
2025-03-13,1002.51,tax_payment,out,Counterparty_31,22571772.03,2025-02-18,2025-03-28
2025-03-13,1315.33,tax_payment,out,Counterparty_43,22570456.7,2025-02-14,2025-03-20
2025-03-13,7629.21,customer_payment,in,Counterparty_5,22578085.91,,
2025-03-13,1653.1,utilities,out,Counterparty_78,22576432.81,2025-01-30,2025-03-08
2025-03-13,5927.46,marketing_spend,out,Counterparty_47,22570505.35,2025-01-31,2025-02-28
2025-03-13,4640.25,supplier_payment,out,Counterparty_97,22565865.1,2025-01-31,2025-03-08
2025-03-13,5958.52,credit,in,Counterparty_80,22571823.62,,
2025-03-13,6180.44,asset_sale,in,Counterparty_10,22578004.06,,
2025-03-13,359.93,payroll,out,Counterparty_9,22577644.13,2025-02-15,2025-03-14
2025-03-13,18197.62,customer_payment,in,Counterparty_58,22595841.75,,
2025-03-13,4115.22,refund,in,Counterparty_44,22599956.97,,
2025-03-14,4807.4,investment_income,in,Counterparty_98,22604764.37,,
2025-03-14,11750.77,supplier_payment,out,Counterparty_16,22593013.6,2025-02-22,2025-03-19
2025-03-14,15432.65,refund,in,Counterparty_43,22608446.25,,
2025-03-14,3690.23,supplier_payment,out,Counterparty_90,22604756.02,2025-02-08,2025-03-09
2025-03-14,4607.18,tax_payment,out,Counterparty_19,22600148.84,2025-02-12,2025-03-21
2025-03-14,2916.67,tax_payment,out,Counterparty_69,22597232.17,2025-02-05,2025-03-14
2025-03-14,852.77,T&E,out,Counterparty_83,22596379.4,2025-02-05,2025-03-10
2025-03-14,407.18,marketing_spend,out,Counterparty_16,22595972.22,2025-02-16,2025-03-22
2025-03-14,2555.57,refund,in,Counterparty_91,22598527.79,,
2025-03-14,6700.63,tax_payment,out,Counterparty_25,22591827.16,2025-02-01,2025-03-01
2025-03-14,2154.7,marketing_spend,out,Counterparty_21,22589672.46,2025-02-10,2025-03-18
2025-03-14,6468.23,loan_repayment,out,Counterparty_62,22583204.23,2025-02-11,2025-03-08
2025-03-14,1631.22,rent,out,Counterparty_52,22581573.01,2025-02-14,2025-03-17
2025-03-14,601.77,utilities,out,Counterparty_91,22580971.24,2025-02-23,2025-03-22
2025-03-14,308.2,tax_payment,out,Counterparty_19,22580663.04,2025-02-04,2025-03-07
2025-03-14,9415.27,asset_sale,in,Counterparty_26,22590078.31,,
2025-03-14,4934.75,marketing_spend,out,Counterparty_44,22585143.56,2025-02-04,2025-03-05
2025-03-14,433.68,payroll,out,Counterparty_92,22584709.88,2025-01-29,2025-02-28
2025-03-14,354.19,payroll,out,Counterparty_72,22584355.69,2025-02-24,2025-03-28
2025-03-14,5013.17,utilities,out,Counterparty_39,22579342.52,2025-02-20,2025-03-26
2025-03-14,466.6,refund,in,Counterparty_68,22579809.12,,
2025-03-14,490.28,software_subscription,out,Counterparty_83,22579318.84,2025-02-05,2025-03-15
2025-03-14,182.78,refund,in,Counterparty_98,22579501.62,,
2025-03-14,7149.84,asset_sale,in,Counterparty_55,22586651.46,,
2025-03-14,2111.26,customer_payment,in,Counterparty_99,22588762.72,,
2025-03-14,382.16,loan_repayment,out,Counterparty_84,22588380.56,2025-02-16,2025-03-19
2025-03-14,3425.12,marketing_spend,out,Counterparty_83,22584955.44,2025-02-07,2025-03-10
2025-03-14,25542.9,customer_payment,in,Counterparty_78,22610498.34,,
2025-03-14,3992.0,T&E,out,Counterparty_35,22606506.34,2025-02-01,2025-02-28
2025-03-14,575.0,supplier_payment,out,Counterparty_23,22605931.34,2025-02-24,2025-03-24
2025-03-14,4141.31,utilities,out,Counterparty_81,22601790.03,2025-02-09,2025-03-08
2025-03-14,2840.19,customer_payment,in,Counterparty_63,22604630.22,,
2025-03-14,4277.09,credit,in,Counterparty_54,22608907.31,,
2025-03-14,9484.85,credit,in,Counterparty_70,22618392.16,,
2025-03-14,2985.46,refund,in,Counterparty_13,22621377.62,,
2025-03-14,1310.94,credit,in,Counterparty_26,22622688.56,,
2025-03-14,1152.75,credit,in,Counterparty_28,22623841.31,,
2025-03-14,6531.7,customer_payment,in,Counterparty_6,22630373.01,,
2025-03-14,10919.97,payroll,out,Counterparty_71,22619453.04,2025-02-05,2025-03-09
2025-03-14,5011.43,loan_repayment,out,Counterparty_19,22614441.61,2025-02-23,2025-03-22
2025-03-14,1428.62,marketing_spend,out,Counterparty_59,22613012.99,2025-02-16,2025-03-26
2025-03-14,1600.29,loan_repayment,out,Counterparty_40,22611412.7,2025-02-12,2025-03-16
2025-03-14,1811.35,asset_sale,in,Counterparty_10,22613224.05,,
2025-03-14,2276.23,rent,out,Counterparty_2,22610947.82,2025-02-11,2025-03-22
2025-03-14,1171.9,supplier_payment,out,Counterparty_92,22609775.92,2025-02-23,2025-04-02
2025-03-14,3870.87,asset_sale,in,Counterparty_31,22613646.79,,
2025-03-14,10259.04,T&E,out,Counterparty_65,22603387.75,2025-02-10,2025-03-11
2025-03-14,7612.69,credit,in,Counterparty_96,22611000.44,,
2025-03-14,6716.32,credit,in,Counterparty_52,22617716.76,,
2025-03-14,2754.2,supplier_payment,out,Counterparty_6,22614962.56,2025-02-04,2025-03-14
2025-03-14,6003.12,rent,out,Counterparty_12,22608959.44,2025-02-15,2025-03-12
2025-03-14,393.13,payroll,out,Counterparty_54,22608566.31,2025-01-29,2025-03-05
2025-03-14,1123.33,tax_payment,out,Counterparty_40,22607442.98,2025-02-23,2025-03-20
2025-03-14,8538.28,credit,in,Counterparty_47,22615981.26,,
2025-03-14,5439.83,asset_sale,in,Counterparty_9,22621421.09,,
2025-03-14,247.39,refund,in,Counterparty_91,22621668.48,,
2025-03-14,3762.96,utilities,out,Counterparty_68,22617905.52,2025-01-31,2025-02-27
2025-03-14,1758.51,software_subscription,out,Counterparty_86,22616147.01,2025-02-16,2025-03-23
2025-03-14,1706.15,supplier_payment,out,Counterparty_39,22614440.86,2025-01-29,2025-03-06
2025-03-14,6413.07,customer_payment,in,Counterparty_70,22620853.93,,
2025-03-14,618.32,tax_payment,out,Counterparty_65,22620235.61,2025-02-10,2025-03-15
2025-03-14,1648.39,payroll,out,Counterparty_5,22618587.22,2025-02-25,2025-04-01
2025-03-14,357.4,utilities,out,Counterparty_71,22618229.82,2025-02-07,2025-03-08
2025-03-14,5127.95,supplier_payment,out,Counterparty_75,22613101.87,2025-02-05,2025-03-08
2025-03-14,868.69,tax_payment,out,Counterparty_62,22612233.18,2025-02-10,2025-03-14
2025-03-14,3251.56,rent,out,Counterparty_69,22608981.62,2025-02-15,2025-03-21
2025-03-15,3402.86,marketing_spend,out,Counterparty_50,22605578.76,2025-02-10,2025-03-15
2025-03-15,5210.67,asset_sale,in,Counterparty_65,22610789.43,,
2025-03-15,2499.04,utilities,out,Counterparty_6,22608290.39,2025-02-03,2025-03-14
2025-03-15,4098.13,tax_payment,out,Counterparty_33,22604192.26,2025-02-19,2025-03-26
2025-03-15,927.61,tax_payment,out,Counterparty_27,22603264.65,2025-01-30,2025-02-25
2025-03-15,18005.93,asset_sale,in,Counterparty_91,22621270.58,,
2025-03-15,637.38,investment_income,in,Counterparty_48,22621907.96,,
2025-03-15,780.68,software_subscription,out,Counterparty_44,22621127.28,2025-02-19,2025-03-29
2025-03-15,210.3,loan_repayment,out,Counterparty_59,22620916.98,2025-02-25,2025-03-22
2025-03-15,1554.72,marketing_spend,out,Counterparty_14,22619362.26,2025-02-01,2025-02-26
2025-03-15,4665.6,tax_payment,out,Counterparty_38,22614696.66,2025-02-28,2025-04-01
2025-03-15,5004.9,rent,out,Counterparty_73,22609691.76,2025-02-09,2025-03-06
2025-03-15,207.23,rent,out,Counterparty_21,22609484.53,2025-02-04,2025-03-05
2025-03-15,9865.33,customer_payment,in,Counterparty_25,22619349.86,,
2025-03-15,1862.78,utilities,out,Counterparty_30,22617487.08,2025-02-27,2025-03-29
2025-03-15,1156.74,T&E,out,Counterparty_1,22616330.34,2025-02-05,2025-03-12
2025-03-15,35447.15,customer_payment,in,Counterparty_91,22651777.49,,
2025-03-15,5343.02,credit,in,Counterparty_58,22657120.51,,
2025-03-15,7221.23,customer_payment,in,Counterparty_41,22664341.74,,
2025-03-15,11742.91,customer_payment,in,Counterparty_69,22676084.65,,
2025-03-15,2535.57,loan_repayment,out,Counterparty_86,22673549.08,2025-02-08,2025-03-14
2025-03-15,8193.09,tax_payment,out,Counterparty_43,22665355.99,2025-02-09,2025-03-08
2025-03-15,362.14,loan_repayment,out,Counterparty_17,22664993.85,2025-02-16,2025-03-18
2025-03-15,8173.67,marketing_spend,out,Counterparty_82,22656820.18,2025-02-09,2025-03-07
2025-03-15,2670.09,asset_sale,in,Counterparty_37,22659490.27,,
2025-03-15,7766.4,tax_payment,out,Counterparty_63,22651723.87,2025-02-08,2025-03-19
2025-03-15,64.08,tax_payment,out,Counterparty_85,22651659.79,2025-02-02,2025-03-04
2025-03-15,473.66,payroll,out,Counterparty_32,22651186.13,2025-02-12,2025-03-11
2025-03-15,276.78,tax_payment,out,Counterparty_54,22650909.35,2025-02-08,2025-03-19
2025-03-15,1688.41,payroll,out,Counterparty_46,22649220.94,2025-02-27,2025-04-06
2025-03-15,13707.44,credit,in,Counterparty_52,22662928.38,,
2025-03-15,4593.41,T&E,out,Counterparty_62,22658334.97,2025-02-14,2025-03-11
2025-03-15,207.77,payroll,out,Counterparty_57,22658127.2,2025-02-16,2025-03-17
2025-03-15,11690.38,customer_payment,in,Counterparty_60,22669817.58,,
2025-03-15,11940.37,asset_sale,in,Counterparty_43,22681757.95,,
2025-03-15,530.01,loan_repayment,out,Counterparty_39,22681227.94,2025-02-12,2025-03-13
2025-03-15,4306.72,asset_sale,in,Counterparty_49,22685534.66,,
2025-03-15,16933.57,asset_sale,in,Counterparty_70,22702468.23,,
2025-03-15,394.64,loan_repayment,out,Counterparty_93,22702073.59,2025-02-25,2025-03-31
2025-03-15,1365.7,utilities,out,Counterparty_36,22700707.89,2025-02-18,2025-03-19
2025-03-15,10425.25,rent,out,Counterparty_13,22690282.64,2025-02-11,2025-03-22
2025-03-15,389.14,loan_repayment,out,Counterparty_99,22689893.5,2025-02-16,2025-03-24
2025-03-15,4465.45,utilities,out,Counterparty_77,22685428.05,2025-02-10,2025-03-13
2025-03-15,12691.89,investment_income,in,Counterparty_87,22698119.94,,
2025-03-15,498.23,customer_payment,in,Counterparty_67,22698618.17,,
2025-03-15,172.23,payroll,out,Counterparty_6,22698445.94,2025-02-11,2025-03-13
2025-03-15,11088.26,utilities,out,Counterparty_67,22687357.68,2025-02-28,2025-04-03
2025-03-15,264.74,investment_income,in,Counterparty_64,22687622.42,,
2025-03-15,542.88,supplier_payment,out,Counterparty_87,22687079.54,2025-02-19,2025-03-27
2025-03-15,14510.47,investment_income,in,Counterparty_98,22701590.01,,
2025-03-15,3521.07,loan_repayment,out,Counterparty_52,22698068.94,2025-02-24,2025-03-26
2025-03-15,4848.84,T&E,out,Counterparty_95,22693220.1,2025-02-27,2025-03-30
2025-03-15,156.21,loan_repayment,out,Counterparty_34,22693063.89,2025-01-30,2025-03-04
2025-03-15,3068.5,utilities,out,Counterparty_69,22689995.39,2025-02-04,2025-03-01
2025-03-15,56.75,loan_repayment,out,Counterparty_2,22689938.64,2025-02-13,2025-03-13
2025-03-15,64.24,utilities,out,Counterparty_72,22689874.4,2025-01-31,2025-02-28
2025-03-15,3937.59,T&E,out,Counterparty_59,22685936.81,2025-02-04,2025-03-07
2025-03-15,3175.22,investment_income,in,Counterparty_68,22689112.03,,
2025-03-16,569.28,rent,out,Counterparty_40,22688542.75,2025-02-12,2025-03-22
2025-03-16,1178.03,T&E,out,Counterparty_83,22687364.72,2025-02-04,2025-03-02
2025-03-16,6567.9,payroll,out,Counterparty_88,22680796.82,2025-02-15,2025-03-20
2025-03-16,1769.93,T&E,out,Counterparty_43,22679026.89,2025-02-01,2025-03-08
2025-03-16,7563.11,software_subscription,out,Counterparty_14,22671463.78,2025-02-26,2025-03-31
2025-03-16,574.23,tax_payment,out,Counterparty_71,22670889.55,2025-02-08,2025-03-09
2025-03-16,665.76,payroll,out,Counterparty_87,22670223.79,2025-02-07,2025-03-08
2025-03-16,983.83,utilities,out,Counterparty_36,22669239.96,2025-02-17,2025-03-26
2025-03-16,2869.24,rent,out,Counterparty_57,22666370.72,2025-02-10,2025-03-18
2025-03-16,4413.8,customer_payment,in,Counterparty_79,22670784.52,,
2025-03-16,10248.75,refund,in,Counterparty_5,22681033.27,,
2025-03-16,1639.43,investment_income,in,Counterparty_16,22682672.7,,
2025-03-16,6931.68,investment_income,in,Counterparty_66,22689604.38,,
2025-03-16,2659.59,supplier_payment,out,Counterparty_16,22686944.79,2025-03-01,2025-04-01
2025-03-16,729.73,rent,out,Counterparty_28,22686215.06,2025-02-27,2025-03-28
2025-03-16,3316.0,utilities,out,Counterparty_2,22682899.06,2025-02-21,2025-03-29
2025-03-16,5080.91,utilities,out,Counterparty_46,22677818.15,2025-02-17,2025-03-18
2025-03-16,3199.57,T&E,out,Counterparty_53,22674618.58,2025-02-07,2025-03-06
2025-03-16,14549.65,investment_income,in,Counterparty_17,22689168.23,,
2025-03-16,6773.47,payroll,out,Counterparty_21,22682394.76,2025-02-28,2025-03-29
2025-03-16,4738.42,payroll,out,Counterparty_62,22677656.34,2025-02-19,2025-03-18
2025-03-16,8146.47,customer_payment,in,Counterparty_9,22685802.81,,
2025-03-16,10745.42,payroll,out,Counterparty_79,22675057.39,2025-02-16,2025-03-14
2025-03-16,1977.28,tax_payment,out,Counterparty_10,22673080.11,2025-02-08,2025-03-08
2025-03-16,16805.19,tax_payment,out,Counterparty_96,22656274.92,2025-02-21,2025-03-20
2025-03-16,1028.53,rent,out,Counterparty_61,22655246.39,2025-02-27,2025-04-04
2025-03-16,1677.83,software_subscription,out,Counterparty_2,22653568.56,2025-02-03,2025-03-11
2025-03-16,2714.37,customer_payment,in,Counterparty_69,22656282.93,,
2025-03-16,668.66,credit,in,Counterparty_27,22656951.59,,
2025-03-16,5900.56,rent,out,Counterparty_14,22651051.03,2025-02-28,2025-04-03
2025-03-16,9849.59,customer_payment,in,Counterparty_5,22660900.62,,
2025-03-16,4476.52,marketing_spend,out,Counterparty_31,22656424.1,2025-02-11,2025-03-13
2025-03-16,859.5,marketing_spend,out,Counterparty_81,22655564.6,2025-02-02,2025-03-10
2025-03-16,1415.5,marketing_spend,out,Counterparty_36,22654149.1,2025-02-06,2025-03-14
2025-03-16,1858.58,tax_payment,out,Counterparty_31,22652290.52,2025-02-28,2025-04-02
2025-03-16,1340.69,credit,in,Counterparty_26,22653631.21,,
2025-03-16,441.97,supplier_payment,out,Counterparty_54,22653189.24,2025-02-05,2025-03-02
2025-03-16,9699.78,supplier_payment,out,Counterparty_60,22643489.46,2025-02-20,2025-03-21
2025-03-16,1242.35,rent,out,Counterparty_42,22642247.11,2025-02-20,2025-03-27
2025-03-16,1789.94,marketing_spend,out,Counterparty_74,22640457.17,2025-02-28,2025-04-01
2025-03-16,1185.98,T&E,out,Counterparty_67,22639271.19,2025-02-22,2025-03-22
2025-03-16,451.77,T&E,out,Counterparty_47,22638819.42,2025-01-31,2025-03-08
2025-03-16,6490.63,tax_payment,out,Counterparty_10,22632328.79,2025-02-10,2025-03-19
2025-03-16,5682.75,marketing_spend,out,Counterparty_58,22626646.04,2025-02-05,2025-03-05
2025-03-16,2708.76,software_subscription,out,Counterparty_79,22623937.28,2025-02-05,2025-03-08
2025-03-16,2512.3,credit,in,Counterparty_62,22626449.58,,
2025-03-16,5737.3,marketing_spend,out,Counterparty_54,22620712.28,2025-02-08,2025-03-09
2025-03-16,6760.05,marketing_spend,out,Counterparty_23,22613952.23,2025-02-03,2025-03-03
2025-03-16,528.77,credit,in,Counterparty_26,22614481.0,,
2025-03-16,6932.52,tax_payment,out,Counterparty_1,22607548.48,2025-02-22,2025-03-31
2025-03-16,3841.58,asset_sale,in,Counterparty_3,22611390.06,,
2025-03-16,391.92,loan_repayment,out,Counterparty_59,22610998.14,2025-02-10,2025-03-20
2025-03-16,4123.29,marketing_spend,out,Counterparty_19,22606874.85,2025-02-24,2025-03-27
2025-03-16,6988.14,payroll,out,Counterparty_39,22599886.71,2025-02-05,2025-03-02
2025-03-17,13566.04,refund,in,Counterparty_43,22613452.75,,
2025-03-17,9199.02,investment_income,in,Counterparty_5,22622651.77,,
2025-03-17,2182.04,asset_sale,in,Counterparty_73,22624833.81,,
2025-03-17,353.04,tax_payment,out,Counterparty_98,22624480.77,2025-02-05,2025-03-12
2025-03-17,473.58,refund,in,Counterparty_54,22624954.35,,
2025-03-17,604.63,investment_income,in,Counterparty_31,22625558.98,,
2025-03-17,591.8,T&E,out,Counterparty_10,22624967.18,2025-02-27,2025-03-31
2025-03-17,6071.66,T&E,out,Counterparty_21,22618895.52,2025-02-24,2025-03-25
2025-03-17,288.81,customer_payment,in,Counterparty_70,22619184.33,,
2025-03-17,2080.44,investment_income,in,Counterparty_39,22621264.77,,
2025-03-17,5458.7,T&E,out,Counterparty_2,22615806.07,2025-02-01,2025-03-08
2025-03-17,4697.88,credit,in,Counterparty_16,22620503.95,,
2025-03-17,4774.74,customer_payment,in,Counterparty_27,22625278.69,,
2025-03-17,770.01,payroll,out,Counterparty_73,22624508.68,2025-02-15,2025-03-17
2025-03-17,11105.23,T&E,out,Counterparty_58,22613403.45,2025-03-02,2025-04-01
2025-03-17,21434.74,refund,in,Counterparty_84,22634838.19,,
2025-03-17,5844.26,credit,in,Counterparty_5,22640682.45,,
2025-03-17,1892.24,investment_income,in,Counterparty_83,22642574.69,,
2025-03-17,3891.32,rent,out,Counterparty_93,22638683.37,2025-02-01,2025-03-11
2025-03-17,11243.21,refund,in,Counterparty_78,22649926.58,,
2025-03-17,2444.6,marketing_spend,out,Counterparty_87,22647481.98,2025-02-10,2025-03-12
2025-03-17,2576.6,supplier_payment,out,Counterparty_26,22644905.38,2025-02-02,2025-03-06
2025-03-17,17247.65,customer_payment,in,Counterparty_94,22662153.03,,
2025-03-17,7646.75,utilities,out,Counterparty_86,22654506.28,2025-02-27,2025-03-28
2025-03-17,6866.49,investment_income,in,Counterparty_56,22661372.77,,
2025-03-17,2357.71,software_subscription,out,Counterparty_17,22659015.06,2025-02-08,2025-03-10
2025-03-17,715.95,loan_repayment,out,Counterparty_25,22658299.11,2025-02-20,2025-03-30
2025-03-17,819.67,asset_sale,in,Counterparty_56,22659118.78,,
2025-03-17,3164.93,investment_income,in,Counterparty_75,22662283.71,,
2025-03-17,4497.77,T&E,out,Counterparty_89,22657785.94,2025-02-18,2025-03-27
2025-03-17,3375.37,utilities,out,Counterparty_33,22654410.57,2025-03-02,2025-04-01
2025-03-17,678.5,software_subscription,out,Counterparty_82,22653732.07,2025-02-04,2025-03-02
2025-03-17,1051.88,utilities,out,Counterparty_89,22652680.19,2025-02-05,2025-03-13
2025-03-17,754.47,refund,in,Counterparty_64,22653434.66,,
2025-03-17,3844.12,T&E,out,Counterparty_58,22649590.54,2025-02-21,2025-03-28
2025-03-17,1948.43,tax_payment,out,Counterparty_26,22647642.11,2025-02-24,2025-03-26
2025-03-17,5733.79,asset_sale,in,Counterparty_83,22653375.9,,
2025-03-17,2772.62,loan_repayment,out,Counterparty_48,22650603.28,2025-02-13,2025-03-20
2025-03-17,5594.64,customer_payment,in,Counterparty_66,22656197.92,,
2025-03-17,598.44,investment_income,in,Counterparty_56,22656796.36,,
2025-03-17,1018.13,payroll,out,Counterparty_66,22655778.23,2025-02-07,2025-03-16
2025-03-17,3451.42,utilities,out,Counterparty_91,22652326.81,2025-02-15,2025-03-23
2025-03-17,12911.12,rent,out,Counterparty_33,22639415.69,2025-02-01,2025-03-12
2025-03-17,179.89,payroll,out,Counterparty_21,22639235.8,2025-02-11,2025-03-13
2025-03-17,176.16,rent,out,Counterparty_27,22639059.64,2025-02-09,2025-03-20
2025-03-17,245.75,supplier_payment,out,Counterparty_81,22638813.89,2025-02-26,2025-03-30
2025-03-17,9008.1,supplier_payment,out,Counterparty_38,22629805.79,2025-02-04,2025-03-13
2025-03-17,1460.24,software_subscription,out,Counterparty_35,22628345.55,2025-02-24,2025-04-03
2025-03-17,8820.54,payroll,out,Counterparty_47,22619525.01,2025-02-15,2025-03-24
2025-03-17,2487.31,payroll,out,Counterparty_1,22617037.7,2025-03-02,2025-04-07
2025-03-17,5695.04,credit,in,Counterparty_34,22622732.74,,
2025-03-17,400.37,loan_repayment,out,Counterparty_35,22622332.37,2025-02-17,2025-03-16
2025-03-17,2791.27,payroll,out,Counterparty_17,22619541.1,2025-02-19,2025-03-30
2025-03-17,495.15,asset_sale,in,Counterparty_25,22620036.25,,
2025-03-17,1094.84,utilities,out,Counterparty_33,22618941.41,2025-03-01,2025-03-29
2025-03-18,23360.62,rent,out,Counterparty_48,22595580.79,2025-03-03,2025-03-28
2025-03-18,6955.53,supplier_payment,out,Counterparty_18,22588625.26,2025-02-20,2025-03-25
2025-03-18,3648.83,credit,in,Counterparty_93,22592274.09,,
2025-03-18,2711.03,T&E,out,Counterparty_48,22589563.06,2025-02-15,2025-03-12
2025-03-18,3454.52,tax_payment,out,Counterparty_97,22586108.54,2025-02-03,2025-03-06
2025-03-18,1912.76,asset_sale,in,Counterparty_79,22588021.3,,
2025-03-18,2478.0,utilities,out,Counterparty_63,22585543.3,2025-02-09,2025-03-17
2025-03-18,333.89,marketing_spend,out,Counterparty_74,22585209.41,2025-02-10,2025-03-12
2025-03-18,5346.69,customer_payment,in,Counterparty_77,22590556.1,,
2025-03-18,4866.7,customer_payment,in,Counterparty_12,22595422.8,,
2025-03-18,13559.58,credit,in,Counterparty_71,22608982.38,,
2025-03-18,1606.86,refund,in,Counterparty_73,22610589.24,,
2025-03-18,10400.12,supplier_payment,out,Counterparty_72,22600189.12,2025-03-02,2025-03-31
2025-03-18,1387.35,refund,in,Counterparty_7,22601576.47,,
2025-03-18,8432.14,investment_income,in,Counterparty_71,22610008.61,,
2025-03-18,902.36,T&E,out,Counterparty_98,22609106.25,2025-02-03,2025-03-02
2025-03-18,1123.82,rent,out,Counterparty_13,22607982.43,2025-02-08,2025-03-09
2025-03-18,5066.84,investment_income,in,Counterparty_32,22613049.27,,
2025-03-18,2772.19,T&E,out,Counterparty_42,22610277.08,2025-02-04,2025-03-13
2025-03-18,1840.88,supplier_payment,out,Counterparty_68,22608436.2,2025-02-10,2025-03-11
2025-03-18,3976.55,asset_sale,in,Counterparty_25,22612412.75,,
2025-03-18,571.07,software_subscription,out,Counterparty_74,22611841.68,2025-02-04,2025-03-09
2025-03-18,7469.77,payroll,out,Counterparty_7,22604371.91,2025-02-27,2025-03-31
2025-03-18,13148.42,refund,in,Counterparty_27,22617520.33,,
2025-03-18,718.34,rent,out,Counterparty_17,22616801.99,2025-02-05,2025-03-08
2025-03-18,1229.18,customer_payment,in,Counterparty_49,22618031.17,,
2025-03-18,1001.9,tax_payment,out,Counterparty_47,22617029.27,2025-02-24,2025-04-01
2025-03-18,2470.09,loan_repayment,out,Counterparty_55,22614559.18,2025-02-09,2025-03-06
2025-03-18,203.91,supplier_payment,out,Counterparty_22,22614355.27,2025-03-03,2025-04-06
2025-03-18,3737.11,software_subscription,out,Counterparty_6,22610618.16,2025-02-15,2025-03-21
2025-03-18,7051.07,refund,in,Counterparty_99,22617669.23,,
2025-03-18,4668.34,asset_sale,in,Counterparty_46,22622337.57,,
2025-03-18,12415.58,customer_payment,in,Counterparty_30,22634753.15,,
2025-03-18,1408.02,utilities,out,Counterparty_10,22633345.13,2025-02-09,2025-03-08
2025-03-18,477.41,payroll,out,Counterparty_54,22632867.72,2025-02-23,2025-03-21
2025-03-18,17085.99,payroll,out,Counterparty_12,22615781.73,2025-03-03,2025-04-07
2025-03-18,4839.68,customer_payment,in,Counterparty_95,22620621.41,,
2025-03-18,4623.6,marketing_spend,out,Counterparty_30,22615997.81,2025-02-12,2025-03-10
2025-03-18,1717.54,payroll,out,Counterparty_81,22614280.27,2025-03-03,2025-04-01
2025-03-18,5391.29,T&E,out,Counterparty_39,22608888.98,2025-02-20,2025-03-26
2025-03-18,5648.35,loan_repayment,out,Counterparty_78,22603240.63,2025-02-12,2025-03-23
2025-03-18,4767.18,software_subscription,out,Counterparty_49,22598473.45,2025-02-21,2025-03-24
2025-03-18,1327.66,T&E,out,Counterparty_20,22597145.79,2025-02-25,2025-03-26
2025-03-18,2323.0,payroll,out,Counterparty_42,22594822.79,2025-03-01,2025-03-29
2025-03-18,2649.78,software_subscription,out,Counterparty_80,22592173.01,2025-02-28,2025-04-01
2025-03-18,1470.32,loan_repayment,out,Counterparty_98,22590702.69,2025-02-20,2025-03-17
2025-03-18,404.65,marketing_spend,out,Counterparty_7,22590298.04,2025-02-17,2025-03-16
2025-03-18,2495.39,payroll,out,Counterparty_11,22587802.65,2025-02-27,2025-04-06
2025-03-18,1730.56,marketing_spend,out,Counterparty_99,22586072.09,2025-02-04,2025-03-06
2025-03-18,1464.68,payroll,out,Counterparty_61,22584607.41,2025-02-19,2025-03-22
2025-03-18,1351.72,investment_income,in,Counterparty_88,22585959.13,,
2025-03-18,3831.87,supplier_payment,out,Counterparty_4,22582127.26,2025-02-23,2025-04-03
2025-03-18,3841.79,tax_payment,out,Counterparty_27,22578285.47,2025-02-27,2025-04-04
2025-03-18,7613.34,customer_payment,in,Counterparty_30,22585898.81,,
2025-03-19,1790.26,customer_payment,in,Counterparty_16,22587689.07,,
2025-03-19,4875.54,loan_repayment,out,Counterparty_54,22582813.53,2025-02-25,2025-03-29
2025-03-19,15602.49,customer_payment,in,Counterparty_24,22598416.02,,
2025-03-19,305.26,customer_payment,in,Counterparty_56,22598721.28,,
2025-03-19,715.41,refund,in,Counterparty_80,22599436.69,,
2025-03-19,6124.78,investment_income,in,Counterparty_46,22605561.47,,
2025-03-19,6720.05,T&E,out,Counterparty_36,22598841.42,2025-02-20,2025-03-28
2025-03-19,1283.35,T&E,out,Counterparty_48,22597558.07,2025-02-15,2025-03-18
2025-03-19,198.19,utilities,out,Counterparty_69,22597359.88,2025-02-08,2025-03-14
2025-03-19,7548.88,credit,in,Counterparty_74,22604908.76,,
2025-03-19,3729.2,payroll,out,Counterparty_77,22601179.56,2025-03-02,2025-03-31
2025-03-19,7820.02,marketing_spend,out,Counterparty_77,22593359.54,2025-02-22,2025-03-23
2025-03-19,1864.04,utilities,out,Counterparty_39,22591495.5,2025-02-14,2025-03-24
2025-03-19,45.18,rent,out,Counterparty_33,22591450.32,2025-02-17,2025-03-24
2025-03-19,5955.12,credit,in,Counterparty_50,22597405.44,,
2025-03-19,1590.38,utilities,out,Counterparty_55,22595815.06,2025-02-26,2025-03-23
2025-03-19,1701.64,investment_income,in,Counterparty_77,22597516.7,,
2025-03-19,9139.79,customer_payment,in,Counterparty_93,22606656.49,,
2025-03-19,15203.63,investment_income,in,Counterparty_49,22621860.12,,
2025-03-19,939.48,rent,out,Counterparty_69,22620920.64,2025-02-27,2025-04-07
2025-03-19,715.06,asset_sale,in,Counterparty_18,22621635.7,,
2025-03-19,112.18,software_subscription,out,Counterparty_5,22621523.52,2025-02-16,2025-03-17
2025-03-19,452.15,tax_payment,out,Counterparty_83,22621071.37,2025-03-01,2025-03-27
2025-03-19,66.09,tax_payment,out,Counterparty_94,22621005.28,2025-03-04,2025-03-29
2025-03-19,8542.44,refund,in,Counterparty_87,22629547.72,,
2025-03-19,1634.76,payroll,out,Counterparty_12,22627912.96,2025-02-09,2025-03-09
2025-03-19,1516.15,T&E,out,Counterparty_5,22626396.81,2025-02-17,2025-03-27
2025-03-19,1898.09,rent,out,Counterparty_60,22624498.72,2025-02-04,2025-03-11
2025-03-19,1393.79,payroll,out,Counterparty_20,22623104.93,2025-02-14,2025-03-17
2025-03-19,10681.95,utilities,out,Counterparty_24,22612422.98,2025-02-11,2025-03-16
2025-03-19,589.98,T&E,out,Counterparty_49,22611833.0,2025-03-03,2025-03-31
2025-03-19,1169.56,software_subscription,out,Counterparty_24,22610663.44,2025-02-18,2025-03-25
2025-03-19,12015.74,refund,in,Counterparty_66,22622679.18,,
2025-03-19,309.03,T&E,out,Counterparty_45,22622370.15,2025-02-03,2025-03-07
2025-03-19,1906.69,utilities,out,Counterparty_64,22620463.46,2025-02-28,2025-04-04
2025-03-19,6271.89,tax_payment,out,Counterparty_17,22614191.57,2025-02-04,2025-03-15
2025-03-19,1840.12,utilities,out,Counterparty_46,22612351.45,2025-02-14,2025-03-20
2025-03-19,4578.9,utilities,out,Counterparty_34,22607772.55,2025-02-24,2025-03-25
2025-03-19,8906.4,payroll,out,Counterparty_30,22598866.15,2025-02-10,2025-03-11
2025-03-19,3687.74,utilities,out,Counterparty_35,22595178.41,2025-02-25,2025-04-04
2025-03-19,4993.96,refund,in,Counterparty_90,22600172.37,,
2025-03-19,18844.3,investment_income,in,Counterparty_26,22619016.67,,
2025-03-19,1044.03,customer_payment,in,Counterparty_83,22620060.7,,
2025-03-19,1976.71,rent,out,Counterparty_14,22618083.99,2025-03-01,2025-04-07
2025-03-19,381.33,asset_sale,in,Counterparty_57,22618465.32,,
2025-03-19,2715.69,T&E,out,Counterparty_79,22615749.63,2025-02-11,2025-03-11
2025-03-19,1076.08,marketing_spend,out,Counterparty_86,22614673.55,2025-02-10,2025-03-07
2025-03-19,961.27,credit,in,Counterparty_48,22615634.82,,
2025-03-19,5115.88,credit,in,Counterparty_58,22620750.7,,
2025-03-19,225.97,marketing_spend,out,Counterparty_11,22620524.73,2025-02-17,2025-03-28
2025-03-19,1631.59,payroll,out,Counterparty_98,22618893.14,2025-02-04,2025-03-11
2025-03-19,27928.53,refund,in,Counterparty_45,22646821.67,,
2025-03-19,3928.57,asset_sale,in,Counterparty_93,22650750.24,,
2025-03-20,2019.92,payroll,out,Counterparty_12,22648730.32,2025-02-07,2025-03-10
2025-03-20,1180.2,utilities,out,Counterparty_87,22647550.12,2025-03-02,2025-04-09
2025-03-20,2360.09,marketing_spend,out,Counterparty_95,22645190.03,2025-02-19,2025-03-21
2025-03-20,49.24,T&E,out,Counterparty_51,22645140.79,2025-02-16,2025-03-19
2025-03-20,8705.3,supplier_payment,out,Counterparty_80,22636435.49,2025-02-22,2025-03-24
2025-03-20,237.73,marketing_spend,out,Counterparty_87,22636197.76,2025-02-21,2025-04-01
2025-03-20,214.59,software_subscription,out,Counterparty_90,22635983.17,2025-02-19,2025-03-21
2025-03-20,4915.04,utilities,out,Counterparty_31,22631068.13,2025-02-25,2025-03-28
2025-03-20,8150.06,tax_payment,out,Counterparty_63,22622918.07,2025-02-17,2025-03-25
2025-03-20,1015.61,T&E,out,Counterparty_92,22621902.46,2025-02-28,2025-04-02
2025-03-20,6918.84,marketing_spend,out,Counterparty_22,22614983.62,2025-02-18,2025-03-25
2025-03-20,77.93,payroll,out,Counterparty_56,22614905.69,2025-02-20,2025-03-30
2025-03-20,6149.98,rent,out,Counterparty_5,22608755.71,2025-03-03,2025-03-29
2025-03-20,2799.28,software_subscription,out,Counterparty_61,22605956.43,2025-02-26,2025-04-01
2025-03-20,298.88,software_subscription,out,Counterparty_43,22605657.55,2025-02-07,2025-03-09
2025-03-20,3197.03,T&E,out,Counterparty_71,22602460.52,2025-02-11,2025-03-08
2025-03-20,517.29,tax_payment,out,Counterparty_63,22601943.23,2025-02-28,2025-04-08
2025-03-20,2259.77,payroll,out,Counterparty_43,22599683.46,2025-03-04,2025-04-07
2025-03-20,18442.73,software_subscription,out,Counterparty_29,22581240.73,2025-02-10,2025-03-16
2025-03-20,2230.64,software_subscription,out,Counterparty_69,22579010.09,2025-02-19,2025-03-19
2025-03-20,260.09,software_subscription,out,Counterparty_36,22578750.0,2025-02-26,2025-04-05
2025-03-20,16192.97,refund,in,Counterparty_91,22594942.97,,
2025-03-20,10196.28,tax_payment,out,Counterparty_98,22584746.69,2025-02-08,2025-03-15
2025-03-20,6185.07,investment_income,in,Counterparty_21,22590931.76,,
2025-03-20,10198.6,investment_income,in,Counterparty_9,22601130.36,,
2025-03-20,5084.95,rent,out,Counterparty_96,22596045.41,2025-02-24,2025-04-04
2025-03-20,1142.77,T&E,out,Counterparty_60,22594902.64,2025-02-08,2025-03-18
2025-03-20,9809.08,investment_income,in,Counterparty_84,22604711.72,,
2025-03-20,4152.28,tax_payment,out,Counterparty_86,22600559.44,2025-02-26,2025-04-03
2025-03-20,1091.86,supplier_payment,out,Counterparty_64,22599467.58,2025-02-08,2025-03-09
2025-03-20,2253.89,asset_sale,in,Counterparty_94,22601721.47,,
2025-03-20,6.28,supplier_payment,out,Counterparty_27,22601715.19,2025-02-18,2025-03-21
2025-03-20,10820.91,investment_income,in,Counterparty_89,22612536.1,,
2025-03-20,7557.18,payroll,out,Counterparty_76,22604978.92,2025-03-05,2025-04-07
2025-03-20,3777.09,refund,in,Counterparty_47,22608756.01,,
2025-03-20,46.83,investment_income,in,Counterparty_85,22608802.84,,
2025-03-20,298.83,tax_payment,out,Counterparty_82,22608504.01,2025-02-19,2025-03-26
2025-03-20,227.36,loan_repayment,out,Counterparty_34,22608276.65,2025-02-17,2025-03-25
2025-03-20,1827.61,asset_sale,in,Counterparty_57,22610104.26,,
2025-03-20,3412.01,investment_income,in,Counterparty_40,22613516.27,,
2025-03-20,2273.32,supplier_payment,out,Counterparty_23,22611242.95,2025-03-02,2025-04-05
2025-03-20,3789.47,marketing_spend,out,Counterparty_49,22607453.48,2025-02-21,2025-03-28
2025-03-20,2234.12,credit,in,Counterparty_32,22609687.6,,
2025-03-20,765.04,asset_sale,in,Counterparty_94,22610452.64,,
2025-03-20,869.2,marketing_spend,out,Counterparty_15,22609583.44,2025-02-06,2025-03-13
2025-03-20,5056.37,tax_payment,out,Counterparty_84,22604527.07,2025-02-17,2025-03-17
2025-03-20,5787.74,supplier_payment,out,Counterparty_58,22598739.33,2025-03-03,2025-04-03
2025-03-20,14374.87,asset_sale,in,Counterparty_38,22613114.2,,
2025-03-20,4341.41,supplier_payment,out,Counterparty_98,22608772.79,2025-02-20,2025-03-27
2025-03-20,1939.81,refund,in,Counterparty_83,22610712.6,,
2025-03-20,1021.35,supplier_payment,out,Counterparty_9,22609691.25,2025-03-01,2025-04-07
2025-03-20,6066.1,utilities,out,Counterparty_93,22603625.15,2025-02-21,2025-04-01
2025-03-20,1569.23,T&E,out,Counterparty_15,22602055.92,2025-03-02,2025-04-01
2025-03-20,7384.03,customer_payment,in,Counterparty_33,22609439.95,,
2025-03-20,307.08,refund,in,Counterparty_95,22609747.03,,
2025-03-20,807.63,asset_sale,in,Counterparty_54,22610554.66,,
2025-03-20,18113.55,customer_payment,in,Counterparty_32,22628668.21,,
2025-03-20,465.9,payroll,out,Counterparty_11,22628202.31,2025-02-09,2025-03-15
2025-03-20,619.05,supplier_payment,out,Counterparty_91,22627583.26,2025-03-03,2025-04-08
2025-03-20,4979.58,T&E,out,Counterparty_3,22622603.68,2025-02-28,2025-04-06
2025-03-20,5443.29,refund,in,Counterparty_5,22628046.97,,
2025-03-20,1057.28,refund,in,Counterparty_36,22629104.25,,
2025-03-20,976.52,software_subscription,out,Counterparty_62,22628127.73,2025-02-28,2025-03-30
2025-03-21,1526.06,rent,out,Counterparty_80,22626601.67,2025-02-20,2025-03-28
2025-03-21,4847.28,software_subscription,out,Counterparty_88,22621754.39,2025-02-19,2025-03-17
2025-03-21,1607.94,tax_payment,out,Counterparty_30,22620146.45,2025-02-08,2025-03-14
2025-03-21,6307.56,payroll,out,Counterparty_4,22613838.89,2025-02-20,2025-03-19
2025-03-21,3474.16,payroll,out,Counterparty_73,22610364.73,2025-02-12,2025-03-19
2025-03-21,3784.34,rent,out,Counterparty_41,22606580.39,2025-02-23,2025-03-24
2025-03-21,3983.4,utilities,out,Counterparty_14,22602596.99,2025-02-06,2025-03-15
2025-03-21,2582.53,marketing_spend,out,Counterparty_68,22600014.46,2025-02-25,2025-03-28
2025-03-21,164.93,supplier_payment,out,Counterparty_93,22599849.53,2025-02-10,2025-03-09
2025-03-21,3812.24,T&E,out,Counterparty_57,22596037.29,2025-02-06,2025-03-09
2025-03-21,349.55,loan_repayment,out,Counterparty_81,22595687.74,2025-02-18,2025-03-27
2025-03-21,902.75,supplier_payment,out,Counterparty_13,22594784.99,2025-02-19,2025-03-25
2025-03-21,4180.8,payroll,out,Counterparty_62,22590604.19,2025-02-24,2025-03-31
2025-03-21,1627.87,asset_sale,in,Counterparty_45,22592232.06,,
2025-03-21,1577.54,loan_repayment,out,Counterparty_81,22590654.52,2025-02-24,2025-03-30
2025-03-21,3264.95,supplier_payment,out,Counterparty_94,22587389.57,2025-03-02,2025-04-01
2025-03-21,3498.07,supplier_payment,out,Counterparty_23,22583891.5,2025-02-08,2025-03-10
2025-03-21,5342.96,software_subscription,out,Counterparty_8,22578548.54,2025-02-05,2025-03-05
2025-03-21,421.41,utilities,out,Counterparty_88,22578127.13,2025-02-08,2025-03-10
2025-03-21,3474.37,supplier_payment,out,Counterparty_31,22574652.76,2025-03-06,2025-03-31
2025-03-21,6457.71,asset_sale,in,Counterparty_22,22581110.47,,
2025-03-21,7838.52,asset_sale,in,Counterparty_96,22588948.99,,
2025-03-21,840.15,loan_repayment,out,Counterparty_43,22588108.84,2025-02-07,2025-03-06
2025-03-21,45.18,asset_sale,in,Counterparty_97,22588154.02,,
2025-03-21,3492.63,T&E,out,Counterparty_30,22584661.39,2025-02-10,2025-03-08
2025-03-21,185.95,tax_payment,out,Counterparty_88,22584475.44,2025-03-03,2025-03-30
2025-03-21,1771.29,supplier_payment,out,Counterparty_71,22582704.15,2025-02-21,2025-03-28
2025-03-21,14178.66,asset_sale,in,Counterparty_6,22596882.81,,
2025-03-21,164.11,rent,out,Counterparty_13,22596718.7,2025-02-26,2025-03-25
2025-03-21,13690.93,refund,in,Counterparty_76,22610409.63,,
2025-03-21,488.56,asset_sale,in,Counterparty_81,22610898.19,,
2025-03-21,4351.1,investment_income,in,Counterparty_91,22615249.29,,
2025-03-21,270.61,loan_repayment,out,Counterparty_18,22614978.68,2025-03-05,2025-04-13
2025-03-21,1348.1,loan_repayment,out,Counterparty_82,22613630.58,2025-02-06,2025-03-05
2025-03-21,21322.31,investment_income,in,Counterparty_34,22634952.89,,
2025-03-21,905.8,investment_income,in,Counterparty_91,22635858.69,,
2025-03-21,7654.87,T&E,out,Counterparty_79,22628203.82,2025-02-07,2025-03-11
2025-03-21,699.92,utilities,out,Counterparty_5,22627503.9,2025-03-04,2025-03-30
2025-03-21,1281.73,software_subscription,out,Counterparty_35,22626222.17,2025-02-05,2025-03-15
2025-03-21,1465.14,software_subscription,out,Counterparty_7,22624757.03,2025-02-19,2025-03-16
2025-03-21,1163.45,asset_sale,in,Counterparty_26,22625920.48,,
2025-03-21,5681.59,utilities,out,Counterparty_10,22620238.89,2025-03-05,2025-04-11
2025-03-21,4752.0,customer_payment,in,Counterparty_7,22624990.89,,
2025-03-21,626.41,rent,out,Counterparty_4,22624364.48,2025-02-24,2025-04-01
2025-03-21,649.46,credit,in,Counterparty_92,22625013.94,,
2025-03-21,2076.99,supplier_payment,out,Counterparty_20,22622936.95,2025-03-02,2025-04-05
2025-03-21,2645.13,T&E,out,Counterparty_66,22620291.82,2025-02-17,2025-03-18
2025-03-21,1517.42,supplier_payment,out,Counterparty_70,22618774.4,2025-02-13,2025-03-17
2025-03-21,7136.79,customer_payment,in,Counterparty_59,22625911.19,,
2025-03-21,6298.33,supplier_payment,out,Counterparty_21,22619612.86,2025-02-11,2025-03-22
2025-03-21,3608.13,utilities,out,Counterparty_48,22616004.73,2025-02-22,2025-03-23
2025-03-21,3002.49,software_subscription,out,Counterparty_24,22613002.24,2025-02-14,2025-03-25
2025-03-21,459.33,utilities,out,Counterparty_16,22612542.91,2025-02-08,2025-03-17
2025-03-21,384.36,rent,out,Counterparty_1,22612158.55,2025-02-25,2025-03-24
2025-03-21,1199.95,software_subscription,out,Counterparty_14,22610958.6,2025-02-08,2025-03-17
2025-03-21,12.08,rent,out,Counterparty_82,22610946.52,2025-02-24,2025-03-23
2025-03-21,65.35,utilities,out,Counterparty_8,22610881.17,2025-02-07,2025-03-07
2025-03-21,4536.25,tax_payment,out,Counterparty_68,22606344.92,2025-03-01,2025-03-31
2025-03-21,328.59,payroll,out,Counterparty_93,22606016.33,2025-02-06,2025-03-13
2025-03-21,1549.24,refund,in,Counterparty_27,22607565.57,,
2025-03-21,17539.19,credit,in,Counterparty_95,22625104.76,,
2025-03-21,4828.4,investment_income,in,Counterparty_51,22629933.16,,
2025-03-21,3536.74,asset_sale,in,Counterparty_54,22633469.9,,
2025-03-21,715.2,loan_repayment,out,Counterparty_88,22632754.7,2025-03-05,2025-04-09
2025-03-21,341.82,software_subscription,out,Counterparty_36,22632412.88,2025-02-06,2025-03-17
2025-03-22,17707.68,asset_sale,in,Counterparty_22,22650120.56,,
2025-03-22,35382.68,refund,in,Counterparty_67,22685503.24,,
2025-03-22,16026.01,asset_sale,in,Counterparty_79,22701529.25,,
2025-03-22,4007.13,credit,in,Counterparty_62,22705536.38,,
2025-03-22,82.49,software_subscription,out,Counterparty_75,22705453.89,2025-02-24,2025-03-21
2025-03-22,3642.52,refund,in,Counterparty_19,22709096.41,,
2025-03-22,12306.35,investment_income,in,Counterparty_77,22721402.76,,
2025-03-22,2320.91,payroll,out,Counterparty_8,22719081.85,2025-02-07,2025-03-13
2025-03-22,160.67,asset_sale,in,Counterparty_72,22719242.52,,
2025-03-22,2178.83,asset_sale,in,Counterparty_58,22721421.35,,
2025-03-22,2111.84,supplier_payment,out,Counterparty_4,22719309.51,2025-02-21,2025-03-23
2025-03-22,1736.85,credit,in,Counterparty_13,22721046.36,,
2025-03-22,4479.36,customer_payment,in,Counterparty_28,22725525.72,,
2025-03-22,5848.19,utilities,out,Counterparty_19,22719677.53,2025-02-21,2025-03-31
2025-03-22,5981.2,customer_payment,in,Counterparty_1,22725658.73,,
2025-03-22,2139.28,investment_income,in,Counterparty_7,22727798.01,,
2025-03-22,2856.72,payroll,out,Counterparty_19,22724941.29,2025-02-25,2025-04-01
2025-03-22,3770.28,rent,out,Counterparty_7,22721171.01,2025-02-18,2025-03-17
2025-03-22,2701.68,utilities,out,Counterparty_58,22718469.33,2025-03-04,2025-04-02
2025-03-22,1697.96,refund,in,Counterparty_49,22720167.29,,
2025-03-22,246.96,marketing_spend,out,Counterparty_25,22719920.33,2025-03-06,2025-04-02
2025-03-22,503.56,customer_payment,in,Counterparty_49,22720423.89,,
2025-03-22,6480.79,utilities,out,Counterparty_42,22713943.1,2025-03-07,2025-04-14
2025-03-22,785.16,utilities,out,Counterparty_11,22713157.94,2025-02-17,2025-03-22
2025-03-22,949.09,investment_income,in,Counterparty_34,22714107.03,,
2025-03-22,12129.81,customer_payment,in,Counterparty_38,22726236.84,,
2025-03-22,12905.0,investment_income,in,Counterparty_99,22739141.84,,
2025-03-22,521.98,marketing_spend,out,Counterparty_99,22738619.86,2025-03-04,2025-04-03
2025-03-22,19000.29,refund,in,Counterparty_36,22757620.15,,
2025-03-22,621.62,payroll,out,Counterparty_60,22756998.53,2025-02-18,2025-03-22
2025-03-22,27188.22,credit,in,Counterparty_85,22784186.75,,
2025-03-22,2358.63,asset_sale,in,Counterparty_34,22786545.38,,
2025-03-22,4538.26,customer_payment,in,Counterparty_63,22791083.64,,
2025-03-22,3039.96,customer_payment,in,Counterparty_48,22794123.6,,
2025-03-22,323.41,software_subscription,out,Counterparty_22,22793800.19,2025-02-21,2025-03-29
2025-03-22,894.51,customer_payment,in,Counterparty_9,22794694.7,,
2025-03-22,3978.34,credit,in,Counterparty_36,22798673.04,,
2025-03-22,2833.36,software_subscription,out,Counterparty_55,22795839.68,2025-02-15,2025-03-12
2025-03-22,4168.49,tax_payment,out,Counterparty_88,22791671.19,2025-02-13,2025-03-16
2025-03-22,1145.66,supplier_payment,out,Counterparty_86,22790525.53,2025-02-20,2025-03-20
2025-03-22,1562.82,software_subscription,out,Counterparty_4,22788962.71,2025-03-03,2025-03-28
2025-03-22,4208.23,loan_repayment,out,Counterparty_67,22784754.48,2025-02-21,2025-04-01
2025-03-22,5926.54,supplier_payment,out,Counterparty_6,22778827.94,2025-02-07,2025-03-16
2025-03-22,1404.12,tax_payment,out,Counterparty_38,22777423.82,2025-02-23,2025-03-22
2025-03-22,2650.98,tax_payment,out,Counterparty_34,22774772.84,2025-02-06,2025-03-07
2025-03-22,7889.98,T&E,out,Counterparty_40,22766882.86,2025-02-08,2025-03-19
2025-03-22,6954.61,rent,out,Counterparty_75,22759928.25,2025-03-02,2025-04-03
2025-03-22,2666.71,software_subscription,out,Counterparty_23,22757261.54,2025-02-24,2025-03-24
2025-03-22,5259.45,rent,out,Counterparty_91,22752002.09,2025-02-15,2025-03-25
2025-03-22,2346.3,tax_payment,out,Counterparty_4,22749655.79,2025-02-09,2025-03-06
2025-03-22,8223.44,T&E,out,Counterparty_87,22741432.35,2025-03-03,2025-04-04
2025-03-22,6949.56,payroll,out,Counterparty_76,22734482.79,2025-02-08,2025-03-16
2025-03-22,362.3,supplier_payment,out,Counterparty_53,22734120.49,2025-02-20,2025-03-18
2025-03-22,3758.57,tax_payment,out,Counterparty_13,22730361.92,2025-02-13,2025-03-19
2025-03-22,1861.53,software_subscription,out,Counterparty_70,22728500.39,2025-02-27,2025-03-31
2025-03-22,3755.76,marketing_spend,out,Counterparty_38,22724744.63,2025-02-09,2025-03-18
2025-03-22,3556.73,software_subscription,out,Counterparty_95,22721187.9,2025-02-22,2025-03-27
2025-03-23,119.52,payroll,out,Counterparty_83,22721068.38,2025-03-05,2025-04-01
2025-03-23,5277.11,T&E,out,Counterparty_32,22715791.27,2025-03-01,2025-03-27
2025-03-23,9934.05,refund,in,Counterparty_83,22725725.32,,
2025-03-23,3064.86,credit,in,Counterparty_53,22728790.18,,
2025-03-23,6424.82,marketing_spend,out,Counterparty_76,22722365.36,2025-02-09,2025-03-16
2025-03-23,3142.69,loan_repayment,out,Counterparty_26,22719222.67,2025-03-04,2025-04-03
2025-03-23,34.03,payroll,out,Counterparty_41,22719188.64,2025-03-06,2025-04-11
2025-03-23,6395.35,customer_payment,in,Counterparty_3,22725583.99,,
2025-03-23,1417.37,supplier_payment,out,Counterparty_85,22724166.62,2025-02-23,2025-04-01
2025-03-23,777.81,loan_repayment,out,Counterparty_55,22723388.81,2025-03-06,2025-04-02
2025-03-23,4348.19,supplier_payment,out,Counterparty_47,22719040.62,2025-02-08,2025-03-10
2025-03-23,1018.77,loan_repayment,out,Counterparty_32,22718021.85,2025-03-01,2025-04-01
2025-03-23,13074.31,asset_sale,in,Counterparty_7,22731096.16,,
2025-03-23,3843.44,asset_sale,in,Counterparty_57,22734939.6,,
2025-03-23,719.3,payroll,out,Counterparty_74,22734220.3,2025-02-08,2025-03-15
2025-03-23,7895.68,refund,in,Counterparty_3,22742115.98,,
2025-03-23,1711.16,asset_sale,in,Counterparty_26,22743827.14,,
2025-03-23,14239.08,asset_sale,in,Counterparty_26,22758066.22,,
2025-03-23,13610.58,utilities,out,Counterparty_98,22744455.64,2025-02-22,2025-03-21
2025-03-23,1857.0,refund,in,Counterparty_81,22746312.64,,
2025-03-23,28629.39,asset_sale,in,Counterparty_62,22774942.03,,
2025-03-23,7702.09,credit,in,Counterparty_47,22782644.12,,
2025-03-23,7584.64,credit,in,Counterparty_34,22790228.76,,
2025-03-23,6053.8,payroll,out,Counterparty_65,22784174.96,2025-02-17,2025-03-18
2025-03-23,6292.07,supplier_payment,out,Counterparty_53,22777882.89,2025-02-21,2025-03-30
2025-03-23,6790.38,asset_sale,in,Counterparty_99,22784673.27,,
2025-03-23,177.8,credit,in,Counterparty_21,22784851.07,,
2025-03-23,25198.79,credit,in,Counterparty_56,22810049.86,,
2025-03-23,19352.68,customer_payment,in,Counterparty_25,22829402.54,,
2025-03-23,489.55,investment_income,in,Counterparty_47,22829892.09,,
2025-03-23,15983.98,software_subscription,out,Counterparty_5,22813908.11,2025-02-15,2025-03-22
2025-03-23,8315.24,supplier_payment,out,Counterparty_41,22805592.87,2025-02-12,2025-03-14
2025-03-23,1902.81,credit,in,Counterparty_18,22807495.68,,
2025-03-23,2077.12,loan_repayment,out,Counterparty_17,22805418.56,2025-02-24,2025-03-29
2025-03-23,13966.82,supplier_payment,out,Counterparty_4,22791451.74,2025-03-02,2025-03-29
2025-03-23,3720.99,tax_payment,out,Counterparty_30,22787730.75,2025-02-18,2025-03-29
2025-03-23,3869.39,rent,out,Counterparty_80,22783861.36,2025-02-07,2025-03-07
2025-03-23,13959.57,refund,in,Counterparty_74,22797820.93,,
2025-03-23,3561.28,credit,in,Counterparty_78,22801382.21,,
2025-03-23,4120.09,asset_sale,in,Counterparty_28,22805502.3,,
2025-03-23,7824.04,asset_sale,in,Counterparty_5,22813326.34,,
2025-03-23,1907.27,investment_income,in,Counterparty_9,22815233.61,,
2025-03-23,318.18,supplier_payment,out,Counterparty_87,22814915.43,2025-02-19,2025-03-28
2025-03-23,6974.21,customer_payment,in,Counterparty_60,22821889.64,,
2025-03-23,2321.65,software_subscription,out,Counterparty_83,22819567.99,2025-02-08,2025-03-08
2025-03-23,6182.26,asset_sale,in,Counterparty_21,22825750.25,,
2025-03-23,6431.8,refund,in,Counterparty_67,22832182.05,,
2025-03-23,3320.23,tax_payment,out,Counterparty_31,22828861.82,2025-02-27,2025-03-26
2025-03-23,3167.89,credit,in,Counterparty_25,22832029.71,,
2025-03-23,1359.81,marketing_spend,out,Counterparty_36,22830669.9,2025-02-16,2025-03-24
2025-03-23,1230.63,marketing_spend,out,Counterparty_90,22829439.27,2025-02-23,2025-04-01
2025-03-23,3784.4,credit,in,Counterparty_77,22833223.67,,
2025-03-23,7800.32,customer_payment,in,Counterparty_81,22841023.99,,
2025-03-23,34543.08,refund,in,Counterparty_83,22875567.07,,
2025-03-23,6166.7,utilities,out,Counterparty_27,22869400.37,2025-03-07,2025-04-06
2025-03-23,298.44,payroll,out,Counterparty_28,22869101.93,2025-02-28,2025-03-26
2025-03-23,11332.53,credit,in,Counterparty_21,22880434.46,,
2025-03-23,6585.75,rent,out,Counterparty_39,22873848.71,2025-02-10,2025-03-13
2025-03-23,22769.91,refund,in,Counterparty_54,22896618.62,,
2025-03-23,5149.61,payroll,out,Counterparty_68,22891469.01,2025-02-27,2025-03-26
2025-03-23,484.68,rent,out,Counterparty_46,22890984.33,2025-02-18,2025-03-20
2025-03-23,546.63,T&E,out,Counterparty_32,22890437.7,2025-03-06,2025-04-13
2025-03-23,4525.69,payroll,out,Counterparty_67,22885912.01,2025-02-13,2025-03-11
2025-03-23,1249.8,loan_repayment,out,Counterparty_7,22884662.21,2025-03-04,2025-03-30
2025-03-23,5705.19,asset_sale,in,Counterparty_1,22890367.4,,
2025-03-23,1398.13,tax_payment,out,Counterparty_34,22888969.27,2025-03-01,2025-03-26
2025-03-23,15819.84,marketing_spend,out,Counterparty_82,22873149.43,2025-03-08,2025-04-05
2025-03-23,5868.82,software_subscription,out,Counterparty_2,22867280.61,2025-03-06,2025-04-01
2025-03-23,15769.66,credit,in,Counterparty_91,22883050.27,,
2025-03-23,1910.83,credit,in,Counterparty_6,22884961.1,,
2025-03-23,7753.11,refund,in,Counterparty_70,22892714.21,,
2025-03-23,744.68,utilities,out,Counterparty_11,22891969.53,2025-02-10,2025-03-07
2025-03-23,1900.07,T&E,out,Counterparty_57,22890069.46,2025-03-03,2025-04-02
2025-03-23,252.39,utilities,out,Counterparty_19,22889817.07,2025-02-19,2025-03-25
2025-03-23,2245.63,refund,in,Counterparty_33,22892062.7,,
2025-03-23,534.85,refund,in,Counterparty_12,22892597.55,,
2025-03-24,1245.48,tax_payment,out,Counterparty_97,22891352.07,2025-02-21,2025-03-24
2025-03-24,16337.59,customer_payment,in,Counterparty_32,22907689.66,,
2025-03-24,1521.05,payroll,out,Counterparty_57,22906168.61,2025-02-09,2025-03-18
2025-03-24,4016.41,customer_payment,in,Counterparty_23,22910185.02,,
2025-03-24,9177.43,asset_sale,in,Counterparty_17,22919362.45,,
2025-03-24,299.28,tax_payment,out,Counterparty_66,22919063.17,2025-02-22,2025-03-30
2025-03-24,54.82,investment_income,in,Counterparty_31,22919117.99,,
2025-03-24,414.81,refund,in,Counterparty_20,22919532.8,,
2025-03-24,4729.53,refund,in,Counterparty_34,22924262.33,,
2025-03-24,13829.81,software_subscription,out,Counterparty_4,22910432.52,2025-02-17,2025-03-18
2025-03-24,668.41,marketing_spend,out,Counterparty_41,22909764.11,2025-02-18,2025-03-23
2025-03-24,1924.92,rent,out,Counterparty_49,22907839.19,2025-03-06,2025-04-09
2025-03-24,3912.38,software_subscription,out,Counterparty_64,22903926.81,2025-03-04,2025-04-08
2025-03-24,1429.85,utilities,out,Counterparty_78,22902496.96,2025-03-05,2025-04-05
2025-03-24,19530.16,investment_income,in,Counterparty_55,22922027.12,,
2025-03-24,8113.18,credit,in,Counterparty_9,22930140.3,,
2025-03-24,4697.03,utilities,out,Counterparty_1,22925443.27,2025-02-12,2025-03-20
2025-03-24,4948.21,utilities,out,Counterparty_36,22920495.06,2025-03-01,2025-04-01
2025-03-24,15368.9,customer_payment,in,Counterparty_43,22935863.96,,
2025-03-24,254.84,loan_repayment,out,Counterparty_80,22935609.12,2025-02-09,2025-03-07
2025-03-24,4790.51,tax_payment,out,Counterparty_22,22930818.61,2025-03-06,2025-03-31
2025-03-24,13060.99,credit,in,Counterparty_22,22943879.6,,
2025-03-24,13449.8,customer_payment,in,Counterparty_26,22957329.4,,
2025-03-24,538.67,marketing_spend,out,Counterparty_94,22956790.73,2025-02-24,2025-03-21
2025-03-24,3637.58,credit,in,Counterparty_55,22960428.31,,
2025-03-24,15221.01,utilities,out,Counterparty_38,22945207.3,2025-03-07,2025-04-09
2025-03-24,2742.43,credit,in,Counterparty_5,22947949.73,,
2025-03-24,2624.91,tax_payment,out,Counterparty_50,22945324.82,2025-03-04,2025-04-01
2025-03-24,4435.55,T&E,out,Counterparty_95,22940889.27,2025-03-08,2025-04-02
2025-03-24,12301.23,credit,in,Counterparty_15,22953190.5,,
2025-03-24,9533.76,customer_payment,in,Counterparty_38,22962724.26,,
2025-03-24,3183.63,tax_payment,out,Counterparty_45,22959540.63,2025-02-13,2025-03-11
2025-03-24,3726.56,investment_income,in,Counterparty_68,22963267.19,,
2025-03-24,3284.56,software_subscription,out,Counterparty_44,22959982.63,2025-02-25,2025-04-03
2025-03-24,5759.61,refund,in,Counterparty_45,22965742.24,,
2025-03-24,14451.7,customer_payment,in,Counterparty_28,22980193.94,,
2025-03-24,8883.12,asset_sale,in,Counterparty_94,22989077.06,,
2025-03-24,4341.14,payroll,out,Counterparty_96,22984735.92,2025-02-16,2025-03-23
2025-03-24,11154.11,customer_payment,in,Counterparty_55,22995890.03,,
2025-03-24,4014.42,utilities,out,Counterparty_3,22991875.61,2025-02-13,2025-03-17
2025-03-24,1112.3,asset_sale,in,Counterparty_75,22992987.91,,
2025-03-24,625.59,rent,out,Counterparty_45,22992362.32,2025-02-27,2025-04-06
2025-03-24,14489.54,software_subscription,out,Counterparty_8,22977872.78,2025-03-01,2025-04-07
2025-03-24,813.69,loan_repayment,out,Counterparty_60,22977059.09,2025-03-02,2025-04-03
2025-03-24,1530.11,rent,out,Counterparty_57,22975528.98,2025-02-18,2025-03-17
2025-03-24,3769.21,refund,in,Counterparty_86,22979298.19,,
2025-03-24,1139.23,marketing_spend,out,Counterparty_85,22978158.96,2025-02-18,2025-03-16
2025-03-24,319.22,utilities,out,Counterparty_4,22977839.74,2025-02-12,2025-03-20
2025-03-24,1480.58,supplier_payment,out,Counterparty_28,22976359.16,2025-02-20,2025-03-29
2025-03-24,5056.15,asset_sale,in,Counterparty_17,22981415.31,,
2025-03-24,395.73,rent,out,Counterparty_86,22981019.58,2025-02-11,2025-03-08
2025-03-24,914.64,supplier_payment,out,Counterparty_86,22980104.94,2025-03-09,2025-04-07
2025-03-24,6363.16,credit,in,Counterparty_57,22986468.1,,
2025-03-24,2611.46,asset_sale,in,Counterparty_93,22989079.56,,
2025-03-24,902.89,rent,out,Counterparty_32,22988176.67,2025-03-04,2025-03-29
2025-03-24,6084.43,T&E,out,Counterparty_57,22982092.24,2025-02-28,2025-03-28
2025-03-24,3704.55,rent,out,Counterparty_65,22978387.69,2025-02-19,2025-03-29
2025-03-24,724.56,tax_payment,out,Counterparty_42,22977663.13,2025-02-25,2025-03-31
2025-03-24,205.13,T&E,out,Counterparty_47,22977458.0,2025-02-17,2025-03-15
2025-03-24,7479.28,T&E,out,Counterparty_49,22969978.72,2025-02-16,2025-03-23
2025-03-24,437.2,T&E,out,Counterparty_72,22969541.52,2025-03-09,2025-04-15
2025-03-24,741.51,credit,in,Counterparty_52,22970283.03,,
2025-03-24,4872.32,investment_income,in,Counterparty_32,22975155.35,,
2025-03-24,2698.4,utilities,out,Counterparty_71,22972456.95,2025-03-08,2025-04-02
2025-03-24,1985.28,payroll,out,Counterparty_95,22970471.67,2025-02-10,2025-03-15
2025-03-25,1840.29,software_subscription,out,Counterparty_90,22968631.38,2025-02-14,2025-03-20
2025-03-25,1072.05,utilities,out,Counterparty_56,22967559.33,2025-02-26,2025-03-27
2025-03-25,5062.67,loan_repayment,out,Counterparty_39,22962496.66,2025-02-13,2025-03-23
2025-03-25,7411.34,investment_income,in,Counterparty_75,22969908.0,,
2025-03-25,6386.79,software_subscription,out,Counterparty_24,22963521.21,2025-02-17,2025-03-22
2025-03-25,4997.42,credit,in,Counterparty_57,22968518.63,,
2025-03-25,2761.66,software_subscription,out,Counterparty_32,22965756.97,2025-02-28,2025-03-26
2025-03-25,4539.04,asset_sale,in,Counterparty_34,22970296.01,,
2025-03-25,2187.27,supplier_payment,out,Counterparty_79,22968108.74,2025-02-18,2025-03-29
2025-03-25,897.02,supplier_payment,out,Counterparty_7,22967211.72,2025-03-06,2025-04-06
2025-03-25,1866.37,investment_income,in,Counterparty_45,22969078.09,,
2025-03-25,6107.72,software_subscription,out,Counterparty_95,22962970.37,2025-02-28,2025-04-02
2025-03-25,4955.95,credit,in,Counterparty_67,22967926.32,,
2025-03-25,1191.3,marketing_spend,out,Counterparty_35,22966735.02,2025-02-19,2025-03-21
2025-03-25,3523.02,payroll,out,Counterparty_35,22963212.0,2025-02-20,2025-03-25
2025-03-25,1127.64,T&E,out,Counterparty_84,22962084.36,2025-02-10,2025-03-09
2025-03-25,16001.01,investment_income,in,Counterparty_52,22978085.37,,
2025-03-25,1188.15,T&E,out,Counterparty_14,22976897.22,2025-03-08,2025-04-11
2025-03-25,1990.95,software_subscription,out,Counterparty_13,22974906.27,2025-03-07,2025-04-12
2025-03-25,3008.89,loan_repayment,out,Counterparty_2,22971897.38,2025-02-23,2025-03-22
2025-03-25,4306.21,refund,in,Counterparty_89,22976203.59,,
2025-03-25,13862.77,customer_payment,in,Counterparty_58,22990066.36,,
2025-03-25,4007.43,refund,in,Counterparty_70,22994073.79,,
2025-03-25,3897.12,loan_repayment,out,Counterparty_6,22990176.67,2025-02-19,2025-03-30
2025-03-25,5273.84,supplier_payment,out,Counterparty_48,22984902.83,2025-03-01,2025-03-26
2025-03-25,789.1,marketing_spend,out,Counterparty_82,22984113.73,2025-02-21,2025-03-18
2025-03-25,1672.35,asset_sale,in,Counterparty_65,22985786.08,,
2025-03-25,1242.93,loan_repayment,out,Counterparty_65,22984543.15,2025-03-04,2025-04-04
2025-03-25,1405.39,payroll,out,Counterparty_6,22983137.76,2025-02-18,2025-03-15
2025-03-25,2480.85,tax_payment,out,Counterparty_67,22980656.91,2025-02-20,2025-03-26
2025-03-25,4083.02,payroll,out,Counterparty_12,22976573.89,2025-03-01,2025-04-06
2025-03-25,7160.82,marketing_spend,out,Counterparty_29,22969413.07,2025-02-15,2025-03-24
2025-03-25,3835.97,loan_repayment,out,Counterparty_81,22965577.1,2025-03-05,2025-04-07
2025-03-25,68.55,T&E,out,Counterparty_1,22965508.55,2025-02-27,2025-04-01
2025-03-25,2239.08,payroll,out,Counterparty_37,22963269.47,2025-03-09,2025-04-07
2025-03-25,1793.45,software_subscription,out,Counterparty_75,22961476.02,2025-02-14,2025-03-24
2025-03-25,5682.04,credit,in,Counterparty_74,22967158.06,,
2025-03-25,330.36,payroll,out,Counterparty_94,22966827.7,2025-02-27,2025-04-05
2025-03-25,3414.95,supplier_payment,out,Counterparty_65,22963412.75,2025-02-17,2025-03-21
2025-03-25,6215.64,refund,in,Counterparty_78,22969628.39,,
2025-03-25,3915.57,asset_sale,in,Counterparty_51,22973543.96,,
2025-03-25,1617.3,supplier_payment,out,Counterparty_83,22971926.66,2025-02-15,2025-03-24
2025-03-25,1729.2,credit,in,Counterparty_22,22973655.86,,
2025-03-25,4689.25,supplier_payment,out,Counterparty_32,22968966.61,2025-02-10,2025-03-09
2025-03-25,20434.69,credit,in,Counterparty_31,22989401.3,,
2025-03-25,19412.26,asset_sale,in,Counterparty_9,23008813.56,,
2025-03-25,122.05,refund,in,Counterparty_44,23008935.61,,
2025-03-25,856.59,marketing_spend,out,Counterparty_27,23008079.02,2025-02-23,2025-03-27
2025-03-25,3587.72,rent,out,Counterparty_16,23004491.3,2025-02-26,2025-04-03
2025-03-25,6134.32,utilities,out,Counterparty_28,22998356.98,2025-03-07,2025-04-13
2025-03-25,1856.29,investment_income,in,Counterparty_13,23000213.27,,
2025-03-25,4333.31,customer_payment,in,Counterparty_44,23004546.58,,
2025-03-25,2473.43,utilities,out,Counterparty_95,23002073.15,2025-02-09,2025-03-06
2025-03-25,140.02,supplier_payment,out,Counterparty_35,23001933.13,2025-02-09,2025-03-08
2025-03-25,26887.03,asset_sale,in,Counterparty_31,23028820.16,,
2025-03-25,507.04,supplier_payment,out,Counterparty_44,23028313.12,2025-02-18,2025-03-29
2025-03-25,983.25,tax_payment,out,Counterparty_43,23027329.87,2025-02-13,2025-03-24
2025-03-26,471.62,software_subscription,out,Counterparty_35,23026858.25,2025-03-07,2025-04-09
2025-03-26,5764.48,refund,in,Counterparty_90,23032622.73,,
2025-03-26,778.8,credit,in,Counterparty_96,23033401.53,,
2025-03-26,147.99,rent,out,Counterparty_40,23033253.54,2025-02-17,2025-03-17
2025-03-26,2226.14,software_subscription,out,Counterparty_32,23031027.4,2025-02-20,2025-03-18
2025-03-26,1320.32,utilities,out,Counterparty_46,23029707.08,2025-03-09,2025-04-10
2025-03-26,1018.21,payroll,out,Counterparty_29,23028688.87,2025-02-28,2025-03-27
2025-03-26,479.53,T&E,out,Counterparty_85,23028209.34,2025-02-17,2025-03-20
2025-03-26,2828.54,loan_repayment,out,Counterparty_64,23025380.8,2025-02-11,2025-03-21
2025-03-26,874.93,loan_repayment,out,Counterparty_91,23024505.87,2025-02-24,2025-03-25
2025-03-26,7751.22,credit,in,Counterparty_19,23032257.09,,
2025-03-26,11352.72,investment_income,in,Counterparty_27,23043609.81,,
2025-03-26,584.75,software_subscription,out,Counterparty_73,23043025.06,2025-02-12,2025-03-09
2025-03-26,6002.76,loan_repayment,out,Counterparty_86,23037022.3,2025-03-11,2025-04-18
2025-03-26,12342.91,investment_income,in,Counterparty_64,23049365.21,,
2025-03-26,747.69,credit,in,Counterparty_36,23050112.9,,
2025-03-26,1635.94,T&E,out,Counterparty_84,23048476.96,2025-02-28,2025-04-05
2025-03-26,3661.6,T&E,out,Counterparty_71,23044815.36,2025-03-06,2025-04-11
2025-03-26,5354.44,supplier_payment,out,Counterparty_53,23039460.92,2025-03-05,2025-04-05
2025-03-26,201.69,rent,out,Counterparty_62,23039259.23,2025-02-21,2025-03-28
2025-03-26,2937.15,credit,in,Counterparty_26,23042196.38,,
2025-03-26,538.95,loan_repayment,out,Counterparty_84,23041657.43,2025-03-11,2025-04-19
2025-03-26,1376.72,supplier_payment,out,Counterparty_64,23040280.71,2025-03-07,2025-04-08
2025-03-26,1294.36,loan_repayment,out,Counterparty_30,23038986.35,2025-02-25,2025-03-26
2025-03-26,3952.4,payroll,out,Counterparty_35,23035033.95,2025-02-23,2025-03-21
2025-03-26,7551.17,customer_payment,in,Counterparty_57,23042585.12,,
2025-03-26,5368.47,asset_sale,in,Counterparty_87,23047953.59,,
2025-03-26,1918.52,tax_payment,out,Counterparty_31,23046035.07,2025-03-02,2025-04-01
2025-03-26,2445.47,rent,out,Counterparty_58,23043589.6,2025-02-19,2025-03-21
2025-03-26,23740.38,investment_income,in,Counterparty_3,23067329.98,,
2025-03-26,2236.44,software_subscription,out,Counterparty_42,23065093.54,2025-02-18,2025-03-28
2025-03-26,3857.57,tax_payment,out,Counterparty_91,23061235.97,2025-03-02,2025-04-04
2025-03-26,4713.95,refund,in,Counterparty_32,23065949.92,,
2025-03-26,30162.15,refund,in,Counterparty_67,23096112.07,,
2025-03-26,3249.62,tax_payment,out,Counterparty_42,23092862.45,2025-03-01,2025-04-06
2025-03-26,3844.45,software_subscription,out,Counterparty_94,23089018.0,2025-02-23,2025-03-21
2025-03-26,10347.53,customer_payment,in,Counterparty_19,23099365.53,,
2025-03-26,4059.35,investment_income,in,Counterparty_74,23103424.88,,
2025-03-26,780.82,software_subscription,out,Counterparty_92,23102644.06,2025-02-10,2025-03-08
2025-03-26,369.13,utilities,out,Counterparty_43,23102274.93,2025-02-13,2025-03-24
2025-03-26,12944.25,investment_income,in,Counterparty_22,23115219.18,,
2025-03-26,1000.78,investment_income,in,Counterparty_35,23116219.96,,
2025-03-26,1309.25,rent,out,Counterparty_19,23114910.71,2025-02-26,2025-03-27
2025-03-26,4677.61,supplier_payment,out,Counterparty_51,23110233.1,2025-02-10,2025-03-16
2025-03-26,11589.61,software_subscription,out,Counterparty_50,23098643.49,2025-02-11,2025-03-10
2025-03-26,697.58,T&E,out,Counterparty_7,23097945.91,2025-02-22,2025-03-28
2025-03-26,4746.91,T&E,out,Counterparty_29,23093199.0,2025-02-21,2025-03-25
2025-03-26,6218.27,software_subscription,out,Counterparty_89,23086980.73,2025-03-03,2025-03-28
2025-03-26,554.82,T&E,out,Counterparty_36,23086425.91,2025-02-13,2025-03-18
2025-03-26,26496.28,asset_sale,in,Counterparty_26,23112922.19,,
2025-03-26,2764.1,asset_sale,in,Counterparty_37,23115686.29,,
2025-03-26,224.56,loan_repayment,out,Counterparty_27,23115461.73,2025-02-20,2025-03-18
2025-03-26,1852.33,T&E,out,Counterparty_19,23113609.4,2025-02-22,2025-03-24
2025-03-26,3231.04,loan_repayment,out,Counterparty_36,23110378.36,2025-02-12,2025-03-14
2025-03-26,2914.08,marketing_spend,out,Counterparty_28,23107464.28,2025-02-25,2025-03-26
2025-03-26,28425.94,refund,in,Counterparty_35,23135890.22,,
2025-03-26,5441.73,rent,out,Counterparty_64,23130448.49,2025-02-18,2025-03-18
2025-03-26,9345.9,credit,in,Counterparty_58,23139794.39,,
2025-03-26,2275.57,software_subscription,out,Counterparty_47,23137518.82,2025-02-12,2025-03-18
2025-03-27,2404.26,rent,out,Counterparty_63,23135114.56,2025-02-12,2025-03-16
2025-03-27,1013.37,marketing_spend,out,Counterparty_97,23134101.19,2025-02-17,2025-03-28
2025-03-27,9343.18,marketing_spend,out,Counterparty_44,23124758.01,2025-02-19,2025-03-17
2025-03-27,6020.37,marketing_spend,out,Counterparty_89,23118737.64,2025-03-10,2025-04-18
2025-03-27,8154.82,utilities,out,Counterparty_15,23110582.82,2025-02-16,2025-03-16
2025-03-27,17067.48,utilities,out,Counterparty_66,23093515.34,2025-02-17,2025-03-20
2025-03-27,3293.21,utilities,out,Counterparty_69,23090222.13,2025-03-10,2025-04-14
2025-03-27,5178.14,supplier_payment,out,Counterparty_29,23085043.99,2025-03-08,2025-04-04
2025-03-27,4006.38,rent,out,Counterparty_80,23081037.61,2025-03-09,2025-04-16
2025-03-27,432.24,supplier_payment,out,Counterparty_30,23080605.37,2025-02-14,2025-03-17
2025-03-27,4192.68,marketing_spend,out,Counterparty_74,23076412.69,2025-02-15,2025-03-18
2025-03-27,837.27,payroll,out,Counterparty_91,23075575.42,2025-03-12,2025-04-12
2025-03-27,3802.25,asset_sale,in,Counterparty_72,23079377.67,,
2025-03-27,1719.04,utilities,out,Counterparty_48,23077658.63,2025-03-01,2025-04-01
2025-03-27,2792.3,refund,in,Counterparty_88,23080450.93,,
2025-03-27,1613.57,utilities,out,Counterparty_10,23078837.36,2025-03-08,2025-04-07
2025-03-27,1105.12,tax_payment,out,Counterparty_99,23077732.24,2025-02-26,2025-04-04
2025-03-27,8284.4,utilities,out,Counterparty_68,23069447.84,2025-02-15,2025-03-20
2025-03-27,8342.39,credit,in,Counterparty_15,23077790.23,,
2025-03-27,110.73,tax_payment,out,Counterparty_40,23077679.5,2025-03-01,2025-04-08
2025-03-27,7527.49,software_subscription,out,Counterparty_70,23070152.01,2025-02-28,2025-04-06
2025-03-27,5807.63,credit,in,Counterparty_26,23075959.64,,
2025-03-27,3844.04,T&E,out,Counterparty_16,23072115.6,2025-03-04,2025-04-10
2025-03-27,3037.77,marketing_spend,out,Counterparty_89,23069077.83,2025-03-02,2025-04-10
2025-03-27,19878.13,investment_income,in,Counterparty_23,23088955.96,,
2025-03-27,1683.51,refund,in,Counterparty_72,23090639.47,,
2025-03-27,13524.16,refund,in,Counterparty_40,23104163.63,,
2025-03-27,11754.32,asset_sale,in,Counterparty_16,23115917.95,,
2025-03-27,19854.85,credit,in,Counterparty_63,23135772.8,,
2025-03-27,4175.04,customer_payment,in,Counterparty_3,23139947.84,,
2025-03-27,7965.04,asset_sale,in,Counterparty_21,23147912.88,,
2025-03-27,1137.07,credit,in,Counterparty_20,23149049.95,,
2025-03-27,2714.57,refund,in,Counterparty_31,23151764.52,,
2025-03-27,5841.09,utilities,out,Counterparty_62,23145923.43,2025-02-24,2025-04-03
2025-03-27,166.61,supplier_payment,out,Counterparty_91,23145756.82,2025-02-17,2025-03-26
2025-03-27,10987.67,refund,in,Counterparty_61,23156744.49,,
2025-03-27,2308.05,investment_income,in,Counterparty_52,23159052.54,,
2025-03-27,3524.29,tax_payment,out,Counterparty_70,23155528.25,2025-02-22,2025-03-25
2025-03-27,6167.84,investment_income,in,Counterparty_32,23161696.09,,
2025-03-27,13898.22,customer_payment,in,Counterparty_42,23175594.31,,
2025-03-27,1807.1,marketing_spend,out,Counterparty_35,23173787.21,2025-03-03,2025-04-02
2025-03-27,1255.65,utilities,out,Counterparty_36,23172531.56,2025-03-01,2025-04-06
2025-03-27,2580.27,refund,in,Counterparty_8,23175111.83,,
2025-03-27,9404.35,customer_payment,in,Counterparty_93,23184516.18,,
2025-03-27,16458.16,investment_income,in,Counterparty_33,23200974.34,,
2025-03-27,5534.04,utilities,out,Counterparty_78,23195440.3,2025-02-11,2025-03-12
2025-03-27,4688.55,tax_payment,out,Counterparty_69,23190751.75,2025-02-18,2025-03-26
2025-03-27,4113.18,investment_income,in,Counterparty_23,23194864.93,,
2025-03-27,286.88,tax_payment,out,Counterparty_93,23194578.05,2025-02-27,2025-03-25
2025-03-27,310.89,tax_payment,out,Counterparty_8,23194267.16,2025-02-22,2025-03-25
2025-03-27,2602.09,T&E,out,Counterparty_1,23191665.07,2025-03-10,2025-04-16
2025-03-27,931.28,T&E,out,Counterparty_5,23190733.79,2025-02-27,2025-03-28
2025-03-27,1498.13,loan_repayment,out,Counterparty_62,23189235.66,2025-02-11,2025-03-12
2025-03-27,3020.06,payroll,out,Counterparty_75,23186215.6,2025-03-02,2025-04-01
2025-03-27,2246.94,rent,out,Counterparty_63,23183968.66,2025-02-23,2025-03-20
2025-03-27,3559.47,marketing_spend,out,Counterparty_90,23180409.19,2025-02-18,2025-03-27
2025-03-27,3053.67,rent,out,Counterparty_73,23177355.52,2025-02-27,2025-04-01
2025-03-27,2250.62,tax_payment,out,Counterparty_70,23175104.9,2025-02-24,2025-03-30
2025-03-27,3034.44,asset_sale,in,Counterparty_2,23178139.34,,
2025-03-27,3788.58,supplier_payment,out,Counterparty_56,23174350.76,2025-02-22,2025-03-30
2025-03-27,508.67,utilities,out,Counterparty_56,23173842.09,2025-02-18,2025-03-17
2025-03-27,5231.01,payroll,out,Counterparty_65,23168611.08,2025-02-20,2025-03-24
2025-03-27,5770.37,customer_payment,in,Counterparty_16,23174381.45,,
2025-03-27,2639.33,marketing_spend,out,Counterparty_49,23171742.12,2025-02-15,2025-03-25
2025-03-28,321.86,tax_payment,out,Counterparty_49,23171420.26,2025-03-05,2025-04-05
2025-03-28,2920.53,loan_repayment,out,Counterparty_19,23168499.73,2025-02-22,2025-03-27
2025-03-28,171.34,payroll,out,Counterparty_72,23168328.39,2025-02-18,2025-03-16
2025-03-28,3110.09,customer_payment,in,Counterparty_98,23171438.48,,
2025-03-28,6693.47,refund,in,Counterparty_38,23178131.95,,
2025-03-28,4299.46,tax_payment,out,Counterparty_24,23173832.49,2025-03-03,2025-03-29
2025-03-28,68.58,loan_repayment,out,Counterparty_78,23173763.91,2025-02-14,2025-03-12
2025-03-28,1060.16,payroll,out,Counterparty_9,23172703.75,2025-02-27,2025-03-29
2025-03-28,4160.38,asset_sale,in,Counterparty_27,23176864.13,,
2025-03-28,33156.56,credit,in,Counterparty_21,23210020.69,,
2025-03-28,2146.2,payroll,out,Counterparty_61,23207874.49,2025-02-27,2025-03-30
2025-03-28,4853.04,supplier_payment,out,Counterparty_6,23203021.45,2025-02-23,2025-03-20
2025-03-28,67.45,loan_repayment,out,Counterparty_60,23202954.0,2025-02-24,2025-03-25
2025-03-28,432.81,credit,in,Counterparty_4,23203386.81,,
2025-03-28,5840.3,tax_payment,out,Counterparty_31,23197546.51,2025-03-05,2025-04-06
2025-03-28,8286.25,asset_sale,in,Counterparty_5,23205832.76,,
2025-03-28,2236.89,tax_payment,out,Counterparty_88,23203595.87,2025-02-17,2025-03-24
2025-03-28,1331.29,tax_payment,out,Counterparty_97,23202264.58,2025-02-28,2025-03-25
2025-03-28,2131.18,utilities,out,Counterparty_61,23200133.4,2025-03-08,2025-04-14
2025-03-28,6178.39,loan_repayment,out,Counterparty_19,23193955.01,2025-02-16,2025-03-20
2025-03-28,7876.55,refund,in,Counterparty_98,23201831.56,,
2025-03-28,5987.72,supplier_payment,out,Counterparty_72,23195843.84,2025-03-03,2025-04-03
2025-03-28,11383.03,refund,in,Counterparty_49,23207226.87,,
2025-03-28,6608.78,loan_repayment,out,Counterparty_96,23200618.09,2025-03-12,2025-04-20
2025-03-28,2764.28,supplier_payment,out,Counterparty_45,23197853.81,2025-02-19,2025-03-24
2025-03-28,677.0,tax_payment,out,Counterparty_48,23197176.81,2025-02-13,2025-03-23
2025-03-28,13429.97,software_subscription,out,Counterparty_82,23183746.84,2025-03-10,2025-04-05
2025-03-28,4504.04,rent,out,Counterparty_57,23179242.8,2025-03-01,2025-04-02
2025-03-28,1704.63,tax_payment,out,Counterparty_19,23177538.17,2025-02-15,2025-03-15
2025-03-28,542.44,customer_payment,in,Counterparty_40,23178080.61,,
2025-03-28,2054.55,refund,in,Counterparty_60,23180135.16,,
2025-03-28,174.88,refund,in,Counterparty_81,23180310.04,,
2025-03-28,3497.98,payroll,out,Counterparty_91,23176812.06,2025-03-13,2025-04-20
2025-03-28,994.92,investment_income,in,Counterparty_97,23177806.98,,
2025-03-28,2371.86,customer_payment,in,Counterparty_92,23180178.84,,
2025-03-28,2008.55,T&E,out,Counterparty_5,23178170.29,2025-02-26,2025-03-23
2025-03-28,5278.17,software_subscription,out,Counterparty_70,23172892.12,2025-02-24,2025-04-01
2025-03-28,308.03,payroll,out,Counterparty_80,23172584.09,2025-03-09,2025-04-14
2025-03-28,2491.62,payroll,out,Counterparty_92,23170092.47,2025-02-14,2025-03-11
2025-03-28,3305.87,marketing_spend,out,Counterparty_86,23166786.6,2025-02-23,2025-03-22
2025-03-28,333.94,customer_payment,in,Counterparty_85,23167120.54,,
2025-03-28,8609.09,supplier_payment,out,Counterparty_83,23158511.45,2025-02-25,2025-03-27
2025-03-28,1313.87,marketing_spend,out,Counterparty_58,23157197.58,2025-02-19,2025-03-22
2025-03-28,4635.3,credit,in,Counterparty_49,23161832.88,,
2025-03-28,1665.51,investment_income,in,Counterparty_34,23163498.39,,
2025-03-28,59.03,customer_payment,in,Counterparty_87,23163557.42,,
2025-03-28,1122.52,supplier_payment,out,Counterparty_13,23162434.9,2025-02-27,2025-04-04
2025-03-28,641.32,rent,out,Counterparty_24,23161793.58,2025-03-08,2025-04-16
2025-03-28,6989.8,loan_repayment,out,Counterparty_15,23154803.78,2025-02-16,2025-03-25
2025-03-28,761.25,software_subscription,out,Counterparty_41,23154042.53,2025-02-24,2025-03-29
2025-03-28,4704.93,supplier_payment,out,Counterparty_4,23149337.6,2025-02-25,2025-03-29
2025-03-28,1185.45,software_subscription,out,Counterparty_48,23148152.15,2025-02-17,2025-03-14
2025-03-28,2853.45,loan_repayment,out,Counterparty_11,23145298.7,2025-03-06,2025-04-02
2025-03-28,16335.5,customer_payment,in,Counterparty_97,23161634.2,,
2025-03-28,403.31,T&E,out,Counterparty_91,23161230.89,2025-02-17,2025-03-26
2025-03-28,2581.36,supplier_payment,out,Counterparty_31,23158649.53,2025-03-12,2025-04-20
2025-03-28,11603.0,customer_payment,in,Counterparty_40,23170252.53,,
2025-03-28,2285.75,payroll,out,Counterparty_85,23167966.78,2025-03-09,2025-04-03
2025-03-28,313.08,utilities,out,Counterparty_11,23167653.7,2025-03-08,2025-04-05
2025-03-29,4430.58,loan_repayment,out,Counterparty_77,23163223.12,2025-02-19,2025-03-22
2025-03-29,21989.44,refund,in,Counterparty_33,23185212.56,,
2025-03-29,1588.29,marketing_spend,out,Counterparty_58,23183624.27,2025-02-24,2025-03-21
2025-03-29,3054.91,investment_income,in,Counterparty_73,23186679.18,,
2025-03-29,13667.26,customer_payment,in,Counterparty_18,23200346.44,,
2025-03-29,3241.4,credit,in,Counterparty_65,23203587.84,,
2025-03-29,3192.06,tax_payment,out,Counterparty_28,23200395.78,2025-02-13,2025-03-15
2025-03-29,1660.69,marketing_spend,out,Counterparty_72,23198735.09,2025-02-23,2025-03-30
2025-03-29,17445.86,customer_payment,in,Counterparty_81,23216180.95,,
2025-03-29,3258.83,credit,in,Counterparty_61,23219439.78,,
2025-03-29,1613.79,tax_payment,out,Counterparty_22,23217825.99,2025-03-12,2025-04-14
2025-03-29,17149.17,credit,in,Counterparty_33,23234975.16,,
2025-03-29,16270.78,refund,in,Counterparty_55,23251245.94,,
2025-03-29,1930.55,supplier_payment,out,Counterparty_80,23249315.39,2025-02-24,2025-03-31
2025-03-29,4323.96,asset_sale,in,Counterparty_2,23253639.35,,
2025-03-29,3689.12,refund,in,Counterparty_63,23257328.47,,
2025-03-29,5611.48,investment_income,in,Counterparty_27,23262939.95,,
2025-03-29,1415.26,marketing_spend,out,Counterparty_66,23261524.69,2025-02-28,2025-03-28
2025-03-29,15112.24,credit,in,Counterparty_90,23276636.93,,
2025-03-29,5977.24,asset_sale,in,Counterparty_37,23282614.17,,
2025-03-29,2450.54,asset_sale,in,Counterparty_88,23285064.71,,
2025-03-29,12829.17,refund,in,Counterparty_98,23297893.88,,
2025-03-29,1028.96,investment_income,in,Counterparty_22,23298922.84,,
2025-03-29,6230.03,investment_income,in,Counterparty_89,23305152.87,,
2025-03-29,1548.97,investment_income,in,Counterparty_55,23306701.84,,
2025-03-29,12660.44,investment_income,in,Counterparty_45,23319362.28,,
2025-03-29,1469.13,investment_income,in,Counterparty_8,23320831.41,,
2025-03-29,789.01,loan_repayment,out,Counterparty_27,23320042.4,2025-02-25,2025-03-29
2025-03-29,945.12,loan_repayment,out,Counterparty_50,23319097.28,2025-03-06,2025-04-13
2025-03-29,1731.73,software_subscription,out,Counterparty_39,23317365.55,2025-03-14,2025-04-21
2025-03-29,481.54,supplier_payment,out,Counterparty_62,23316884.01,2025-02-21,2025-03-31
2025-03-29,1417.11,T&E,out,Counterparty_28,23315466.9,2025-03-13,2025-04-20
2025-03-29,3222.67,software_subscription,out,Counterparty_30,23312244.23,2025-02-19,2025-03-23
2025-03-29,2029.26,utilities,out,Counterparty_95,23310214.97,2025-03-04,2025-04-10
2025-03-29,3029.2,rent,out,Counterparty_18,23307185.77,2025-02-21,2025-03-31
2025-03-29,3891.37,marketing_spend,out,Counterparty_28,23303294.4,2025-02-26,2025-04-05
2025-03-29,68.12,utilities,out,Counterparty_70,23303226.28,2025-02-21,2025-03-24
2025-03-29,2476.75,T&E,out,Counterparty_26,23300749.53,2025-03-03,2025-03-31
2025-03-29,5688.26,marketing_spend,out,Counterparty_29,23295061.27,2025-03-12,2025-04-06
2025-03-29,1221.84,supplier_payment,out,Counterparty_64,23293839.43,2025-02-27,2025-04-04
2025-03-29,1403.59,software_subscription,out,Counterparty_81,23292435.84,2025-02-16,2025-03-23
2025-03-29,4675.59,supplier_payment,out,Counterparty_16,23287760.25,2025-02-20,2025-03-18
2025-03-29,167.23,tax_payment,out,Counterparty_62,23287593.02,2025-02-27,2025-03-29
2025-03-29,9507.21,tax_payment,out,Counterparty_5,23278085.81,2025-03-13,2025-04-12
2025-03-29,773.88,supplier_payment,out,Counterparty_44,23277311.93,2025-02-18,2025-03-19
2025-03-29,1151.93,utilities,out,Counterparty_2,23276160.0,2025-02-14,2025-03-20
2025-03-29,7145.99,loan_repayment,out,Counterparty_58,23269014.01,2025-03-09,2025-04-12
2025-03-29,1485.12,supplier_payment,out,Counterparty_24,23267528.89,2025-02-18,2025-03-21
2025-03-29,4256.63,rent,out,Counterparty_31,23263272.26,2025-02-19,2025-03-25
2025-03-29,2680.04,marketing_spend,out,Counterparty_91,23260592.22,2025-02-28,2025-04-01
2025-03-30,1553.76,customer_payment,in,Counterparty_67,23262145.98,,
2025-03-30,602.73,utilities,out,Counterparty_75,23261543.25,2025-03-07,2025-04-10
2025-03-30,6113.24,payroll,out,Counterparty_38,23255430.01,2025-02-18,2025-03-15
2025-03-30,1204.73,supplier_payment,out,Counterparty_19,23254225.28,2025-03-02,2025-04-10
2025-03-30,3896.05,utilities,out,Counterparty_76,23250329.23,2025-03-01,2025-03-29
2025-03-30,42139.52,investment_income,in,Counterparty_97,23292468.75,,
2025-03-30,3663.2,supplier_payment,out,Counterparty_87,23288805.55,2025-02-26,2025-04-06
2025-03-30,1286.66,credit,in,Counterparty_60,23290092.21,,
2025-03-30,5832.34,rent,out,Counterparty_12,23284259.87,2025-03-07,2025-04-02
2025-03-30,710.69,rent,out,Counterparty_62,23283549.18,2025-03-04,2025-03-30
2025-03-30,9389.92,payroll,out,Counterparty_78,23274159.26,2025-03-07,2025-04-04
2025-03-30,13784.2,customer_payment,in,Counterparty_87,23287943.46,,
2025-03-30,16647.6,refund,in,Counterparty_98,23304591.06,,
2025-03-30,1974.07,rent,out,Counterparty_56,23302616.99,2025-03-14,2025-04-10
2025-03-30,19062.1,refund,in,Counterparty_76,23321679.09,,
2025-03-30,3170.03,supplier_payment,out,Counterparty_70,23318509.06,2025-02-14,2025-03-11
2025-03-30,12339.13,investment_income,in,Counterparty_13,23330848.19,,
2025-03-30,1621.31,rent,out,Counterparty_66,23329226.88,2025-02-22,2025-03-24
2025-03-30,1281.4,payroll,out,Counterparty_18,23327945.48,2025-02-27,2025-03-27
2025-03-30,25568.82,customer_payment,in,Counterparty_49,23353514.3,,
2025-03-30,70.29,rent,out,Counterparty_90,23353444.01,2025-03-14,2025-04-09
2025-03-30,12853.27,customer_payment,in,Counterparty_55,23366297.28,,
2025-03-30,2012.17,asset_sale,in,Counterparty_41,23368309.45,,
2025-03-30,9200.32,credit,in,Counterparty_39,23377509.77,,
2025-03-30,212.7,marketing_spend,out,Counterparty_44,23377297.07,2025-03-14,2025-04-17
2025-03-30,929.94,supplier_payment,out,Counterparty_92,23376367.13,2025-02-16,2025-03-14
2025-03-30,1386.47,customer_payment,in,Counterparty_76,23377753.6,,
2025-03-30,2942.4,utilities,out,Counterparty_28,23374811.2,2025-02-28,2025-03-27
2025-03-30,12184.67,loan_repayment,out,Counterparty_97,23362626.53,2025-02-22,2025-03-25
2025-03-30,788.99,utilities,out,Counterparty_18,23361837.54,2025-02-22,2025-04-02
2025-03-30,6227.53,rent,out,Counterparty_10,23355610.01,2025-03-11,2025-04-18
2025-03-30,787.28,rent,out,Counterparty_25,23354822.73,2025-03-03,2025-03-28
2025-03-30,589.94,asset_sale,in,Counterparty_5,23355412.67,,
2025-03-30,227.76,software_subscription,out,Counterparty_99,23355184.91,2025-03-01,2025-04-05
2025-03-30,4734.34,tax_payment,out,Counterparty_86,23350450.57,2025-03-07,2025-04-06
2025-03-30,6330.78,tax_payment,out,Counterparty_88,23344119.79,2025-02-18,2025-03-26
2025-03-30,3956.64,loan_repayment,out,Counterparty_24,23340163.15,2025-03-03,2025-03-28
2025-03-30,3150.58,utilities,out,Counterparty_83,23337012.57,2025-03-06,2025-04-07
2025-03-30,7111.37,software_subscription,out,Counterparty_40,23329901.2,2025-03-04,2025-04-10
2025-03-30,748.84,payroll,out,Counterparty_58,23329152.36,2025-03-11,2025-04-18
2025-03-30,9177.93,tax_payment,out,Counterparty_67,23319974.43,2025-02-26,2025-04-06
2025-03-30,4818.04,software_subscription,out,Counterparty_80,23315156.39,2025-02-26,2025-03-31
2025-03-30,653.49,rent,out,Counterparty_57,23314502.9,2025-03-01,2025-03-29
2025-03-30,6994.1,T&E,out,Counterparty_6,23307508.8,2025-02-23,2025-03-26
2025-03-30,26665.46,asset_sale,in,Counterparty_82,23334174.26,,
2025-03-30,990.4,supplier_payment,out,Counterparty_13,23333183.86,2025-03-10,2025-04-08
2025-03-30,2084.04,supplier_payment,out,Counterparty_85,23331099.82,2025-02-24,2025-03-25
2025-03-30,8501.93,credit,in,Counterparty_49,23339601.75,,
2025-03-30,2326.36,utilities,out,Counterparty_20,23337275.39,2025-03-07,2025-04-07
2025-03-30,1270.36,marketing_spend,out,Counterparty_83,23336005.03,2025-02-15,2025-03-25
2025-03-30,1814.96,supplier_payment,out,Counterparty_33,23334190.07,2025-03-15,2025-04-17
2025-03-30,961.71,payroll,out,Counterparty_6,23333228.36,2025-02-22,2025-03-21
2025-03-30,320.23,marketing_spend,out,Counterparty_99,23332908.13,2025-03-03,2025-04-11
2025-03-30,799.57,rent,out,Counterparty_2,23332108.56,2025-02-19,2025-03-26
2025-03-30,5169.56,T&E,out,Counterparty_97,23326939.0,2025-02-21,2025-04-01
2025-03-30,575.64,tax_payment,out,Counterparty_95,23326363.36,2025-03-13,2025-04-10
2025-03-31,2124.32,tax_payment,out,Counterparty_22,23324239.04,2025-02-26,2025-03-28
2025-03-31,1949.52,loan_repayment,out,Counterparty_67,23322289.52,2025-03-06,2025-04-01
2025-03-31,2764.72,utilities,out,Counterparty_53,23319524.8,2025-03-12,2025-04-16
2025-03-31,11298.04,payroll,out,Counterparty_7,23308226.76,2025-03-06,2025-04-13
2025-03-31,1721.83,supplier_payment,out,Counterparty_44,23306504.93,2025-02-17,2025-03-14
2025-03-31,3631.24,payroll,out,Counterparty_46,23302873.69,2025-03-07,2025-04-04
2025-03-31,2061.14,marketing_spend,out,Counterparty_85,23300812.55,2025-02-18,2025-03-26
2025-03-31,21269.7,credit,in,Counterparty_95,23322082.25,,
2025-03-31,8117.62,loan_repayment,out,Counterparty_66,23313964.63,2025-03-05,2025-04-07
2025-03-31,11545.6,utilities,out,Counterparty_6,23302419.03,2025-03-02,2025-04-02
2025-03-31,10526.14,asset_sale,in,Counterparty_41,23312945.17,,
2025-03-31,1776.79,loan_repayment,out,Counterparty_54,23311168.38,2025-03-03,2025-04-08
2025-03-31,1302.73,supplier_payment,out,Counterparty_60,23309865.65,2025-03-15,2025-04-13
2025-03-31,1152.7,supplier_payment,out,Counterparty_76,23308712.95,2025-03-11,2025-04-09
2025-03-31,124.17,rent,out,Counterparty_3,23308588.78,2025-03-10,2025-04-13
2025-03-31,164.42,supplier_payment,out,Counterparty_24,23308424.36,2025-03-03,2025-04-02
2025-03-31,10491.91,loan_repayment,out,Counterparty_27,23297932.45,2025-03-11,2025-04-16
2025-03-31,10875.98,refund,in,Counterparty_52,23308808.43,,
2025-03-31,1482.38,supplier_payment,out,Counterparty_76,23307326.05,2025-03-03,2025-04-08
2025-03-31,5848.72,asset_sale,in,Counterparty_1,23313174.77,,
2025-03-31,7913.79,utilities,out,Counterparty_58,23305260.98,2025-02-27,2025-03-29
2025-03-31,502.6,rent,out,Counterparty_48,23304758.38,2025-02-18,2025-03-19
2025-03-31,1468.77,asset_sale,in,Counterparty_25,23306227.15,,
2025-03-31,2028.81,utilities,out,Counterparty_69,23304198.34,2025-03-09,2025-04-05
2025-03-31,1636.58,utilities,out,Counterparty_68,23302561.76,2025-03-11,2025-04-06
2025-03-31,235.38,rent,out,Counterparty_98,23302326.38,2025-02-17,2025-03-17
2025-03-31,2182.03,supplier_payment,out,Counterparty_60,23300144.35,2025-02-25,2025-03-27
2025-03-31,6092.12,loan_repayment,out,Counterparty_7,23294052.23,2025-03-05,2025-04-10
2025-03-31,14.79,asset_sale,in,Counterparty_30,23294067.02,,
2025-03-31,840.01,payroll,out,Counterparty_69,23293227.01,2025-03-02,2025-04-01
2025-03-31,7782.1,supplier_payment,out,Counterparty_11,23285444.91,2025-02-21,2025-03-26
2025-03-31,2999.08,payroll,out,Counterparty_67,23282445.83,2025-02-18,2025-03-17
2025-03-31,534.5,asset_sale,in,Counterparty_97,23282980.33,,
2025-03-31,2012.63,investment_income,in,Counterparty_17,23284992.96,,
2025-03-31,601.57,supplier_payment,out,Counterparty_45,23284391.39,2025-02-24,2025-03-27
2025-03-31,462.52,tax_payment,out,Counterparty_69,23283928.87,2025-02-17,2025-03-26
2025-03-31,8425.89,credit,in,Counterparty_83,23292354.76,,
2025-03-31,13823.89,investment_income,in,Counterparty_36,23306178.65,,
2025-03-31,4555.49,supplier_payment,out,Counterparty_79,23301623.16,2025-02-16,2025-03-22
2025-03-31,4600.94,customer_payment,in,Counterparty_9,23306224.1,,
2025-03-31,15851.7,refund,in,Counterparty_75,23322075.8,,
2025-03-31,4864.35,investment_income,in,Counterparty_49,23326940.15,,
2025-03-31,7332.89,refund,in,Counterparty_99,23334273.04,,
2025-03-31,3986.54,T&E,out,Counterparty_38,23330286.5,2025-02-19,2025-03-20
2025-03-31,5648.34,investment_income,in,Counterparty_27,23335934.84,,
2025-03-31,298.36,loan_repayment,out,Counterparty_7,23335636.48,2025-02-27,2025-03-27
2025-03-31,16326.58,credit,in,Counterparty_93,23351963.06,,
2025-03-31,2807.68,utilities,out,Counterparty_2,23349155.38,2025-03-16,2025-04-24
2025-03-31,3149.33,rent,out,Counterparty_12,23346006.05,2025-02-23,2025-03-26
2025-03-31,13117.29,credit,in,Counterparty_53,23359123.34,,
2025-03-31,2058.4,refund,in,Counterparty_12,23361181.74,,
2025-03-31,18036.04,investment_income,in,Counterparty_50,23379217.78,,
2025-03-31,1428.17,software_subscription,out,Counterparty_53,23377789.61,2025-02-21,2025-03-23
2025-03-31,6014.3,software_subscription,out,Counterparty_57,23371775.31,2025-03-11,2025-04-10
2025-03-31,2869.77,rent,out,Counterparty_51,23368905.54,2025-03-12,2025-04-06
2025-04-01,3323.53,marketing_spend,out,Counterparty_18,23365582.01,2025-03-03,2025-03-30
2025-04-01,270.59,tax_payment,out,Counterparty_94,23365311.42,2025-03-01,2025-03-31
2025-04-01,2454.52,payroll,out,Counterparty_85,23362856.9,2025-02-21,2025-04-01
2025-04-01,1730.95,asset_sale,in,Counterparty_64,23364587.85,,
2025-04-01,8687.28,refund,in,Counterparty_82,23373275.13,,
2025-04-01,3681.92,credit,in,Counterparty_54,23376957.05,,
2025-04-01,11988.24,loan_repayment,out,Counterparty_25,23364968.81,2025-02-21,2025-03-25
2025-04-01,4644.84,asset_sale,in,Counterparty_18,23369613.65,,
2025-04-01,1818.56,utilities,out,Counterparty_37,23367795.09,2025-03-08,2025-04-16
2025-04-01,194.5,refund,in,Counterparty_38,23367989.59,,
2025-04-01,2574.91,asset_sale,in,Counterparty_24,23370564.5,,
2025-04-01,322.37,software_subscription,out,Counterparty_60,23370242.13,2025-02-21,2025-03-22
2025-04-01,4524.53,payroll,out,Counterparty_78,23365717.6,2025-02-20,2025-03-31
2025-04-01,388.02,payroll,out,Counterparty_7,23365329.58,2025-02-26,2025-03-28
2025-04-01,366.77,credit,in,Counterparty_80,23365696.35,,
2025-04-01,4626.2,customer_payment,in,Counterparty_88,23370322.55,,
2025-04-01,6870.01,payroll,out,Counterparty_24,23363452.54,2025-02-18,2025-03-25
2025-04-01,2967.59,software_subscription,out,Counterparty_12,23360484.95,2025-02-19,2025-03-19
2025-04-01,8759.59,payroll,out,Counterparty_19,23351725.36,2025-03-11,2025-04-06
2025-04-01,2767.5,marketing_spend,out,Counterparty_93,23348957.86,2025-03-07,2025-04-10
2025-04-01,5410.77,software_subscription,out,Counterparty_98,23343547.09,2025-03-05,2025-04-09
2025-04-01,6503.44,credit,in,Counterparty_64,23350050.53,,
2025-04-01,18831.73,investment_income,in,Counterparty_28,23368882.26,,
2025-04-01,2035.98,asset_sale,in,Counterparty_30,23370918.24,,
2025-04-01,1372.63,marketing_spend,out,Counterparty_19,23369545.61,2025-02-16,2025-03-22
2025-04-01,13492.81,refund,in,Counterparty_68,23383038.42,,
2025-04-01,13158.41,asset_sale,in,Counterparty_10,23396196.83,,
2025-04-01,15954.8,marketing_spend,out,Counterparty_80,23380242.03,2025-02-26,2025-03-30
2025-04-01,287.22,customer_payment,in,Counterparty_16,23380529.25,,
2025-04-01,2268.75,credit,in,Counterparty_6,23382798.0,,
2025-04-01,3777.96,marketing_spend,out,Counterparty_62,23379020.04,2025-03-04,2025-04-01
2025-04-01,232.43,utilities,out,Counterparty_4,23378787.61,2025-03-10,2025-04-11
2025-04-01,10549.55,T&E,out,Counterparty_84,23368238.06,2025-03-09,2025-04-10
2025-04-01,1545.63,utilities,out,Counterparty_28,23366692.43,2025-03-08,2025-04-04
2025-04-01,1946.47,credit,in,Counterparty_77,23368638.9,,
2025-04-01,6872.85,rent,out,Counterparty_43,23361766.05,2025-03-07,2025-04-03
2025-04-01,1315.76,customer_payment,in,Counterparty_80,23363081.81,,
2025-04-01,2513.19,refund,in,Counterparty_53,23365595.0,,
2025-04-01,514.63,T&E,out,Counterparty_60,23365080.37,2025-02-21,2025-03-28
2025-04-01,3685.5,refund,in,Counterparty_10,23368765.87,,
2025-04-01,4850.88,credit,in,Counterparty_33,23373616.75,,
2025-04-01,10599.05,T&E,out,Counterparty_30,23363017.7,2025-03-16,2025-04-16
2025-04-01,1467.73,payroll,out,Counterparty_34,23361549.97,2025-02-22,2025-03-23
2025-04-01,992.24,refund,in,Counterparty_62,23362542.21,,
2025-04-01,15159.44,refund,in,Counterparty_19,23377701.65,,
2025-04-01,4604.51,investment_income,in,Counterparty_33,23382306.16,,
2025-04-01,9636.45,asset_sale,in,Counterparty_82,23391942.61,,
2025-04-01,15183.25,credit,in,Counterparty_33,23407125.86,,
2025-04-01,3448.11,customer_payment,in,Counterparty_36,23410573.97,,
2025-04-01,492.58,payroll,out,Counterparty_46,23410081.39,2025-03-15,2025-04-17
2025-04-01,1589.6,software_subscription,out,Counterparty_16,23408491.79,2025-03-02,2025-03-27
2025-04-01,2427.86,customer_payment,in,Counterparty_40,23410919.65,,
2025-04-01,6111.03,customer_payment,in,Counterparty_51,23417030.68,,
2025-04-01,238.92,asset_sale,in,Counterparty_35,23417269.6,,
2025-04-01,6118.36,payroll,out,Counterparty_77,23411151.24,2025-02-25,2025-04-05
2025-04-01,6799.22,supplier_payment,out,Counterparty_2,23404352.02,2025-03-08,2025-04-08
2025-04-01,602.23,refund,in,Counterparty_29,23404954.25,,
2025-04-01,1112.02,rent,out,Counterparty_77,23403842.23,2025-02-22,2025-03-19
2025-04-01,105.01,T&E,out,Counterparty_13,23403737.22,2025-03-10,2025-04-09
2025-04-01,6616.77,customer_payment,in,Counterparty_70,23410353.99,,
2025-04-01,2945.41,rent,out,Counterparty_31,23407408.58,2025-03-06,2025-04-01
2025-04-01,2753.11,investment_income,in,Counterparty_70,23410161.69,,
2025-04-01,522.47,rent,out,Counterparty_69,23409639.22,2025-02-17,2025-03-27
2025-04-01,285.25,supplier_payment,out,Counterparty_81,23409353.97,2025-03-09,2025-04-08
2025-04-01,2052.63,tax_payment,out,Counterparty_22,23407301.34,2025-03-17,2025-04-15
2025-04-01,2826.12,utilities,out,Counterparty_58,23404475.22,2025-03-10,2025-04-15
2025-04-01,193.66,utilities,out,Counterparty_77,23404281.56,2025-02-22,2025-04-02
2025-04-02,654.18,utilities,out,Counterparty_41,23403627.38,2025-02-21,2025-04-01
2025-04-02,2441.12,loan_repayment,out,Counterparty_81,23401186.26,2025-02-27,2025-03-29
2025-04-02,5818.01,tax_payment,out,Counterparty_23,23395368.25,2025-02-26,2025-03-31
2025-04-02,298.79,software_subscription,out,Counterparty_2,23395069.46,2025-03-05,2025-04-10
2025-04-02,4641.17,rent,out,Counterparty_85,23390428.29,2025-03-05,2025-04-12
2025-04-02,5985.06,refund,in,Counterparty_51,23396413.35,,
2025-04-02,4393.2,investment_income,in,Counterparty_85,23400806.55,,
2025-04-02,2431.77,utilities,out,Counterparty_70,23398374.78,2025-03-10,2025-04-16
2025-04-02,31582.4,customer_payment,in,Counterparty_69,23429957.18,,
2025-04-02,1042.41,payroll,out,Counterparty_16,23428914.77,2025-03-04,2025-04-04
2025-04-02,7867.81,customer_payment,in,Counterparty_40,23436782.58,,
2025-04-02,1907.83,T&E,out,Counterparty_10,23434874.75,2025-02-21,2025-03-31
2025-04-02,4870.61,asset_sale,in,Counterparty_11,23439745.36,,
2025-04-02,13110.84,credit,in,Counterparty_80,23452856.2,,
2025-04-02,3120.41,tax_payment,out,Counterparty_87,23449735.79,2025-02-20,2025-03-26
2025-04-02,10262.93,customer_payment,in,Counterparty_17,23459998.72,,
2025-04-02,1698.64,marketing_spend,out,Counterparty_52,23458300.08,2025-02-21,2025-04-01
2025-04-02,2445.01,rent,out,Counterparty_96,23455855.07,2025-03-15,2025-04-21
2025-04-02,18364.13,customer_payment,in,Counterparty_55,23474219.2,,
2025-04-02,9850.75,asset_sale,in,Counterparty_63,23484069.95,,
2025-04-02,2274.14,tax_payment,out,Counterparty_49,23481795.81,2025-03-13,2025-04-14
2025-04-02,5316.79,asset_sale,in,Counterparty_22,23487112.6,,
2025-04-02,1582.97,software_subscription,out,Counterparty_67,23485529.63,2025-03-18,2025-04-25
2025-04-02,7715.74,investment_income,in,Counterparty_9,23493245.37,,
2025-04-02,3973.11,software_subscription,out,Counterparty_72,23489272.26,2025-03-12,2025-04-09
2025-04-02,960.42,payroll,out,Counterparty_34,23488311.84,2025-02-17,2025-03-21
2025-04-02,2165.56,loan_repayment,out,Counterparty_26,23486146.28,2025-03-10,2025-04-16
2025-04-02,1149.34,asset_sale,in,Counterparty_62,23487295.62,,
2025-04-02,813.77,asset_sale,in,Counterparty_80,23488109.39,,
2025-04-02,3721.38,customer_payment,in,Counterparty_70,23491830.77,,
2025-04-02,7006.3,T&E,out,Counterparty_59,23484824.47,2025-02-23,2025-03-22
2025-04-02,6026.34,customer_payment,in,Counterparty_7,23490850.81,,
2025-04-02,1678.88,payroll,out,Counterparty_97,23489171.93,2025-03-04,2025-04-01
2025-04-02,186.68,payroll,out,Counterparty_77,23488985.25,2025-03-18,2025-04-26
2025-04-02,184.07,asset_sale,in,Counterparty_28,23489169.32,,
2025-04-02,2061.48,utilities,out,Counterparty_65,23487107.84,2025-03-18,2025-04-21
2025-04-02,17308.48,credit,in,Counterparty_76,23504416.32,,
2025-04-02,5062.44,investment_income,in,Counterparty_1,23509478.76,,
2025-04-02,3981.62,customer_payment,in,Counterparty_44,23513460.38,,
2025-04-02,6682.76,asset_sale,in,Counterparty_86,23520143.14,,
2025-04-02,7723.85,software_subscription,out,Counterparty_55,23512419.29,2025-03-10,2025-04-07
2025-04-02,7000.83,investment_income,in,Counterparty_74,23519420.12,,
2025-04-02,1363.6,customer_payment,in,Counterparty_64,23520783.72,,
2025-04-02,723.43,T&E,out,Counterparty_94,23520060.29,2025-02-21,2025-03-31
2025-04-02,4105.36,credit,in,Counterparty_85,23524165.65,,
2025-04-02,2441.18,asset_sale,in,Counterparty_4,23526606.83,,
2025-04-02,1230.12,loan_repayment,out,Counterparty_30,23525376.71,2025-02-20,2025-03-17
2025-04-02,3004.37,customer_payment,in,Counterparty_25,23528381.08,,
2025-04-02,955.95,software_subscription,out,Counterparty_46,23527425.13,2025-02-20,2025-03-22
2025-04-02,6146.69,payroll,out,Counterparty_76,23521278.44,2025-03-10,2025-04-11
2025-04-02,356.31,tax_payment,out,Counterparty_70,23520922.13,2025-03-04,2025-04-06
2025-04-02,5834.31,supplier_payment,out,Counterparty_15,23515087.82,2025-02-28,2025-03-31
2025-04-02,19353.69,refund,in,Counterparty_34,23534441.51,,
2025-04-02,16749.25,asset_sale,in,Counterparty_31,23551190.76,,
2025-04-02,2601.5,T&E,out,Counterparty_15,23548589.26,2025-03-03,2025-04-04
2025-04-02,2894.78,credit,in,Counterparty_65,23551484.04,,
2025-04-02,3018.05,customer_payment,in,Counterparty_34,23554502.09,,
2025-04-03,1255.75,rent,out,Counterparty_52,23553246.34,2025-03-06,2025-04-12
2025-04-03,12297.4,customer_payment,in,Counterparty_53,23565543.74,,
2025-04-03,5765.84,asset_sale,in,Counterparty_16,23571309.58,,
2025-04-03,282.5,supplier_payment,out,Counterparty_48,23571027.08,2025-03-02,2025-04-02
2025-04-03,3899.98,credit,in,Counterparty_22,23574927.06,,
2025-04-03,10849.85,investment_income,in,Counterparty_79,23585776.91,,
2025-04-03,9644.87,investment_income,in,Counterparty_17,23595421.78,,
2025-04-03,1933.72,supplier_payment,out,Counterparty_41,23593488.06,2025-02-22,2025-03-21
2025-04-03,2388.97,refund,in,Counterparty_62,23595877.03,,
2025-04-03,7757.49,investment_income,in,Counterparty_58,23603634.52,,
2025-04-03,5111.8,utilities,out,Counterparty_60,23598522.72,2025-02-26,2025-04-03
2025-04-03,5704.97,investment_income,in,Counterparty_58,23604227.69,,
2025-04-03,6374.39,refund,in,Counterparty_96,23610602.08,,
2025-04-03,3044.25,customer_payment,in,Counterparty_88,23613646.33,,
2025-04-03,6082.27,credit,in,Counterparty_79,23619728.6,,
2025-04-03,137.1,supplier_payment,out,Counterparty_99,23619591.5,2025-03-09,2025-04-05
2025-04-03,136.8,utilities,out,Counterparty_72,23619454.7,2025-03-06,2025-04-05
2025-04-03,1820.36,loan_repayment,out,Counterparty_25,23617634.34,2025-02-26,2025-03-31
2025-04-03,92.3,supplier_payment,out,Counterparty_86,23617542.04,2025-02-27,2025-03-26
2025-04-03,38032.65,customer_payment,in,Counterparty_20,23655574.69,,
2025-04-03,22277.36,investment_income,in,Counterparty_64,23677852.05,,
2025-04-03,2104.28,refund,in,Counterparty_44,23679956.33,,
2025-04-03,19155.85,credit,in,Counterparty_37,23699112.18,,
2025-04-03,11215.8,refund,in,Counterparty_96,23710327.98,,
2025-04-03,2737.09,supplier_payment,out,Counterparty_19,23707590.89,2025-02-20,2025-03-22
2025-04-03,140.44,supplier_payment,out,Counterparty_99,23707450.45,2025-02-20,2025-03-22
2025-04-03,4805.23,refund,in,Counterparty_78,23712255.68,,
2025-04-03,10079.15,payroll,out,Counterparty_34,23702176.53,2025-02-19,2025-03-22
2025-04-03,3866.04,marketing_spend,out,Counterparty_94,23698310.49,2025-03-11,2025-04-18
2025-04-03,7249.36,T&E,out,Counterparty_47,23691061.13,2025-03-17,2025-04-14
2025-04-03,10648.73,customer_payment,in,Counterparty_96,23701709.86,,
2025-04-03,5005.3,customer_payment,in,Counterparty_44,23706715.16,,
2025-04-03,9335.55,asset_sale,in,Counterparty_4,23716050.71,,
2025-04-03,8379.99,refund,in,Counterparty_14,23724430.7,,
2025-04-03,4915.01,T&E,out,Counterparty_58,23719515.69,2025-02-24,2025-03-29
2025-04-03,3892.95,software_subscription,out,Counterparty_48,23715622.74,2025-02-18,2025-03-19
2025-04-03,4593.7,supplier_payment,out,Counterparty_6,23711029.04,2025-02-28,2025-03-31
2025-04-03,2808.94,investment_income,in,Counterparty_55,23713837.98,,
2025-04-03,1600.02,software_subscription,out,Counterparty_99,23712237.96,2025-02-21,2025-03-20
2025-04-03,8665.67,customer_payment,in,Counterparty_57,23720903.63,,
2025-04-03,10787.19,marketing_spend,out,Counterparty_96,23710116.44,2025-03-17,2025-04-12
2025-04-03,15331.6,asset_sale,in,Counterparty_95,23725448.04,,
2025-04-03,1746.55,investment_income,in,Counterparty_80,23727194.59,,
2025-04-03,388.71,supplier_payment,out,Counterparty_66,23726805.88,2025-03-01,2025-04-02
2025-04-03,6288.23,rent,out,Counterparty_73,23720517.65,2025-03-03,2025-04-07
2025-04-03,5476.43,customer_payment,in,Counterparty_43,23725994.08,,
2025-04-03,5679.19,T&E,out,Counterparty_94,23720314.89,2025-03-11,2025-04-11
2025-04-03,1250.03,asset_sale,in,Counterparty_59,23721564.92,,
2025-04-03,9230.09,utilities,out,Counterparty_9,23712334.83,2025-03-03,2025-03-31
2025-04-03,1881.64,payroll,out,Counterparty_27,23710453.19,2025-02-23,2025-03-25
2025-04-03,4456.91,asset_sale,in,Counterparty_8,23714910.1,,
2025-04-03,4525.6,payroll,out,Counterparty_16,23710384.5,2025-03-15,2025-04-20
2025-04-03,933.05,refund,in,Counterparty_12,23711317.55,,
2025-04-03,8479.92,software_subscription,out,Counterparty_26,23702837.63,2025-03-12,2025-04-06
2025-04-03,1.37,payroll,out,Counterparty_3,23702836.26,2025-03-04,2025-04-07
2025-04-03,3778.75,payroll,out,Counterparty_6,23699057.51,2025-03-19,2025-04-14
2025-04-03,6090.62,T&E,out,Counterparty_99,23692966.89,2025-03-01,2025-03-27
2025-04-03,2286.9,supplier_payment,out,Counterparty_6,23690679.99,2025-03-13,2025-04-13
2025-04-03,3746.18,credit,in,Counterparty_99,23694426.17,,
2025-04-04,699.33,refund,in,Counterparty_56,23695125.5,,
2025-04-04,3959.48,payroll,out,Counterparty_33,23691166.02,2025-02-25,2025-03-26
2025-04-04,10438.01,customer_payment,in,Counterparty_17,23701604.03,,
2025-04-04,336.83,marketing_spend,out,Counterparty_13,23701267.2,2025-03-20,2025-04-26
2025-04-04,22185.27,refund,in,Counterparty_77,23723452.47,,
2025-04-04,2092.92,loan_repayment,out,Counterparty_62,23721359.55,2025-03-10,2025-04-15
2025-04-04,7849.36,investment_income,in,Counterparty_78,23729208.91,,
2025-04-04,976.35,payroll,out,Counterparty_95,23728232.56,2025-03-09,2025-04-04
2025-04-04,519.71,refund,in,Counterparty_92,23728752.27,,
2025-04-04,12728.14,investment_income,in,Counterparty_31,23741480.41,,
2025-04-04,5777.75,T&E,out,Counterparty_15,23735702.66,2025-02-25,2025-03-28
2025-04-04,26922.58,asset_sale,in,Counterparty_58,23762625.24,,
2025-04-04,38439.91,asset_sale,in,Counterparty_3,23801065.15,,
2025-04-04,3391.24,investment_income,in,Counterparty_40,23804456.39,,
2025-04-04,1169.73,customer_payment,in,Counterparty_84,23805626.12,,
2025-04-04,1706.15,utilities,out,Counterparty_16,23803919.97,2025-03-02,2025-03-30
2025-04-04,11868.63,asset_sale,in,Counterparty_91,23815788.6,,
2025-04-04,1547.92,investment_income,in,Counterparty_89,23817336.52,,
2025-04-04,5064.38,credit,in,Counterparty_95,23822400.9,,
2025-04-04,2708.62,T&E,out,Counterparty_18,23819692.28,2025-03-12,2025-04-15
2025-04-04,8945.22,customer_payment,in,Counterparty_96,23828637.5,,
2025-04-04,1546.48,investment_income,in,Counterparty_69,23830183.98,,
2025-04-04,1055.52,rent,out,Counterparty_84,23829128.46,2025-02-19,2025-03-19
2025-04-04,847.14,asset_sale,in,Counterparty_44,23829975.6,,
2025-04-04,2099.82,payroll,out,Counterparty_35,23827875.78,2025-03-12,2025-04-20
2025-04-04,3976.85,tax_payment,out,Counterparty_42,23823898.93,2025-03-10,2025-04-09
2025-04-04,1153.17,tax_payment,out,Counterparty_68,23822745.76,2025-02-23,2025-04-03
2025-04-04,7263.28,customer_payment,in,Counterparty_85,23830009.04,,
2025-04-04,2249.74,loan_repayment,out,Counterparty_57,23827759.3,2025-02-22,2025-03-26
2025-04-04,6853.48,refund,in,Counterparty_32,23834612.78,,
2025-04-04,3529.02,loan_repayment,out,Counterparty_1,23831083.76,2025-03-09,2025-04-06
2025-04-04,3802.55,software_subscription,out,Counterparty_63,23827281.21,2025-03-08,2025-04-10
2025-04-04,5064.07,investment_income,in,Counterparty_70,23832345.28,,
2025-04-04,3013.68,T&E,out,Counterparty_68,23829331.6,2025-03-12,2025-04-08
2025-04-04,9271.69,customer_payment,in,Counterparty_41,23838603.29,,
2025-04-04,1930.66,supplier_payment,out,Counterparty_46,23836672.63,2025-02-27,2025-03-27
2025-04-04,7254.78,customer_payment,in,Counterparty_52,23843927.41,,
2025-04-04,9978.89,utilities,out,Counterparty_86,23833948.52,2025-03-05,2025-04-02
2025-04-04,1994.47,software_subscription,out,Counterparty_36,23831954.05,2025-02-24,2025-03-27
2025-04-04,14903.95,asset_sale,in,Counterparty_81,23846858.0,,
2025-04-04,6941.59,T&E,out,Counterparty_58,23839916.41,2025-03-05,2025-04-10
2025-04-04,1366.44,marketing_spend,out,Counterparty_41,23838549.97,2025-02-22,2025-03-24
2025-04-04,181.06,loan_repayment,out,Counterparty_29,23838368.91,2025-03-10,2025-04-04
2025-04-04,181.88,asset_sale,in,Counterparty_22,23838550.79,,
2025-04-04,7137.96,supplier_payment,out,Counterparty_73,23831412.83,2025-03-05,2025-04-02
2025-04-04,15014.77,utilities,out,Counterparty_20,23816398.06,2025-03-17,2025-04-20
2025-04-04,7284.27,marketing_spend,out,Counterparty_89,23809113.79,2025-02-25,2025-03-24
2025-04-04,1079.38,supplier_payment,out,Counterparty_47,23808034.41,2025-03-03,2025-03-28
2025-04-04,335.27,refund,in,Counterparty_57,23808369.68,,
2025-04-04,16.38,rent,out,Counterparty_31,23808353.3,2025-02-25,2025-03-27
2025-04-04,333.32,refund,in,Counterparty_77,23808686.62,,
2025-04-04,11418.13,refund,in,Counterparty_35,23820104.75,,
2025-04-04,4188.99,software_subscription,out,Counterparty_36,23815915.76,2025-03-06,2025-04-02
2025-04-04,1176.9,supplier_payment,out,Counterparty_45,23814738.86,2025-03-03,2025-04-01
2025-04-04,169.31,rent,out,Counterparty_90,23814569.55,2025-03-14,2025-04-13
2025-04-04,100.04,refund,in,Counterparty_62,23814669.59,,
2025-04-04,1830.79,supplier_payment,out,Counterparty_86,23812838.8,2025-02-21,2025-03-28
2025-04-04,3369.37,payroll,out,Counterparty_77,23809469.43,2025-02-26,2025-03-25
2025-04-04,9582.16,investment_income,in,Counterparty_14,23819051.59,,
2025-04-04,1410.28,supplier_payment,out,Counterparty_85,23817641.31,2025-03-06,2025-04-06
2025-04-04,4082.89,marketing_spend,out,Counterparty_52,23813558.42,2025-03-09,2025-04-15
2025-04-04,476.66,asset_sale,in,Counterparty_11,23814035.08,,
2025-04-04,2991.64,supplier_payment,out,Counterparty_57,23811043.44,2025-03-17,2025-04-18
2025-04-04,577.92,tax_payment,out,Counterparty_81,23810465.52,2025-02-21,2025-03-29
2025-04-05,5577.88,payroll,out,Counterparty_32,23804887.64,2025-03-03,2025-03-30
2025-04-05,2177.4,marketing_spend,out,Counterparty_37,23802710.24,2025-03-01,2025-04-06
2025-04-05,1227.18,rent,out,Counterparty_8,23801483.06,2025-03-01,2025-04-06
2025-04-05,1440.04,investment_income,in,Counterparty_78,23802923.1,,
2025-04-05,8375.06,marketing_spend,out,Counterparty_6,23794548.04,2025-02-27,2025-03-31
2025-04-05,2335.44,supplier_payment,out,Counterparty_22,23792212.6,2025-03-06,2025-04-03
2025-04-05,2025.79,refund,in,Counterparty_97,23794238.39,,
2025-04-05,2770.36,T&E,out,Counterparty_11,23791468.03,2025-03-18,2025-04-15
2025-04-05,2403.06,T&E,out,Counterparty_44,23789064.97,2025-02-27,2025-04-05
2025-04-05,529.23,refund,in,Counterparty_45,23789594.2,,
2025-04-05,1647.56,payroll,out,Counterparty_95,23787946.64,2025-02-24,2025-04-02
2025-04-05,1511.59,investment_income,in,Counterparty_15,23789458.23,,
2025-04-05,2834.73,software_subscription,out,Counterparty_57,23786623.5,2025-03-18,2025-04-17
2025-04-05,3317.91,marketing_spend,out,Counterparty_12,23783305.59,2025-03-12,2025-04-06
2025-04-05,7380.67,customer_payment,in,Counterparty_75,23790686.26,,
2025-04-05,2422.73,investment_income,in,Counterparty_92,23793108.99,,
2025-04-05,115.52,rent,out,Counterparty_9,23792993.47,2025-03-15,2025-04-23
2025-04-05,3228.39,supplier_payment,out,Counterparty_41,23789765.08,2025-03-06,2025-04-10
2025-04-05,4129.74,T&E,out,Counterparty_27,23785635.34,2025-02-23,2025-03-20
2025-04-05,8161.44,marketing_spend,out,Counterparty_65,23777473.9,2025-02-21,2025-03-28
2025-04-05,22846.98,customer_payment,in,Counterparty_3,23800320.88,,
2025-04-05,1298.5,refund,in,Counterparty_24,23801619.38,,
2025-04-05,509.94,asset_sale,in,Counterparty_82,23802129.32,,
2025-04-05,7033.48,marketing_spend,out,Counterparty_82,23795095.84,2025-02-24,2025-03-25
2025-04-05,1193.21,utilities,out,Counterparty_74,23793902.63,2025-03-02,2025-04-01
2025-04-05,3212.15,tax_payment,out,Counterparty_1,23790690.48,2025-03-09,2025-04-12
2025-04-05,328.38,payroll,out,Counterparty_14,23790362.1,2025-03-21,2025-04-17
2025-04-05,8218.14,tax_payment,out,Counterparty_7,23782143.96,2025-03-11,2025-04-17
2025-04-05,327.52,utilities,out,Counterparty_15,23781816.44,2025-03-05,2025-04-01
2025-04-05,3310.4,software_subscription,out,Counterparty_12,23778506.04,2025-03-15,2025-04-20
2025-04-05,3260.47,marketing_spend,out,Counterparty_38,23775245.57,2025-03-21,2025-04-25
2025-04-05,2001.64,asset_sale,in,Counterparty_45,23777247.21,,
2025-04-05,2912.96,investment_income,in,Counterparty_32,23780160.17,,
2025-04-05,136.43,investment_income,in,Counterparty_99,23780296.6,,
2025-04-05,4603.71,utilities,out,Counterparty_87,23775692.89,2025-03-21,2025-04-27
2025-04-05,5805.19,investment_income,in,Counterparty_52,23781498.08,,
2025-04-05,804.17,T&E,out,Counterparty_8,23780693.91,2025-02-21,2025-03-18
2025-04-05,89.94,T&E,out,Counterparty_80,23780603.97,2025-03-01,2025-04-02
2025-04-05,8454.16,credit,in,Counterparty_74,23789058.13,,
2025-04-05,917.77,investment_income,in,Counterparty_83,23789975.9,,
2025-04-05,5449.84,refund,in,Counterparty_91,23795425.74,,
2025-04-05,2104.81,refund,in,Counterparty_44,23797530.55,,
2025-04-05,513.95,T&E,out,Counterparty_99,23797016.6,2025-02-27,2025-04-02
2025-04-05,1242.04,credit,in,Counterparty_85,23798258.64,,
2025-04-05,6784.38,marketing_spend,out,Counterparty_55,23791474.26,2025-03-21,2025-04-28
2025-04-05,513.42,T&E,out,Counterparty_25,23790960.84,2025-03-16,2025-04-13
2025-04-05,11397.39,customer_payment,in,Counterparty_68,23802358.23,,
2025-04-05,13.07,customer_payment,in,Counterparty_77,23802371.3,,
2025-04-05,3709.68,rent,out,Counterparty_47,23798661.62,2025-03-01,2025-04-08
2025-04-05,2673.24,credit,in,Counterparty_49,23801334.86,,
2025-04-05,6532.67,asset_sale,in,Counterparty_25,23807867.53,,
2025-04-05,5352.27,credit,in,Counterparty_52,23813219.8,,
2025-04-05,14441.46,asset_sale,in,Counterparty_83,23827661.26,,
2025-04-05,3394.88,investment_income,in,Counterparty_71,23831056.14,,
2025-04-05,9736.77,T&E,out,Counterparty_23,23821319.37,2025-03-11,2025-04-19
2025-04-05,2523.6,loan_repayment,out,Counterparty_25,23818795.77,2025-02-24,2025-03-23
2025-04-05,4890.14,asset_sale,in,Counterparty_86,23823685.91,,
2025-04-05,2153.9,refund,in,Counterparty_52,23825839.81,,
2025-04-06,5174.19,loan_repayment,out,Counterparty_41,23820665.62,2025-03-04,2025-03-29
2025-04-06,1935.97,marketing_spend,out,Counterparty_78,23818729.65,2025-03-04,2025-04-07
2025-04-06,4668.89,rent,out,Counterparty_95,23814060.76,2025-03-07,2025-04-11
2025-04-06,110.29,loan_repayment,out,Counterparty_36,23813950.47,2025-03-10,2025-04-14
2025-04-06,1830.76,tax_payment,out,Counterparty_12,23812119.71,2025-03-12,2025-04-17
2025-04-06,2089.93,payroll,out,Counterparty_11,23810029.78,2025-03-09,2025-04-10
2025-04-06,8275.92,tax_payment,out,Counterparty_89,23801753.86,2025-03-16,2025-04-12
2025-04-06,4340.93,utilities,out,Counterparty_9,23797412.93,2025-02-22,2025-03-29
2025-04-06,5965.74,rent,out,Counterparty_6,23791447.19,2025-03-15,2025-04-14
2025-04-06,4799.46,tax_payment,out,Counterparty_30,23786647.73,2025-02-26,2025-03-23
2025-04-06,784.12,software_subscription,out,Counterparty_63,23785863.61,2025-02-28,2025-04-06
2025-04-06,1316.28,supplier_payment,out,Counterparty_81,23784547.33,2025-03-14,2025-04-15
2025-04-06,88.74,supplier_payment,out,Counterparty_73,23784458.59,2025-02-27,2025-03-31
2025-04-06,164.33,asset_sale,in,Counterparty_81,23784622.92,,
2025-04-06,5519.42,refund,in,Counterparty_91,23790142.34,,
2025-04-06,7163.66,refund,in,Counterparty_67,23797306.0,,
2025-04-06,10504.82,software_subscription,out,Counterparty_93,23786801.18,2025-02-23,2025-03-26
2025-04-06,5552.52,T&E,out,Counterparty_54,23781248.66,2025-02-28,2025-03-30
2025-04-06,844.35,payroll,out,Counterparty_69,23780404.31,2025-03-17,2025-04-11
2025-04-06,3959.19,loan_repayment,out,Counterparty_62,23776445.12,2025-03-13,2025-04-11
2025-04-06,4903.79,T&E,out,Counterparty_71,23771541.33,2025-03-14,2025-04-09
2025-04-06,1639.35,supplier_payment,out,Counterparty_26,23769901.98,2025-03-07,2025-04-02
2025-04-06,2031.31,utilities,out,Counterparty_85,23767870.67,2025-03-14,2025-04-22
2025-04-06,6139.31,rent,out,Counterparty_86,23761731.36,2025-03-09,2025-04-17
2025-04-06,205.31,loan_repayment,out,Counterparty_32,23761526.05,2025-02-23,2025-04-01
2025-04-06,2476.09,utilities,out,Counterparty_28,23759049.96,2025-03-19,2025-04-23
2025-04-06,3358.33,marketing_spend,out,Counterparty_63,23755691.63,2025-02-22,2025-04-01
2025-04-06,6033.85,loan_repayment,out,Counterparty_83,23749657.78,2025-03-07,2025-04-05
2025-04-06,2148.54,tax_payment,out,Counterparty_72,23747509.24,2025-02-24,2025-04-02
2025-04-06,4358.83,software_subscription,out,Counterparty_62,23743150.41,2025-03-06,2025-04-05
2025-04-06,5166.98,tax_payment,out,Counterparty_74,23737983.43,2025-03-17,2025-04-21
2025-04-06,1673.37,utilities,out,Counterparty_36,23736310.06,2025-03-06,2025-04-08
2025-04-06,677.21,T&E,out,Counterparty_82,23735632.85,2025-02-23,2025-03-28
2025-04-06,7341.78,marketing_spend,out,Counterparty_43,23728291.07,2025-02-22,2025-03-29
2025-04-06,290.54,investment_income,in,Counterparty_86,23728581.61,,
2025-04-06,2778.81,credit,in,Counterparty_8,23731360.42,,
2025-04-06,1077.31,payroll,out,Counterparty_82,23730283.11,2025-02-23,2025-03-23
2025-04-06,8919.51,refund,in,Counterparty_28,23739202.62,,
2025-04-06,4081.44,tax_payment,out,Counterparty_42,23735121.18,2025-03-20,2025-04-23
2025-04-06,8246.13,rent,out,Counterparty_30,23726875.05,2025-03-19,2025-04-15
2025-04-06,7071.86,investment_income,in,Counterparty_34,23733946.91,,
2025-04-06,682.92,customer_payment,in,Counterparty_16,23734629.83,,
2025-04-06,206.3,credit,in,Counterparty_30,23734836.13,,
2025-04-06,22622.23,credit,in,Counterparty_5,23757458.36,,
2025-04-06,2480.28,customer_payment,in,Counterparty_59,23759938.64,,
2025-04-06,4383.85,customer_payment,in,Counterparty_88,23764322.49,,
2025-04-06,14282.33,refund,in,Counterparty_88,23778604.82,,
2025-04-06,7668.33,customer_payment,in,Counterparty_42,23786273.15,,
2025-04-06,17957.22,customer_payment,in,Counterparty_41,23804230.37,,
2025-04-06,1273.24,payroll,out,Counterparty_97,23802957.13,2025-03-04,2025-04-02
2025-04-06,4110.23,supplier_payment,out,Counterparty_89,23798846.9,2025-03-06,2025-04-10
2025-04-06,6610.94,refund,in,Counterparty_25,23805457.84,,
2025-04-06,1304.29,refund,in,Counterparty_10,23806762.13,,
2025-04-06,2784.87,customer_payment,in,Counterparty_92,23809547.0,,
2025-04-06,2048.84,credit,in,Counterparty_33,23811595.84,,
2025-04-06,841.81,asset_sale,in,Counterparty_19,23812437.65,,
2025-04-07,2992.93,asset_sale,in,Counterparty_55,23815430.58,,
2025-04-07,2558.88,credit,in,Counterparty_38,23817989.46,,
2025-04-07,4954.97,supplier_payment,out,Counterparty_31,23813034.49,2025-02-24,2025-03-28
2025-04-07,236.35,asset_sale,in,Counterparty_48,23813270.84,,
2025-04-07,13006.91,asset_sale,in,Counterparty_50,23826277.75,,
2025-04-07,836.5,investment_income,in,Counterparty_35,23827114.25,,
2025-04-07,3209.49,software_subscription,out,Counterparty_96,23823904.76,2025-02-27,2025-04-05
2025-04-07,3749.3,marketing_spend,out,Counterparty_30,23820155.46,2025-02-25,2025-03-29
2025-04-07,4271.54,marketing_spend,out,Counterparty_36,23815883.92,2025-03-13,2025-04-18
2025-04-07,3281.86,utilities,out,Counterparty_7,23812602.06,2025-03-07,2025-04-04
2025-04-07,15.11,loan_repayment,out,Counterparty_47,23812586.95,2025-03-12,2025-04-11
2025-04-07,1574.43,rent,out,Counterparty_96,23811012.52,2025-03-13,2025-04-20
2025-04-07,11218.86,investment_income,in,Counterparty_16,23822231.38,,
2025-04-07,1925.78,loan_repayment,out,Counterparty_47,23820305.6,2025-03-22,2025-04-25
2025-04-07,2484.6,refund,in,Counterparty_5,23822790.2,,
2025-04-07,1520.47,refund,in,Counterparty_34,23824310.67,,
2025-04-07,1654.65,credit,in,Counterparty_81,23825965.32,,
2025-04-07,4340.22,T&E,out,Counterparty_41,23821625.1,2025-03-14,2025-04-12
2025-04-07,321.47,utilities,out,Counterparty_73,23821303.63,2025-03-19,2025-04-20
2025-04-07,1881.47,asset_sale,in,Counterparty_91,23823185.1,,
2025-04-07,4660.41,marketing_spend,out,Counterparty_44,23818524.69,2025-03-14,2025-04-13
2025-04-07,2339.02,customer_payment,in,Counterparty_82,23820863.71,,
2025-04-07,1482.11,loan_repayment,out,Counterparty_96,23819381.6,2025-02-22,2025-03-23
2025-04-07,733.4,tax_payment,out,Counterparty_65,23818648.2,2025-03-03,2025-03-31
2025-04-07,2890.72,supplier_payment,out,Counterparty_28,23815757.48,2025-03-03,2025-03-29
2025-04-07,1756.9,loan_repayment,out,Counterparty_96,23814000.58,2025-03-14,2025-04-16
2025-04-07,1426.91,investment_income,in,Counterparty_77,23815427.49,,
2025-04-07,9108.23,credit,in,Counterparty_98,23824535.72,,
2025-04-07,3740.27,rent,out,Counterparty_68,23820795.45,2025-03-15,2025-04-10
2025-04-07,4967.71,software_subscription,out,Counterparty_25,23815827.74,2025-03-20,2025-04-26
2025-04-07,1275.06,software_subscription,out,Counterparty_88,23814552.68,2025-03-16,2025-04-19
2025-04-07,5453.37,marketing_spend,out,Counterparty_78,23809099.31,2025-03-23,2025-04-26
2025-04-07,5242.44,customer_payment,in,Counterparty_16,23814341.75,,
2025-04-07,3908.23,investment_income,in,Counterparty_60,23818249.98,,
2025-04-07,8394.81,investment_income,in,Counterparty_12,23826644.79,,
2025-04-07,7103.71,investment_income,in,Counterparty_11,23833748.5,,
2025-04-07,2392.43,loan_repayment,out,Counterparty_46,23831356.07,2025-03-18,2025-04-13
2025-04-07,332.8,investment_income,in,Counterparty_43,23831688.87,,
2025-04-07,1842.12,T&E,out,Counterparty_92,23829846.75,2025-03-01,2025-03-28
2025-04-07,880.64,software_subscription,out,Counterparty_33,23828966.11,2025-03-20,2025-04-23
2025-04-07,4998.85,customer_payment,in,Counterparty_33,23833964.96,,
2025-04-07,4887.68,credit,in,Counterparty_24,23838852.64,,
2025-04-07,795.59,loan_repayment,out,Counterparty_7,23838057.05,2025-02-28,2025-04-04
2025-04-07,6371.12,loan_repayment,out,Counterparty_88,23831685.93,2025-03-23,2025-04-28
2025-04-07,1.48,T&E,out,Counterparty_74,23831684.45,2025-03-19,2025-04-16
2025-04-07,2701.78,investment_income,in,Counterparty_70,23834386.23,,
2025-04-07,794.6,payroll,out,Counterparty_92,23833591.63,2025-03-08,2025-04-12
2025-04-07,4236.37,customer_payment,in,Counterparty_77,23837828.0,,
2025-04-07,12194.8,asset_sale,in,Counterparty_41,23850022.8,,
2025-04-07,596.41,T&E,out,Counterparty_5,23849426.39,2025-02-25,2025-04-03
2025-04-07,2457.24,refund,in,Counterparty_97,23851883.63,,
2025-04-07,1264.07,marketing_spend,out,Counterparty_98,23850619.56,2025-03-17,2025-04-11
2025-04-07,3410.86,supplier_payment,out,Counterparty_3,23847208.7,2025-03-02,2025-04-05
2025-04-07,1595.14,refund,in,Counterparty_39,23848803.84,,
2025-04-07,10300.44,credit,in,Counterparty_43,23859104.28,,
2025-04-07,4227.19,asset_sale,in,Counterparty_29,23863331.47,,
2025-04-07,14220.94,investment_income,in,Counterparty_96,23877552.41,,
2025-04-08,6586.66,refund,in,Counterparty_34,23884139.07,,
2025-04-08,1891.76,software_subscription,out,Counterparty_57,23882247.31,2025-02-26,2025-04-05
2025-04-08,4261.98,customer_payment,in,Counterparty_63,23886509.29,,
2025-04-08,1230.54,refund,in,Counterparty_32,23887739.83,,
2025-04-08,21.36,marketing_spend,out,Counterparty_79,23887718.47,2025-03-10,2025-04-04
2025-04-08,5736.69,tax_payment,out,Counterparty_4,23881981.78,2025-03-24,2025-04-21
2025-04-08,17453.88,customer_payment,in,Counterparty_81,23899435.66,,
2025-04-08,7226.46,T&E,out,Counterparty_77,23892209.2,2025-02-28,2025-04-05
2025-04-08,1212.13,utilities,out,Counterparty_72,23890997.07,2025-03-22,2025-04-19
2025-04-08,33191.44,customer_payment,in,Counterparty_64,23924188.51,,
2025-04-08,6090.23,loan_repayment,out,Counterparty_8,23918098.28,2025-02-24,2025-04-03
2025-04-08,2895.62,payroll,out,Counterparty_97,23915202.66,2025-03-07,2025-04-11
2025-04-08,6595.96,investment_income,in,Counterparty_60,23921798.62,,
2025-04-08,3436.91,T&E,out,Counterparty_41,23918361.71,2025-03-13,2025-04-13
2025-04-08,1915.51,customer_payment,in,Counterparty_9,23920277.22,,
2025-04-08,1391.27,refund,in,Counterparty_5,23921668.49,,
2025-04-08,3675.73,refund,in,Counterparty_99,23925344.22,,
2025-04-08,1614.96,marketing_spend,out,Counterparty_57,23923729.26,2025-03-08,2025-04-06
2025-04-08,8578.93,utilities,out,Counterparty_95,23915150.33,2025-03-07,2025-04-14
2025-04-08,5462.34,utilities,out,Counterparty_75,23909687.99,2025-03-23,2025-04-24
2025-04-08,2293.91,investment_income,in,Counterparty_54,23911981.9,,
2025-04-08,2212.05,asset_sale,in,Counterparty_36,23914193.95,,
2025-04-08,210.98,rent,out,Counterparty_74,23913982.97,2025-03-13,2025-04-20
2025-04-08,2718.74,credit,in,Counterparty_75,23916701.71,,
2025-04-08,1087.18,asset_sale,in,Counterparty_39,23917788.89,,
2025-04-08,4341.26,customer_payment,in,Counterparty_89,23922130.15,,
2025-04-08,332.5,refund,in,Counterparty_71,23922462.65,,
2025-04-08,2715.04,customer_payment,in,Counterparty_44,23925177.69,,
2025-04-08,689.11,tax_payment,out,Counterparty_25,23924488.58,2025-03-18,2025-04-26
2025-04-08,510.85,asset_sale,in,Counterparty_65,23924999.43,,
2025-04-08,408.19,payroll,out,Counterparty_29,23924591.24,2025-03-06,2025-04-05
2025-04-08,3418.33,rent,out,Counterparty_76,23921172.91,2025-03-20,2025-04-17
2025-04-08,12546.32,T&E,out,Counterparty_52,23908626.59,2025-02-28,2025-03-25
2025-04-08,1180.77,payroll,out,Counterparty_5,23907445.82,2025-02-27,2025-03-26
2025-04-08,505.99,T&E,out,Counterparty_42,23906939.83,2025-03-02,2025-04-05
2025-04-08,5734.51,marketing_spend,out,Counterparty_25,23901205.32,2025-03-13,2025-04-11
2025-04-08,3960.65,marketing_spend,out,Counterparty_91,23897244.67,2025-03-13,2025-04-09
2025-04-08,474.63,software_subscription,out,Counterparty_22,23896770.04,2025-03-12,2025-04-09
2025-04-08,4482.16,asset_sale,in,Counterparty_73,23901252.2,,
2025-04-08,14460.76,asset_sale,in,Counterparty_75,23915712.96,,
2025-04-08,2046.29,loan_repayment,out,Counterparty_75,23913666.67,2025-02-24,2025-03-21
2025-04-08,2957.44,tax_payment,out,Counterparty_33,23910709.23,2025-03-22,2025-04-28
2025-04-08,7643.2,marketing_spend,out,Counterparty_82,23903066.03,2025-03-10,2025-04-06
2025-04-08,2066.98,supplier_payment,out,Counterparty_46,23900999.05,2025-03-08,2025-04-04
2025-04-08,8900.54,marketing_spend,out,Counterparty_47,23892098.51,2025-03-01,2025-03-31
2025-04-08,2017.43,tax_payment,out,Counterparty_40,23890081.08,2025-03-12,2025-04-18
2025-04-08,1968.04,software_subscription,out,Counterparty_29,23888113.04,2025-03-23,2025-04-25
2025-04-08,563.25,supplier_payment,out,Counterparty_56,23887549.79,2025-03-12,2025-04-12
2025-04-08,3023.05,payroll,out,Counterparty_4,23884526.74,2025-02-24,2025-03-26
2025-04-08,818.72,software_subscription,out,Counterparty_84,23883708.02,2025-03-02,2025-04-03
2025-04-08,3240.95,utilities,out,Counterparty_49,23880467.07,2025-03-16,2025-04-21
2025-04-08,2074.49,payroll,out,Counterparty_76,23878392.58,2025-03-03,2025-04-01
2025-04-08,1704.72,loan_repayment,out,Counterparty_89,23876687.86,2025-03-10,2025-04-16
2025-04-08,598.8,rent,out,Counterparty_59,23876089.06,2025-03-24,2025-04-20
2025-04-08,3528.07,refund,in,Counterparty_3,23879617.13,,
2025-04-08,1392.75,payroll,out,Counterparty_60,23878224.38,2025-03-06,2025-04-13
2025-04-08,1674.18,software_subscription,out,Counterparty_44,23876550.2,2025-03-23,2025-04-26
2025-04-08,1394.86,loan_repayment,out,Counterparty_5,23875155.34,2025-03-20,2025-04-17
2025-04-08,1951.59,T&E,out,Counterparty_32,23873203.75,2025-03-18,2025-04-20
2025-04-08,4759.07,T&E,out,Counterparty_86,23868444.68,2025-03-20,2025-04-19
2025-04-08,7565.41,marketing_spend,out,Counterparty_16,23860879.27,2025-03-05,2025-04-03
2025-04-08,16785.8,asset_sale,in,Counterparty_88,23877665.07,,
2025-04-08,2516.07,supplier_payment,out,Counterparty_45,23875149.0,2025-03-22,2025-04-25
2025-04-09,845.63,loan_repayment,out,Counterparty_38,23874303.37,2025-03-06,2025-04-07
2025-04-09,9341.74,marketing_spend,out,Counterparty_83,23864961.63,2025-02-24,2025-03-30
2025-04-09,9548.96,customer_payment,in,Counterparty_21,23874510.59,,
2025-04-09,22631.6,refund,in,Counterparty_26,23897142.19,,
2025-04-09,417.22,customer_payment,in,Counterparty_52,23897559.41,,
2025-04-09,4100.24,customer_payment,in,Counterparty_70,23901659.65,,
2025-04-09,1238.85,credit,in,Counterparty_7,23902898.5,,
2025-04-09,4882.41,tax_payment,out,Counterparty_10,23898016.09,2025-03-23,2025-04-17
2025-04-09,9134.9,refund,in,Counterparty_47,23907150.99,,
2025-04-09,1087.55,T&E,out,Counterparty_51,23906063.44,2025-03-10,2025-04-16
2025-04-09,3091.56,rent,out,Counterparty_14,23902971.88,2025-02-27,2025-03-28
2025-04-09,5138.89,customer_payment,in,Counterparty_35,23908110.77,,
2025-04-09,6403.13,credit,in,Counterparty_39,23914513.9,,
2025-04-09,2169.24,asset_sale,in,Counterparty_56,23916683.14,,
2025-04-09,1274.63,marketing_spend,out,Counterparty_66,23915408.51,2025-03-10,2025-04-08
2025-04-09,1435.8,refund,in,Counterparty_20,23916844.31,,
2025-04-09,16382.14,customer_payment,in,Counterparty_71,23933226.45,,
2025-04-09,11790.31,asset_sale,in,Counterparty_56,23945016.76,,
2025-04-09,2959.83,refund,in,Counterparty_78,23947976.59,,
2025-04-09,6897.56,credit,in,Counterparty_61,23954874.15,,
2025-04-09,2238.38,tax_payment,out,Counterparty_98,23952635.77,2025-03-19,2025-04-23
2025-04-09,2938.13,customer_payment,in,Counterparty_81,23955573.9,,
2025-04-09,7425.55,utilities,out,Counterparty_13,23948148.35,2025-03-08,2025-04-15
2025-04-09,1045.94,software_subscription,out,Counterparty_28,23947102.41,2025-03-03,2025-04-02
2025-04-09,4879.96,refund,in,Counterparty_53,23951982.37,,
2025-04-09,4686.5,investment_income,in,Counterparty_21,23956668.87,,
2025-04-09,1780.56,utilities,out,Counterparty_56,23954888.31,2025-03-24,2025-04-28
2025-04-09,3698.91,loan_repayment,out,Counterparty_76,23951189.4,2025-03-15,2025-04-22
2025-04-09,19.48,software_subscription,out,Counterparty_19,23951169.92,2025-03-24,2025-04-25
2025-04-09,1216.87,software_subscription,out,Counterparty_71,23949953.05,2025-03-10,2025-04-17
2025-04-09,1815.1,investment_income,in,Counterparty_92,23951768.15,,
2025-04-09,2590.35,supplier_payment,out,Counterparty_86,23949177.8,2025-02-26,2025-03-25
2025-04-09,3055.77,tax_payment,out,Counterparty_85,23946122.03,2025-03-05,2025-04-11
2025-04-09,1117.34,tax_payment,out,Counterparty_93,23945004.69,2025-03-02,2025-04-08
2025-04-09,3887.17,rent,out,Counterparty_83,23941117.52,2025-02-25,2025-04-02
2025-04-09,4729.17,customer_payment,in,Counterparty_53,23945846.69,,
2025-04-09,11696.04,software_subscription,out,Counterparty_63,23934150.65,2025-03-25,2025-04-19
2025-04-09,1390.0,payroll,out,Counterparty_43,23932760.65,2025-03-11,2025-04-17
2025-04-09,3625.28,tax_payment,out,Counterparty_43,23929135.37,2025-03-02,2025-04-10
2025-04-09,2201.16,customer_payment,in,Counterparty_58,23931336.53,,
2025-04-09,763.39,utilities,out,Counterparty_7,23930573.14,2025-03-22,2025-04-25
2025-04-09,718.31,loan_repayment,out,Counterparty_34,23929854.83,2025-03-15,2025-04-17
2025-04-09,1189.91,credit,in,Counterparty_77,23931044.74,,
2025-04-09,19233.01,investment_income,in,Counterparty_68,23950277.75,,
2025-04-09,966.61,refund,in,Counterparty_86,23951244.36,,
2025-04-09,6597.04,refund,in,Counterparty_64,23957841.4,,
2025-04-09,203.97,customer_payment,in,Counterparty_76,23958045.37,,
2025-04-09,827.74,tax_payment,out,Counterparty_69,23957217.63,2025-03-22,2025-04-20
2025-04-09,4250.69,supplier_payment,out,Counterparty_7,23952966.94,2025-02-25,2025-03-28
2025-04-09,10060.44,investment_income,in,Counterparty_11,23963027.38,,
2025-04-09,2764.64,investment_income,in,Counterparty_49,23965792.02,,
2025-04-09,4233.86,loan_repayment,out,Counterparty_13,23961558.16,2025-03-12,2025-04-20
2025-04-09,4872.15,utilities,out,Counterparty_32,23956686.01,2025-02-24,2025-03-29
2025-04-09,2162.96,payroll,out,Counterparty_58,23954523.05,2025-03-19,2025-04-23
2025-04-09,1949.89,credit,in,Counterparty_99,23956472.94,,
2025-04-09,6682.1,supplier_payment,out,Counterparty_20,23949790.84,2025-03-15,2025-04-23
2025-04-09,3408.0,investment_income,in,Counterparty_22,23953198.84,,
2025-04-09,5508.96,marketing_spend,out,Counterparty_88,23947689.88,2025-03-20,2025-04-26
2025-04-09,5170.34,marketing_spend,out,Counterparty_48,23942519.54,2025-02-24,2025-04-04
2025-04-09,6382.16,rent,out,Counterparty_71,23936137.38,2025-03-17,2025-04-12
2025-04-09,6374.11,T&E,out,Counterparty_92,23929763.27,2025-03-11,2025-04-17
2025-04-09,15801.7,supplier_payment,out,Counterparty_78,23913961.57,2025-03-20,2025-04-25
2025-04-10,7506.94,credit,in,Counterparty_41,23921468.51,,
2025-04-10,174.95,marketing_spend,out,Counterparty_63,23921293.56,2025-03-12,2025-04-14
2025-04-10,722.14,payroll,out,Counterparty_29,23920571.42,2025-03-07,2025-04-11
2025-04-10,5690.62,credit,in,Counterparty_24,23926262.04,,
2025-04-10,1489.6,asset_sale,in,Counterparty_82,23927751.64,,
2025-04-10,6306.87,refund,in,Counterparty_74,23934058.51,,
2025-04-10,1379.01,marketing_spend,out,Counterparty_48,23932679.5,2025-03-06,2025-04-14
2025-04-10,4065.99,refund,in,Counterparty_80,23936745.49,,
2025-04-10,13441.84,credit,in,Counterparty_59,23950187.33,,
2025-04-10,1910.59,tax_payment,out,Counterparty_79,23948276.74,2025-03-01,2025-04-07
2025-04-10,4928.98,tax_payment,out,Counterparty_21,23943347.76,2025-03-13,2025-04-15
2025-04-10,1019.48,tax_payment,out,Counterparty_69,23942328.28,2025-03-12,2025-04-16
2025-04-10,4196.96,T&E,out,Counterparty_6,23938131.32,2025-02-26,2025-04-04
2025-04-10,1577.45,software_subscription,out,Counterparty_85,23936553.87,2025-02-26,2025-03-28
2025-04-10,13306.49,credit,in,Counterparty_52,23949860.36,,
2025-04-10,1092.12,loan_repayment,out,Counterparty_59,23948768.24,2025-03-01,2025-03-30
2025-04-10,1845.0,T&E,out,Counterparty_21,23946923.24,2025-03-04,2025-04-06
2025-04-10,2922.5,payroll,out,Counterparty_66,23944000.74,2025-03-23,2025-04-26
2025-04-10,706.03,payroll,out,Counterparty_16,23943294.71,2025-03-07,2025-04-06
2025-04-10,3580.36,tax_payment,out,Counterparty_69,23939714.35,2025-03-16,2025-04-22
2025-04-10,4008.07,rent,out,Counterparty_8,23935706.28,2025-03-03,2025-04-10
2025-04-10,2578.34,supplier_payment,out,Counterparty_31,23933127.94,2025-03-13,2025-04-11
2025-04-10,17446.41,asset_sale,in,Counterparty_97,23950574.35,,
2025-04-10,3992.47,asset_sale,in,Counterparty_72,23954566.82,,
2025-04-10,3071.52,supplier_payment,out,Counterparty_35,23951495.3,2025-03-16,2025-04-18
2025-04-10,4060.26,rent,out,Counterparty_29,23947435.04,2025-03-06,2025-04-03
2025-04-10,4344.26,asset_sale,in,Counterparty_99,23951779.3,,
2025-04-10,26419.03,refund,in,Counterparty_37,23978198.33,,
2025-04-10,16606.53,T&E,out,Counterparty_76,23961591.8,2025-02-26,2025-04-06
2025-04-10,2340.19,software_subscription,out,Counterparty_70,23959251.61,2025-03-04,2025-04-03
2025-04-10,1606.63,marketing_spend,out,Counterparty_13,23957644.98,2025-03-02,2025-04-03
2025-04-10,2119.5,T&E,out,Counterparty_22,23955525.48,2025-03-03,2025-04-04
2025-04-10,3304.43,rent,out,Counterparty_70,23952221.05,2025-03-14,2025-04-17
2025-04-10,793.74,customer_payment,in,Counterparty_42,23953014.79,,
2025-04-10,5045.47,marketing_spend,out,Counterparty_28,23947969.32,2025-03-15,2025-04-09
2025-04-10,1009.14,loan_repayment,out,Counterparty_77,23946960.18,2025-02-27,2025-03-28
2025-04-10,8222.32,investment_income,in,Counterparty_99,23955182.5,,
2025-04-10,4411.78,rent,out,Counterparty_16,23950770.72,2025-03-10,2025-04-10
2025-04-10,4206.92,credit,in,Counterparty_32,23954977.64,,
2025-04-10,1288.15,payroll,out,Counterparty_88,23953689.49,2025-03-19,2025-04-16
2025-04-10,1838.57,rent,out,Counterparty_95,23951850.92,2025-03-17,2025-04-17
2025-04-10,10212.64,refund,in,Counterparty_58,23962063.56,,
2025-04-10,3226.25,credit,in,Counterparty_98,23965289.81,,
2025-04-10,391.56,utilities,out,Counterparty_77,23964898.25,2025-03-17,2025-04-12
2025-04-10,2011.86,payroll,out,Counterparty_29,23962886.39,2025-03-25,2025-04-29
2025-04-10,6026.75,supplier_payment,out,Counterparty_66,23956859.64,2025-02-26,2025-04-02
2025-04-10,1967.95,credit,in,Counterparty_14,23958827.59,,
2025-04-10,4609.53,credit,in,Counterparty_55,23963437.12,,
2025-04-10,484.85,credit,in,Counterparty_22,23963921.97,,
2025-04-10,2324.72,supplier_payment,out,Counterparty_31,23961597.25,2025-03-12,2025-04-18
2025-04-10,7132.07,supplier_payment,out,Counterparty_79,23954465.18,2025-02-28,2025-04-04
2025-04-10,4775.71,utilities,out,Counterparty_32,23949689.47,2025-02-26,2025-03-24
2025-04-10,2405.21,investment_income,in,Counterparty_90,23952094.68,,
2025-04-10,5048.86,investment_income,in,Counterparty_93,23957143.54,,
2025-04-10,2839.29,customer_payment,in,Counterparty_31,23959982.83,,
2025-04-10,46.52,software_subscription,out,Counterparty_39,23959936.31,2025-03-04,2025-03-30
2025-04-10,6925.3,T&E,out,Counterparty_3,23953011.01,2025-03-04,2025-03-30
2025-04-10,13521.94,asset_sale,in,Counterparty_74,23966532.95,,
2025-04-10,3614.48,software_subscription,out,Counterparty_83,23962918.47,2025-03-25,2025-05-03
2025-04-10,7592.03,refund,in,Counterparty_42,23970510.5,,
2025-04-10,4049.18,T&E,out,Counterparty_67,23966461.32,2025-03-23,2025-04-19
2025-04-11,627.0,tax_payment,out,Counterparty_18,23965834.32,2025-03-20,2025-04-20
2025-04-11,3272.61,investment_income,in,Counterparty_69,23969106.93,,
2025-04-11,710.95,refund,in,Counterparty_27,23969817.88,,
2025-04-11,626.17,rent,out,Counterparty_1,23969191.71,2025-03-11,2025-04-17
2025-04-11,409.71,utilities,out,Counterparty_84,23968782.0,2025-03-25,2025-04-30
2025-04-11,3223.78,utilities,out,Counterparty_55,23965558.22,2025-03-02,2025-03-27
2025-04-11,4415.65,supplier_payment,out,Counterparty_7,23961142.57,2025-03-16,2025-04-18
2025-04-11,1043.56,supplier_payment,out,Counterparty_41,23960099.01,2025-03-19,2025-04-24
2025-04-11,1488.34,customer_payment,in,Counterparty_78,23961587.35,,
2025-04-11,6974.38,asset_sale,in,Counterparty_71,23968561.73,,
2025-04-11,126.4,customer_payment,in,Counterparty_66,23968688.13,,
2025-04-11,421.21,software_subscription,out,Counterparty_10,23968266.92,2025-02-26,2025-03-24
2025-04-11,3976.68,refund,in,Counterparty_2,23972243.6,,
2025-04-11,259.55,asset_sale,in,Counterparty_68,23972503.15,,
2025-04-11,8207.31,payroll,out,Counterparty_42,23964295.84,2025-03-20,2025-04-21
2025-04-11,75.39,payroll,out,Counterparty_44,23964220.45,2025-02-27,2025-03-25
2025-04-11,629.6,customer_payment,in,Counterparty_87,23964850.05,,
2025-04-11,4694.62,T&E,out,Counterparty_77,23960155.43,2025-03-14,2025-04-14
2025-04-11,8730.67,marketing_spend,out,Counterparty_63,23951424.76,2025-03-03,2025-04-10
2025-04-11,3823.13,marketing_spend,out,Counterparty_51,23947601.63,2025-03-25,2025-04-29
2025-04-11,2024.13,payroll,out,Counterparty_89,23945577.5,2025-03-05,2025-04-13
2025-04-11,2386.72,supplier_payment,out,Counterparty_34,23943190.78,2025-03-17,2025-04-11
2025-04-11,417.44,T&E,out,Counterparty_43,23942773.34,2025-03-03,2025-04-04
2025-04-11,779.29,payroll,out,Counterparty_45,23941994.05,2025-03-01,2025-04-01
2025-04-11,382.21,marketing_spend,out,Counterparty_47,23941611.84,2025-03-11,2025-04-07
2025-04-11,8395.05,asset_sale,in,Counterparty_96,23950006.89,,
2025-04-11,548.51,software_subscription,out,Counterparty_91,23949458.38,2025-03-12,2025-04-20
2025-04-11,592.05,T&E,out,Counterparty_70,23948866.33,2025-03-06,2025-03-31
2025-04-11,5678.63,payroll,out,Counterparty_67,23943187.7,2025-03-19,2025-04-27
2025-04-11,8624.66,asset_sale,in,Counterparty_66,23951812.36,,
2025-04-11,18221.21,customer_payment,in,Counterparty_30,23970033.57,,
2025-04-11,12921.96,credit,in,Counterparty_55,23982955.53,,
2025-04-11,2107.17,investment_income,in,Counterparty_44,23985062.7,,
2025-04-11,802.96,payroll,out,Counterparty_96,23984259.74,2025-02-27,2025-04-07
2025-04-11,5505.2,customer_payment,in,Counterparty_23,23989764.94,,
2025-04-11,2640.32,T&E,out,Counterparty_76,23987124.62,2025-03-17,2025-04-13
2025-04-11,3785.21,supplier_payment,out,Counterparty_46,23983339.41,2025-03-02,2025-03-28
2025-04-11,6354.59,asset_sale,in,Counterparty_15,23989694.0,,
2025-04-11,1437.08,customer_payment,in,Counterparty_49,23991131.08,,
2025-04-11,1133.55,T&E,out,Counterparty_80,23989997.53,2025-03-09,2025-04-17
2025-04-11,2898.59,credit,in,Counterparty_81,23992896.12,,
2025-04-11,2237.39,customer_payment,in,Counterparty_50,23995133.51,,
2025-04-11,1988.41,investment_income,in,Counterparty_87,23997121.92,,
2025-04-11,173.25,software_subscription,out,Counterparty_81,23996948.67,2025-02-28,2025-03-27
2025-04-11,585.0,software_subscription,out,Counterparty_46,23996363.67,2025-03-16,2025-04-14
2025-04-11,1030.54,investment_income,in,Counterparty_27,23997394.21,,
2025-04-11,440.24,supplier_payment,out,Counterparty_42,23996953.97,2025-03-13,2025-04-14
2025-04-11,1177.95,refund,in,Counterparty_83,23998131.92,,
2025-04-11,579.04,refund,in,Counterparty_5,23998710.96,,
2025-04-11,9793.49,asset_sale,in,Counterparty_31,24008504.45,,
2025-04-11,437.89,investment_income,in,Counterparty_25,24008942.34,,
2025-04-11,5266.11,customer_payment,in,Counterparty_97,24014208.45,,
2025-04-11,1646.03,utilities,out,Counterparty_62,24012562.42,2025-03-23,2025-04-25
2025-04-11,6072.57,supplier_payment,out,Counterparty_60,24006489.85,2025-03-05,2025-04-04
2025-04-11,12789.42,supplier_payment,out,Counterparty_27,23993700.43,2025-03-12,2025-04-15
2025-04-11,7383.72,refund,in,Counterparty_88,24001084.15,,
2025-04-11,2995.2,credit,in,Counterparty_67,24004079.35,,
2025-04-11,11061.16,asset_sale,in,Counterparty_30,24015140.51,,
2025-04-11,5453.42,T&E,out,Counterparty_9,24009687.09,2025-03-12,2025-04-18
2025-04-11,8591.83,refund,in,Counterparty_70,24018278.92,,
2025-04-11,7393.39,asset_sale,in,Counterparty_4,24025672.31,,
2025-04-11,2035.16,loan_repayment,out,Counterparty_69,24023637.15,2025-03-15,2025-04-14
2025-04-11,1171.47,customer_payment,in,Counterparty_7,24024808.62,,
2025-04-12,2114.88,investment_income,in,Counterparty_78,24026923.5,,
2025-04-12,65.3,investment_income,in,Counterparty_89,24026988.8,,
2025-04-12,708.75,loan_repayment,out,Counterparty_47,24026280.05,2025-03-04,2025-03-31
2025-04-12,3873.74,asset_sale,in,Counterparty_21,24030153.79,,
2025-04-12,1090.23,refund,in,Counterparty_60,24031244.02,,
2025-04-12,9401.68,loan_repayment,out,Counterparty_37,24021842.34,2025-03-01,2025-04-08
2025-04-12,8551.55,investment_income,in,Counterparty_22,24030393.89,,
2025-04-12,2397.65,investment_income,in,Counterparty_17,24032791.54,,
2025-04-12,2360.31,utilities,out,Counterparty_2,24030431.23,2025-03-17,2025-04-13
2025-04-12,2911.1,tax_payment,out,Counterparty_52,24027520.13,2025-03-17,2025-04-14
2025-04-12,7034.95,tax_payment,out,Counterparty_70,24020485.18,2025-03-19,2025-04-26
2025-04-12,1727.36,software_subscription,out,Counterparty_36,24018757.82,2025-03-03,2025-04-03
2025-04-12,13976.23,refund,in,Counterparty_59,24032734.05,,
2025-04-12,3097.89,T&E,out,Counterparty_92,24029636.16,2025-03-02,2025-04-09
2025-04-12,1419.43,utilities,out,Counterparty_52,24028216.73,2025-03-14,2025-04-20
2025-04-12,2358.18,marketing_spend,out,Counterparty_70,24025858.55,2025-03-13,2025-04-17
2025-04-12,571.28,tax_payment,out,Counterparty_21,24025287.27,2025-03-18,2025-04-12
2025-04-12,4594.9,supplier_payment,out,Counterparty_5,24020692.37,2025-03-03,2025-04-08
2025-04-12,147.9,utilities,out,Counterparty_21,24020544.47,2025-02-28,2025-04-06
2025-04-12,715.89,T&E,out,Counterparty_65,24019828.58,2025-03-19,2025-04-13
2025-04-12,16741.87,investment_income,in,Counterparty_99,24036570.45,,
2025-04-12,16317.67,investment_income,in,Counterparty_33,24052888.12,,
2025-04-12,10063.72,investment_income,in,Counterparty_79,24062951.84,,
2025-04-12,1385.21,software_subscription,out,Counterparty_87,24061566.63,2025-03-22,2025-04-18
2025-04-12,2413.35,software_subscription,out,Counterparty_33,24059153.28,2025-03-12,2025-04-20
2025-04-12,1841.55,asset_sale,in,Counterparty_8,24060994.83,,
2025-04-12,816.13,credit,in,Counterparty_55,24061810.96,,
2025-04-12,4556.66,customer_payment,in,Counterparty_49,24066367.62,,
2025-04-12,132.03,asset_sale,in,Counterparty_21,24066499.65,,
2025-04-12,2861.83,marketing_spend,out,Counterparty_68,24063637.82,2025-03-15,2025-04-22
2025-04-12,4565.34,customer_payment,in,Counterparty_49,24068203.16,,
2025-04-12,2756.7,marketing_spend,out,Counterparty_50,24065446.46,2025-03-26,2025-04-22
2025-04-12,3540.3,credit,in,Counterparty_63,24068986.76,,
2025-04-12,1660.48,asset_sale,in,Counterparty_54,24070647.24,,
2025-04-12,1748.21,credit,in,Counterparty_60,24072395.45,,
2025-04-12,4749.82,customer_payment,in,Counterparty_81,24077145.27,,
2025-04-12,1859.86,customer_payment,in,Counterparty_90,24079005.13,,
2025-04-12,1326.04,software_subscription,out,Counterparty_59,24077679.09,2025-03-25,2025-04-21
2025-04-12,885.72,supplier_payment,out,Counterparty_59,24076793.37,2025-03-28,2025-04-23
2025-04-12,4481.48,loan_repayment,out,Counterparty_46,24072311.89,2025-03-14,2025-04-08
2025-04-12,8138.24,customer_payment,in,Counterparty_92,24080450.13,,
2025-04-12,11798.1,investment_income,in,Counterparty_68,24092248.23,,
2025-04-12,1526.22,supplier_payment,out,Counterparty_14,24090722.01,2025-03-21,2025-04-28
2025-04-12,827.01,tax_payment,out,Counterparty_45,24089895.0,2025-03-19,2025-04-25
2025-04-12,1571.58,investment_income,in,Counterparty_16,24091466.58,,
2025-04-12,12893.61,marketing_spend,out,Counterparty_26,24078572.97,2025-03-06,2025-04-14
2025-04-12,8598.35,T&E,out,Counterparty_96,24069974.62,2025-03-03,2025-04-11
2025-04-12,11098.35,software_subscription,out,Counterparty_99,24058876.27,2025-03-04,2025-04-12
2025-04-12,1349.43,tax_payment,out,Counterparty_24,24057526.84,2025-03-04,2025-04-12
2025-04-12,9347.35,marketing_spend,out,Counterparty_24,24048179.49,2025-03-16,2025-04-13
2025-04-12,1972.13,software_subscription,out,Counterparty_83,24046207.36,2025-03-05,2025-04-05
2025-04-12,5439.01,investment_income,in,Counterparty_33,24051646.37,,
2025-04-12,7591.18,refund,in,Counterparty_91,24059237.55,,
2025-04-12,1219.23,asset_sale,in,Counterparty_95,24060456.78,,
2025-04-12,3128.13,supplier_payment,out,Counterparty_88,24057328.65,2025-03-04,2025-04-01
2025-04-12,1960.61,T&E,out,Counterparty_98,24055368.04,2025-03-22,2025-04-19
2025-04-12,4569.36,credit,in,Counterparty_63,24059937.4,,
2025-04-12,309.09,utilities,out,Counterparty_45,24059628.31,2025-03-09,2025-04-12
2025-04-12,2505.1,customer_payment,in,Counterparty_25,24062133.41,,
2025-04-12,1352.11,utilities,out,Counterparty_39,24060781.3,2025-03-08,2025-04-15
2025-04-12,9883.48,marketing_spend,out,Counterparty_44,24050897.82,2025-02-27,2025-04-02
2025-04-12,4326.27,payroll,out,Counterparty_6,24046571.55,2025-03-02,2025-03-28
2025-04-12,10501.79,credit,in,Counterparty_62,24057073.34,,
2025-04-12,12517.05,marketing_spend,out,Counterparty_18,24044556.29,2025-03-15,2025-04-15
2025-04-12,2054.6,loan_repayment,out,Counterparty_37,24042501.69,2025-03-10,2025-04-10
2025-04-12,1857.56,refund,in,Counterparty_70,24044359.25,,
2025-04-12,967.84,tax_payment,out,Counterparty_33,24043391.41,2025-03-23,2025-04-17
2025-04-12,6872.67,marketing_spend,out,Counterparty_82,24036518.74,2025-03-03,2025-04-02
2025-04-12,2086.12,investment_income,in,Counterparty_72,24038604.86,,
2025-04-12,13805.88,rent,out,Counterparty_81,24024798.98,2025-03-02,2025-04-05
2025-04-13,30555.86,investment_income,in,Counterparty_94,24055354.84,,
2025-04-13,767.58,marketing_spend,out,Counterparty_77,24054587.26,2025-03-01,2025-04-05
2025-04-13,2186.39,customer_payment,in,Counterparty_74,24056773.65,,
2025-04-13,5726.6,asset_sale,in,Counterparty_79,24062500.25,,
2025-04-13,7793.13,loan_repayment,out,Counterparty_96,24054707.12,2025-03-04,2025-04-12
2025-04-13,4942.9,investment_income,in,Counterparty_58,24059650.02,,
2025-04-13,4538.84,utilities,out,Counterparty_72,24055111.18,2025-03-11,2025-04-08
2025-04-13,11092.6,customer_payment,in,Counterparty_16,24066203.78,,
2025-04-13,9164.71,customer_payment,in,Counterparty_6,24075368.49,,
2025-04-13,151.4,software_subscription,out,Counterparty_95,24075217.09,2025-03-15,2025-04-17
2025-04-13,2785.07,asset_sale,in,Counterparty_72,24078002.16,,
2025-04-13,1125.75,credit,in,Counterparty_11,24079127.91,,
2025-04-13,4169.33,tax_payment,out,Counterparty_25,24074958.58,2025-03-16,2025-04-17
2025-04-13,3431.13,supplier_payment,out,Counterparty_36,24071527.45,2025-03-08,2025-04-16
2025-04-13,10531.68,refund,in,Counterparty_76,24082059.13,,
2025-04-13,526.35,payroll,out,Counterparty_9,24081532.78,2025-03-26,2025-04-27
2025-04-13,481.86,refund,in,Counterparty_39,24082014.64,,
2025-04-13,1883.52,loan_repayment,out,Counterparty_68,24080131.12,2025-03-27,2025-04-29
2025-04-13,1425.21,T&E,out,Counterparty_31,24078705.91,2025-03-27,2025-04-24
2025-04-13,1516.43,asset_sale,in,Counterparty_29,24080222.34,,
2025-04-13,8898.17,supplier_payment,out,Counterparty_66,24071324.17,2025-03-22,2025-04-20
2025-04-13,7091.91,loan_repayment,out,Counterparty_85,24064232.26,2025-03-12,2025-04-10
2025-04-13,4786.58,asset_sale,in,Counterparty_57,24069018.84,,
2025-04-13,5074.24,utilities,out,Counterparty_27,24063944.6,2025-03-13,2025-04-08
2025-04-13,4195.02,payroll,out,Counterparty_69,24059749.58,2025-03-23,2025-05-01
2025-04-13,376.81,credit,in,Counterparty_82,24060126.39,,
2025-04-13,7826.89,investment_income,in,Counterparty_25,24067953.28,,
2025-04-13,917.36,investment_income,in,Counterparty_4,24068870.64,,
2025-04-13,1075.7,refund,in,Counterparty_35,24069946.34,,
2025-04-13,54.59,rent,out,Counterparty_40,24069891.75,2025-03-21,2025-04-18
2025-04-13,4277.62,refund,in,Counterparty_38,24074169.37,,
2025-04-13,7036.29,payroll,out,Counterparty_69,24067133.08,2025-03-02,2025-03-30
2025-04-13,197.57,utilities,out,Counterparty_1,24066935.51,2025-03-14,2025-04-21
2025-04-13,5937.18,utilities,out,Counterparty_43,24060998.33,2025-03-29,2025-04-28
2025-04-13,4180.76,investment_income,in,Counterparty_2,24065179.09,,
2025-04-13,3506.3,asset_sale,in,Counterparty_37,24068685.39,,
2025-04-13,1189.27,asset_sale,in,Counterparty_60,24069874.66,,
2025-04-13,1884.27,software_subscription,out,Counterparty_23,24067990.39,2025-03-12,2025-04-14
2025-04-13,2862.91,credit,in,Counterparty_97,24070853.3,,
2025-04-13,3857.91,loan_repayment,out,Counterparty_79,24066995.39,2025-03-02,2025-04-04
2025-04-13,7512.97,payroll,out,Counterparty_3,24059482.42,2025-03-16,2025-04-14
2025-04-13,13822.71,refund,in,Counterparty_66,24073305.13,,
2025-04-13,373.37,customer_payment,in,Counterparty_74,24073678.5,,
2025-04-13,2946.6,asset_sale,in,Counterparty_4,24076625.1,,
2025-04-13,722.38,tax_payment,out,Counterparty_73,24075902.72,2025-03-08,2025-04-16
2025-04-13,308.91,payroll,out,Counterparty_19,24075593.81,2025-03-07,2025-04-11
2025-04-13,3565.63,refund,in,Counterparty_80,24079159.44,,
2025-04-13,912.69,marketing_spend,out,Counterparty_85,24078246.75,2025-03-27,2025-04-26
2025-04-13,6958.38,asset_sale,in,Counterparty_56,24085205.13,,
2025-04-13,10701.23,credit,in,Counterparty_99,24095906.36,,
2025-04-13,3358.89,payroll,out,Counterparty_54,24092547.47,2025-03-12,2025-04-17
2025-04-13,1223.81,utilities,out,Counterparty_39,24091323.66,2025-03-12,2025-04-17
2025-04-13,373.98,loan_repayment,out,Counterparty_94,24090949.68,2025-03-10,2025-04-11
2025-04-13,10965.66,tax_payment,out,Counterparty_74,24079984.02,2025-03-09,2025-04-15
2025-04-13,4506.59,loan_repayment,out,Counterparty_91,24075477.43,2025-03-21,2025-04-19
2025-04-13,11160.16,customer_payment,in,Counterparty_3,24086637.59,,
2025-04-13,3532.19,tax_payment,out,Counterparty_81,24083105.4,2025-03-01,2025-04-03
2025-04-13,6809.77,credit,in,Counterparty_13,24089915.17,,
2025-04-13,283.77,supplier_payment,out,Counterparty_83,24089631.4,2025-02-28,2025-03-31
2025-04-13,3797.26,rent,out,Counterparty_26,24085834.14,2025-03-18,2025-04-15
2025-04-13,3482.82,customer_payment,in,Counterparty_49,24089316.96,,
2025-04-13,3162.28,utilities,out,Counterparty_19,24086154.68,2025-03-20,2025-04-28
2025-04-13,9836.52,payroll,out,Counterparty_10,24076318.16,2025-02-28,2025-03-31
2025-04-13,2486.7,credit,in,Counterparty_20,24078804.86,,
2025-04-13,10729.9,supplier_payment,out,Counterparty_87,24068074.96,2025-03-26,2025-04-21
2025-04-13,641.65,refund,in,Counterparty_38,24068716.61,,
2025-04-13,5322.47,tax_payment,out,Counterparty_71,24063394.14,2025-03-12,2025-04-10
2025-04-14,1656.05,supplier_payment,out,Counterparty_66,24061738.09,2025-03-04,2025-04-06
2025-04-14,3843.58,refund,in,Counterparty_57,24065581.67,,
2025-04-14,3644.31,T&E,out,Counterparty_26,24061937.36,2025-03-05,2025-04-05
2025-04-14,111.53,payroll,out,Counterparty_99,24061825.83,2025-03-06,2025-04-11
2025-04-14,4442.6,T&E,out,Counterparty_91,24057383.23,2025-03-20,2025-04-28
2025-04-14,5952.93,investment_income,in,Counterparty_40,24063336.16,,
2025-04-14,2253.29,marketing_spend,out,Counterparty_17,24061082.87,2025-03-07,2025-04-05
2025-04-14,11562.55,investment_income,in,Counterparty_32,24072645.42,,
2025-04-14,11646.09,asset_sale,in,Counterparty_91,24084291.51,,
2025-04-14,2673.3,refund,in,Counterparty_5,24086964.81,,
2025-04-14,7932.78,supplier_payment,out,Counterparty_35,24079032.03,2025-03-06,2025-04-10
2025-04-14,1361.79,payroll,out,Counterparty_20,24077670.24,2025-03-29,2025-05-02
2025-04-14,13870.88,tax_payment,out,Counterparty_31,24063799.36,2025-03-12,2025-04-09
2025-04-14,5236.03,software_subscription,out,Counterparty_13,24058563.33,2025-03-24,2025-04-27
2025-04-14,2445.9,rent,out,Counterparty_94,24056117.43,2025-03-13,2025-04-07
2025-04-14,17611.1,software_subscription,out,Counterparty_80,24038506.33,2025-03-08,2025-04-14
2025-04-14,4842.95,T&E,out,Counterparty_86,24033663.38,2025-03-14,2025-04-18
2025-04-14,1585.72,marketing_spend,out,Counterparty_99,24032077.66,2025-03-24,2025-05-01
2025-04-14,1715.59,software_subscription,out,Counterparty_99,24030362.07,2025-03-04,2025-04-09
2025-04-14,2763.79,software_subscription,out,Counterparty_18,24027598.28,2025-03-09,2025-04-08
2025-04-14,2614.16,loan_repayment,out,Counterparty_95,24024984.12,2025-03-12,2025-04-08
2025-04-14,8974.03,credit,in,Counterparty_69,24033958.15,,
2025-04-14,6190.19,T&E,out,Counterparty_97,24027767.96,2025-03-08,2025-04-04
2025-04-14,3101.66,T&E,out,Counterparty_62,24024666.3,2025-03-24,2025-04-30
2025-04-14,112.18,utilities,out,Counterparty_17,24024554.12,2025-03-09,2025-04-03
2025-04-14,878.95,tax_payment,out,Counterparty_39,24023675.17,2025-03-20,2025-04-14
2025-04-14,125.3,credit,in,Counterparty_80,24023800.47,,
2025-04-14,2535.84,asset_sale,in,Counterparty_49,24026336.31,,
2025-04-14,1951.11,investment_income,in,Counterparty_37,24028287.42,,
2025-04-14,4484.85,asset_sale,in,Counterparty_13,24032772.27,,
2025-04-14,1076.23,rent,out,Counterparty_23,24031696.04,2025-03-16,2025-04-20
2025-04-14,1656.01,T&E,out,Counterparty_40,24030040.03,2025-03-01,2025-04-05
2025-04-14,6838.64,payroll,out,Counterparty_47,24023201.39,2025-03-27,2025-05-01
2025-04-14,2659.23,credit,in,Counterparty_6,24025860.62,,
2025-04-14,26014.15,credit,in,Counterparty_60,24051874.77,,
2025-04-14,5633.72,tax_payment,out,Counterparty_30,24046241.05,2025-03-13,2025-04-15
2025-04-14,16000.42,investment_income,in,Counterparty_7,24062241.47,,
2025-04-14,1257.1,asset_sale,in,Counterparty_1,24063498.57,,
2025-04-14,10307.13,tax_payment,out,Counterparty_62,24053191.44,2025-03-14,2025-04-08
2025-04-14,438.42,investment_income,in,Counterparty_42,24053629.86,,
2025-04-14,516.79,payroll,out,Counterparty_2,24053113.07,2025-03-27,2025-05-02
2025-04-14,8776.95,credit,in,Counterparty_66,24061890.02,,
2025-04-14,2730.94,rent,out,Counterparty_97,24059159.08,2025-03-25,2025-05-03
2025-04-14,735.89,asset_sale,in,Counterparty_33,24059894.97,,
2025-04-14,9259.19,credit,in,Counterparty_11,24069154.16,,
2025-04-14,6458.39,customer_payment,in,Counterparty_50,24075612.55,,
2025-04-14,5861.19,rent,out,Counterparty_45,24069751.36,2025-03-30,2025-04-24
2025-04-14,2974.07,rent,out,Counterparty_33,24066777.29,2025-03-17,2025-04-17
2025-04-14,1104.2,T&E,out,Counterparty_32,24065673.09,2025-03-16,2025-04-10
2025-04-14,2835.36,customer_payment,in,Counterparty_83,24068508.45,,
2025-04-14,162.27,customer_payment,in,Counterparty_8,24068670.72,,
2025-04-14,6352.47,refund,in,Counterparty_86,24075023.19,,
2025-04-14,2520.23,marketing_spend,out,Counterparty_72,24072502.96,2025-03-26,2025-04-26
2025-04-14,550.84,credit,in,Counterparty_63,24073053.8,,
2025-04-14,1364.13,asset_sale,in,Counterparty_22,24074417.93,,
2025-04-14,3393.53,rent,out,Counterparty_3,24071024.4,2025-03-29,2025-04-27
2025-04-14,2073.04,software_subscription,out,Counterparty_24,24068951.36,2025-03-06,2025-04-07
2025-04-14,2386.55,supplier_payment,out,Counterparty_32,24066564.81,2025-03-22,2025-04-25
2025-04-14,10838.27,marketing_spend,out,Counterparty_73,24055726.54,2025-03-16,2025-04-22
2025-04-14,1501.89,T&E,out,Counterparty_27,24054224.65,2025-03-09,2025-04-08
2025-04-14,4340.74,rent,out,Counterparty_7,24049883.91,2025-03-29,2025-04-24
2025-04-14,476.06,investment_income,in,Counterparty_8,24050359.97,,
2025-04-14,6253.26,credit,in,Counterparty_74,24056613.23,,
2025-04-14,771.6,marketing_spend,out,Counterparty_79,24055841.63,2025-03-11,2025-04-14
2025-04-14,60.05,supplier_payment,out,Counterparty_99,24055781.58,2025-03-25,2025-05-03
2025-04-15,860.23,payroll,out,Counterparty_21,24054921.35,2025-03-27,2025-05-01
2025-04-15,4122.92,payroll,out,Counterparty_83,24050798.43,2025-03-17,2025-04-25
2025-04-15,696.92,supplier_payment,out,Counterparty_29,24050101.51,2025-03-29,2025-05-02
2025-04-15,3087.88,asset_sale,in,Counterparty_25,24053189.39,,
2025-04-15,1690.99,payroll,out,Counterparty_3,24051498.4,2025-03-21,2025-04-20
2025-04-15,2081.96,software_subscription,out,Counterparty_69,24049416.44,2025-03-15,2025-04-09
2025-04-15,310.69,marketing_spend,out,Counterparty_35,24049105.75,2025-03-11,2025-04-05
2025-04-15,16990.86,software_subscription,out,Counterparty_32,24032114.89,2025-03-13,2025-04-15
2025-04-15,2715.39,payroll,out,Counterparty_51,24029399.5,2025-03-25,2025-04-28
2025-04-15,343.85,T&E,out,Counterparty_22,24029055.65,2025-03-27,2025-05-05
2025-04-15,9928.85,customer_payment,in,Counterparty_66,24038984.5,,
2025-04-15,2791.79,software_subscription,out,Counterparty_83,24036192.71,2025-03-03,2025-04-07
2025-04-15,952.78,marketing_spend,out,Counterparty_78,24035239.93,2025-03-27,2025-04-23
2025-04-15,965.16,tax_payment,out,Counterparty_32,24034274.77,2025-03-30,2025-05-08
2025-04-15,3484.86,supplier_payment,out,Counterparty_92,24030789.91,2025-03-04,2025-04-08
2025-04-15,8808.7,supplier_payment,out,Counterparty_3,24021981.21,2025-03-08,2025-04-14
2025-04-15,10739.71,asset_sale,in,Counterparty_75,24032720.92,,
2025-04-15,6270.58,asset_sale,in,Counterparty_40,24038991.5,,
2025-04-15,783.39,payroll,out,Counterparty_37,24038208.11,2025-03-29,2025-05-03
2025-04-15,839.58,tax_payment,out,Counterparty_18,24037368.53,2025-03-22,2025-04-29
2025-04-15,10399.26,asset_sale,in,Counterparty_28,24047767.79,,
2025-04-15,10517.38,credit,in,Counterparty_8,24058285.17,,
2025-04-15,4824.32,tax_payment,out,Counterparty_73,24053460.85,2025-03-02,2025-04-04
2025-04-15,12931.26,customer_payment,in,Counterparty_8,24066392.11,,
2025-04-15,7552.51,refund,in,Counterparty_60,24073944.62,,
2025-04-15,5248.87,asset_sale,in,Counterparty_68,24079193.49,,
2025-04-15,351.69,supplier_payment,out,Counterparty_1,24078841.8,2025-03-24,2025-04-19
2025-04-15,275.21,investment_income,in,Counterparty_30,24079117.01,,
2025-04-15,5333.53,credit,in,Counterparty_82,24084450.54,,
2025-04-15,2983.34,T&E,out,Counterparty_31,24081467.2,2025-03-21,2025-04-26
2025-04-15,2688.45,asset_sale,in,Counterparty_56,24084155.65,,
2025-04-15,10826.48,customer_payment,in,Counterparty_10,24094982.13,,
2025-04-15,1137.74,asset_sale,in,Counterparty_22,24096119.87,,
2025-04-15,5420.98,rent,out,Counterparty_99,24090698.89,2025-03-21,2025-04-27
2025-04-15,1846.3,investment_income,in,Counterparty_58,24092545.19,,
2025-04-15,1093.21,loan_repayment,out,Counterparty_61,24091451.98,2025-03-08,2025-04-05
2025-04-15,2554.2,asset_sale,in,Counterparty_15,24094006.18,,
2025-04-15,1788.77,payroll,out,Counterparty_2,24092217.41,2025-03-24,2025-04-22
2025-04-15,18356.47,customer_payment,in,Counterparty_42,24110573.88,,
2025-04-15,289.63,T&E,out,Counterparty_4,24110284.25,2025-03-19,2025-04-16
2025-04-15,13694.98,asset_sale,in,Counterparty_18,24123979.23,,
2025-04-15,12613.67,credit,in,Counterparty_94,24136592.9,,
2025-04-15,4757.22,customer_payment,in,Counterparty_57,24141350.12,,
2025-04-15,1642.52,rent,out,Counterparty_58,24139707.6,2025-03-13,2025-04-11
2025-04-15,3143.36,asset_sale,in,Counterparty_18,24142850.96,,
2025-04-15,3104.77,T&E,out,Counterparty_49,24139746.19,2025-03-15,2025-04-11
2025-04-15,12471.88,utilities,out,Counterparty_85,24127274.31,2025-03-19,2025-04-21
2025-04-15,31.23,software_subscription,out,Counterparty_81,24127243.08,2025-03-21,2025-04-16
2025-04-15,255.82,marketing_spend,out,Counterparty_98,24126987.26,2025-03-24,2025-04-21
2025-04-15,1957.76,asset_sale,in,Counterparty_85,24128945.02,,
2025-04-15,2507.89,tax_payment,out,Counterparty_21,24126437.13,2025-03-10,2025-04-17
2025-04-15,1106.64,supplier_payment,out,Counterparty_48,24125330.49,2025-03-12,2025-04-09
2025-04-15,968.31,refund,in,Counterparty_79,24126298.8,,
2025-04-16,18742.81,credit,in,Counterparty_91,24145041.61,,
2025-04-16,1960.94,utilities,out,Counterparty_86,24143080.67,2025-03-06,2025-03-31
2025-04-16,1662.73,payroll,out,Counterparty_1,24141417.94,2025-03-20,2025-04-22
2025-04-16,15254.84,refund,in,Counterparty_84,24156672.78,,
2025-04-16,1444.06,credit,in,Counterparty_72,24158116.84,,
2025-04-16,9351.35,customer_payment,in,Counterparty_53,24167468.19,,
2025-04-16,4404.53,investment_income,in,Counterparty_95,24171872.72,,
2025-04-16,22.05,software_subscription,out,Counterparty_34,24171850.67,2025-03-10,2025-04-09
2025-04-16,2404.35,credit,in,Counterparty_80,24174255.02,,
2025-04-16,877.04,software_subscription,out,Counterparty_43,24173377.98,2025-03-11,2025-04-18
2025-04-16,10786.08,customer_payment,in,Counterparty_51,24184164.06,,
2025-04-16,7902.28,investment_income,in,Counterparty_84,24192066.34,,
2025-04-16,5592.91,asset_sale,in,Counterparty_68,24197659.25,,
2025-04-16,3450.34,utilities,out,Counterparty_4,24194208.91,2025-03-20,2025-04-22
2025-04-16,7991.27,asset_sale,in,Counterparty_50,24202200.18,,
2025-04-16,3001.31,credit,in,Counterparty_65,24205201.49,,
2025-04-16,11024.87,payroll,out,Counterparty_1,24194176.62,2025-03-29,2025-04-26
2025-04-16,2670.66,supplier_payment,out,Counterparty_33,24191505.96,2025-03-11,2025-04-09
2025-04-16,229.78,software_subscription,out,Counterparty_96,24191276.18,2025-03-20,2025-04-25
2025-04-16,1736.26,investment_income,in,Counterparty_5,24193012.44,,
2025-04-16,6007.44,refund,in,Counterparty_6,24199019.88,,
2025-04-16,168.35,refund,in,Counterparty_50,24199188.23,,
2025-04-16,6151.07,utilities,out,Counterparty_74,24193037.16,2025-03-20,2025-04-20
2025-04-16,681.0,credit,in,Counterparty_47,24193718.16,,
2025-04-16,9322.68,T&E,out,Counterparty_43,24184395.48,2025-03-17,2025-04-20
2025-04-16,2458.24,asset_sale,in,Counterparty_44,24186853.72,,
2025-04-16,2550.63,software_subscription,out,Counterparty_2,24184303.09,2025-03-25,2025-04-29
2025-04-16,8151.58,T&E,out,Counterparty_97,24176151.51,2025-03-09,2025-04-03
2025-04-16,3836.94,supplier_payment,out,Counterparty_41,24172314.57,2025-03-06,2025-04-14
2025-04-16,5854.74,supplier_payment,out,Counterparty_46,24166459.83,2025-03-31,2025-05-03
2025-04-16,2827.87,tax_payment,out,Counterparty_52,24163631.96,2025-03-04,2025-04-07
2025-04-16,3093.19,asset_sale,in,Counterparty_74,24166725.15,,
2025-04-16,5263.12,utilities,out,Counterparty_11,24161462.03,2025-03-08,2025-04-05
2025-04-16,2388.07,customer_payment,in,Counterparty_67,24163850.1,,
2025-04-16,3540.62,utilities,out,Counterparty_39,24160309.48,2025-03-18,2025-04-19
2025-04-16,145.0,T&E,out,Counterparty_44,24160164.48,2025-03-08,2025-04-02
2025-04-16,5996.27,T&E,out,Counterparty_26,24154168.21,2025-04-01,2025-05-06
2025-04-16,4341.88,credit,in,Counterparty_18,24158510.09,,
2025-04-16,4808.63,utilities,out,Counterparty_1,24153701.46,2025-03-15,2025-04-23
2025-04-16,6926.54,supplier_payment,out,Counterparty_60,24146774.92,2025-03-17,2025-04-17
2025-04-16,6027.65,investment_income,in,Counterparty_52,24152802.57,,
2025-04-16,11996.66,credit,in,Counterparty_25,24164799.23,,
2025-04-16,5044.35,T&E,out,Counterparty_42,24159754.88,2025-03-31,2025-05-09
2025-04-16,317.53,tax_payment,out,Counterparty_73,24159437.35,2025-03-28,2025-04-26
2025-04-16,2363.69,refund,in,Counterparty_52,24161801.04,,
2025-04-16,10154.21,customer_payment,in,Counterparty_40,24171955.25,,
2025-04-16,551.31,utilities,out,Counterparty_47,24171403.94,2025-03-21,2025-04-28
2025-04-16,6056.61,rent,out,Counterparty_53,24165347.33,2025-03-20,2025-04-25
2025-04-16,3759.64,investment_income,in,Counterparty_37,24169106.97,,
2025-04-16,3635.06,refund,in,Counterparty_55,24172742.03,,
2025-04-16,6149.99,software_subscription,out,Counterparty_56,24166592.04,2025-03-18,2025-04-22
2025-04-16,1540.03,asset_sale,in,Counterparty_9,24168132.07,,
2025-04-16,719.19,marketing_spend,out,Counterparty_18,24167412.88,2025-03-30,2025-05-06
2025-04-16,2558.81,customer_payment,in,Counterparty_87,24169971.69,,
2025-04-16,256.77,supplier_payment,out,Counterparty_49,24169714.92,2025-03-07,2025-04-11
2025-04-16,4821.1,customer_payment,in,Counterparty_84,24174536.02,,
2025-04-16,2127.23,tax_payment,out,Counterparty_29,24172408.79,2025-03-27,2025-04-30
2025-04-16,259.8,customer_payment,in,Counterparty_15,24172668.59,,
2025-04-16,3634.06,investment_income,in,Counterparty_82,24176302.65,,
2025-04-16,1296.37,loan_repayment,out,Counterparty_5,24175006.28,2025-04-01,2025-05-05
2025-04-17,9215.88,credit,in,Counterparty_35,24184222.16,,
2025-04-17,7515.17,loan_repayment,out,Counterparty_99,24176706.99,2025-03-30,2025-04-27
2025-04-17,2121.36,tax_payment,out,Counterparty_32,24174585.63,2025-03-08,2025-04-02
2025-04-17,758.07,T&E,out,Counterparty_24,24173827.56,2025-03-31,2025-05-01
2025-04-17,4751.17,rent,out,Counterparty_27,24169076.39,2025-03-28,2025-04-30
2025-04-17,3425.87,asset_sale,in,Counterparty_14,24172502.26,,
2025-04-17,946.98,tax_payment,out,Counterparty_97,24171555.28,2025-04-02,2025-05-05
2025-04-17,7343.87,asset_sale,in,Counterparty_31,24178899.15,,
2025-04-17,7458.16,refund,in,Counterparty_41,24186357.31,,
2025-04-17,6024.19,payroll,out,Counterparty_87,24180333.12,2025-03-30,2025-05-04
2025-04-17,1838.55,marketing_spend,out,Counterparty_51,24178494.57,2025-03-17,2025-04-15
2025-04-17,2868.2,investment_income,in,Counterparty_47,24181362.77,,
2025-04-17,3069.46,T&E,out,Counterparty_89,24178293.31,2025-03-29,2025-05-04
2025-04-17,497.29,customer_payment,in,Counterparty_20,24178790.6,,
2025-04-17,4000.86,supplier_payment,out,Counterparty_81,24174789.74,2025-03-23,2025-04-23
2025-04-17,10320.49,T&E,out,Counterparty_49,24164469.25,2025-03-08,2025-04-05
2025-04-17,2879.3,customer_payment,in,Counterparty_8,24167348.55,,
2025-04-17,15990.15,refund,in,Counterparty_85,24183338.7,,
2025-04-17,4052.63,software_subscription,out,Counterparty_37,24179286.07,2025-03-18,2025-04-26
2025-04-17,9279.1,asset_sale,in,Counterparty_84,24188565.17,,
2025-04-17,28.6,credit,in,Counterparty_31,24188593.77,,
2025-04-17,7921.36,customer_payment,in,Counterparty_16,24196515.13,,
2025-04-17,3393.34,investment_income,in,Counterparty_12,24199908.47,,
2025-04-17,11450.66,software_subscription,out,Counterparty_72,24188457.81,2025-04-01,2025-05-09
2025-04-17,13644.98,customer_payment,in,Counterparty_42,24202102.79,,
2025-04-17,1235.8,T&E,out,Counterparty_79,24200866.99,2025-03-17,2025-04-18
2025-04-17,178.8,marketing_spend,out,Counterparty_94,24200688.19,2025-03-22,2025-04-28
2025-04-17,1328.36,utilities,out,Counterparty_79,24199359.83,2025-03-27,2025-05-03
2025-04-17,13744.41,investment_income,in,Counterparty_91,24213104.24,,
2025-04-17,1615.07,payroll,out,Counterparty_15,24211489.17,2025-03-07,2025-04-01
2025-04-17,8149.94,refund,in,Counterparty_39,24219639.11,,
2025-04-17,1754.82,supplier_payment,out,Counterparty_43,24217884.29,2025-03-28,2025-05-05
2025-04-17,4342.0,refund,in,Counterparty_46,24222226.29,,
2025-04-17,39.93,investment_income,in,Counterparty_94,24222266.22,,
2025-04-17,8953.74,asset_sale,in,Counterparty_2,24231219.96,,
2025-04-17,7999.98,asset_sale,in,Counterparty_36,24239219.94,,
2025-04-17,1139.02,supplier_payment,out,Counterparty_86,24238080.92,2025-03-09,2025-04-10
2025-04-17,1213.44,marketing_spend,out,Counterparty_91,24236867.48,2025-03-04,2025-04-12
2025-04-17,11273.32,customer_payment,in,Counterparty_1,24248140.8,,
2025-04-17,4000.25,customer_payment,in,Counterparty_71,24252141.05,,
2025-04-17,4464.91,supplier_payment,out,Counterparty_81,24247676.14,2025-03-04,2025-04-03
2025-04-17,3624.55,refund,in,Counterparty_85,24251300.69,,
2025-04-17,4657.47,tax_payment,out,Counterparty_66,24246643.22,2025-03-19,2025-04-14
2025-04-17,631.33,supplier_payment,out,Counterparty_93,24246011.89,2025-03-05,2025-04-11
2025-04-17,1760.05,credit,in,Counterparty_94,24247771.94,,
2025-04-17,1987.07,rent,out,Counterparty_94,24245784.87,2025-03-20,2025-04-19
2025-04-17,1929.0,T&E,out,Counterparty_58,24243855.87,2025-03-09,2025-04-03
2025-04-17,3140.59,software_subscription,out,Counterparty_6,24240715.28,2025-03-05,2025-04-05
2025-04-17,2029.33,asset_sale,in,Counterparty_11,24242744.61,,
2025-04-17,989.07,refund,in,Counterparty_24,24243733.68,,
2025-04-17,4006.85,asset_sale,in,Counterparty_34,24247740.53,,
2025-04-17,1123.19,refund,in,Counterparty_49,24248863.72,,
2025-04-18,9456.17,investment_income,in,Counterparty_37,24258319.89,,
2025-04-18,622.22,utilities,out,Counterparty_36,24257697.67,2025-03-06,2025-04-12
2025-04-18,2322.19,supplier_payment,out,Counterparty_63,24255375.48,2025-03-06,2025-04-05
2025-04-18,2452.99,customer_payment,in,Counterparty_83,24257828.47,,
2025-04-18,1907.29,refund,in,Counterparty_73,24259735.76,,
2025-04-18,16454.19,customer_payment,in,Counterparty_63,24276189.95,,
2025-04-18,74.49,payroll,out,Counterparty_74,24276115.46,2025-03-16,2025-04-10
2025-04-18,3387.46,tax_payment,out,Counterparty_58,24272728.0,2025-03-25,2025-04-19
2025-04-18,553.88,tax_payment,out,Counterparty_47,24272174.12,2025-03-21,2025-04-15
2025-04-18,1873.89,utilities,out,Counterparty_40,24270300.23,2025-03-29,2025-04-27
2025-04-18,708.98,investment_income,in,Counterparty_89,24271009.21,,
2025-04-18,1381.71,loan_repayment,out,Counterparty_61,24269627.5,2025-03-23,2025-04-21
2025-04-18,657.26,credit,in,Counterparty_99,24270284.76,,
2025-04-18,7598.01,investment_income,in,Counterparty_41,24277882.77,,
2025-04-18,8141.07,loan_repayment,out,Counterparty_33,24269741.7,2025-04-03,2025-05-07
2025-04-18,4205.16,marketing_spend,out,Counterparty_87,24265536.54,2025-03-23,2025-04-28
2025-04-18,8445.11,asset_sale,in,Counterparty_68,24273981.65,,
2025-04-18,770.88,loan_repayment,out,Counterparty_90,24273210.77,2025-03-25,2025-04-20
2025-04-18,10602.22,marketing_spend,out,Counterparty_50,24262608.55,2025-04-03,2025-05-10
2025-04-18,1503.34,loan_repayment,out,Counterparty_32,24261105.21,2025-03-31,2025-05-01
2025-04-18,2797.49,supplier_payment,out,Counterparty_23,24258307.72,2025-03-08,2025-04-08
2025-04-18,3053.79,supplier_payment,out,Counterparty_35,24255253.93,2025-03-10,2025-04-12
2025-04-18,804.27,refund,in,Counterparty_27,24256058.2,,
2025-04-18,147.08,tax_payment,out,Counterparty_30,24255911.12,2025-03-11,2025-04-09
2025-04-18,116.8,rent,out,Counterparty_77,24255794.32,2025-03-14,2025-04-20
2025-04-18,5721.57,credit,in,Counterparty_79,24261515.89,,
2025-04-18,1868.04,payroll,out,Counterparty_95,24259647.85,2025-03-19,2025-04-26
2025-04-18,1395.04,refund,in,Counterparty_80,24261042.89,,
2025-04-18,4410.75,asset_sale,in,Counterparty_57,24265453.64,,
2025-04-18,10743.76,refund,in,Counterparty_63,24276197.4,,
2025-04-18,12808.11,payroll,out,Counterparty_50,24263389.29,2025-03-23,2025-04-30
2025-04-18,1039.52,T&E,out,Counterparty_89,24262349.77,2025-03-07,2025-04-09
2025-04-18,233.39,rent,out,Counterparty_69,24262116.38,2025-03-26,2025-04-22
2025-04-18,949.75,marketing_spend,out,Counterparty_55,24261166.63,2025-03-15,2025-04-12
2025-04-18,9734.9,refund,in,Counterparty_45,24270901.53,,
2025-04-18,1001.68,loan_repayment,out,Counterparty_24,24269899.85,2025-03-20,2025-04-14
2025-04-18,2265.55,investment_income,in,Counterparty_84,24272165.4,,
2025-04-18,3494.47,investment_income,in,Counterparty_51,24275659.87,,
2025-04-18,8984.02,asset_sale,in,Counterparty_68,24284643.89,,
2025-04-18,3711.22,investment_income,in,Counterparty_80,24288355.11,,
2025-04-18,6366.76,utilities,out,Counterparty_51,24281988.35,2025-03-30,2025-05-03
2025-04-18,431.51,asset_sale,in,Counterparty_97,24282419.86,,
2025-04-18,3266.02,utilities,out,Counterparty_78,24279153.84,2025-03-20,2025-04-16
2025-04-18,4628.81,investment_income,in,Counterparty_62,24283782.65,,
2025-04-18,11581.36,investment_income,in,Counterparty_12,24295364.01,,
2025-04-18,5580.84,refund,in,Counterparty_72,24300944.85,,
2025-04-18,7063.74,refund,in,Counterparty_17,24308008.59,,
2025-04-18,12080.46,payroll,out,Counterparty_12,24295928.13,2025-03-14,2025-04-12
2025-04-18,3955.43,software_subscription,out,Counterparty_24,24291972.7,2025-03-19,2025-04-27
2025-04-18,6571.63,investment_income,in,Counterparty_16,24298544.33,,
2025-04-18,2495.97,investment_income,in,Counterparty_46,24301040.3,,
2025-04-18,2896.48,refund,in,Counterparty_37,24303936.78,,
2025-04-18,4140.02,credit,in,Counterparty_65,24308076.8,,
2025-04-19,11142.37,payroll,out,Counterparty_39,24296934.43,2025-03-15,2025-04-11
2025-04-19,6045.65,refund,in,Counterparty_63,24302980.08,,
2025-04-19,1360.83,refund,in,Counterparty_28,24304340.91,,
2025-04-19,3270.75,T&E,out,Counterparty_36,24301070.16,2025-04-02,2025-04-27
2025-04-19,5856.96,utilities,out,Counterparty_51,24295213.2,2025-03-22,2025-04-21
2025-04-19,1958.39,supplier_payment,out,Counterparty_15,24293254.81,2025-03-07,2025-04-11
2025-04-19,1302.77,utilities,out,Counterparty_41,24291952.04,2025-04-01,2025-05-07
2025-04-19,965.94,software_subscription,out,Counterparty_15,24290986.1,2025-03-17,2025-04-23
2025-04-19,12741.61,rent,out,Counterparty_10,24278244.49,2025-03-31,2025-05-04
2025-04-19,5780.97,marketing_spend,out,Counterparty_67,24272463.52,2025-03-30,2025-04-26
2025-04-19,1875.35,tax_payment,out,Counterparty_39,24270588.17,2025-03-11,2025-04-13
2025-04-19,4696.18,T&E,out,Counterparty_91,24265891.99,2025-04-04,2025-05-06
2025-04-19,2835.3,refund,in,Counterparty_38,24268727.29,,
2025-04-19,8982.76,customer_payment,in,Counterparty_43,24277710.05,,
2025-04-19,1848.19,T&E,out,Counterparty_94,24275861.86,2025-04-01,2025-05-05
2025-04-19,220.98,utilities,out,Counterparty_53,24275640.88,2025-03-19,2025-04-17
2025-04-19,67.75,customer_payment,in,Counterparty_13,24275708.63,,
2025-04-19,18422.3,refund,in,Counterparty_56,24294130.93,,
2025-04-19,3349.54,supplier_payment,out,Counterparty_95,24290781.39,2025-03-06,2025-04-08
2025-04-19,1501.47,supplier_payment,out,Counterparty_31,24289279.92,2025-03-20,2025-04-17
2025-04-19,15570.06,investment_income,in,Counterparty_95,24304849.98,,
2025-04-19,2069.7,software_subscription,out,Counterparty_57,24302780.28,2025-03-21,2025-04-27
2025-04-19,4461.52,payroll,out,Counterparty_26,24298318.76,2025-03-12,2025-04-14
2025-04-19,4772.41,customer_payment,in,Counterparty_18,24303091.17,,
2025-04-19,1795.64,credit,in,Counterparty_85,24304886.81,,
2025-04-19,2621.91,marketing_spend,out,Counterparty_46,24302264.9,2025-03-23,2025-04-28
2025-04-19,2742.47,asset_sale,in,Counterparty_68,24305007.37,,
2025-04-19,5027.64,software_subscription,out,Counterparty_96,24299979.73,2025-03-31,2025-04-28
2025-04-19,1949.03,supplier_payment,out,Counterparty_3,24298030.7,2025-03-31,2025-04-27
2025-04-19,697.55,rent,out,Counterparty_70,24297333.15,2025-03-29,2025-04-23
2025-04-19,3113.1,credit,in,Counterparty_14,24300446.25,,
2025-04-19,13854.42,customer_payment,in,Counterparty_67,24314300.67,,
2025-04-19,3422.4,asset_sale,in,Counterparty_8,24317723.07,,
2025-04-19,8278.76,investment_income,in,Counterparty_68,24326001.83,,
2025-04-19,731.53,asset_sale,in,Counterparty_69,24326733.36,,
2025-04-19,1539.5,tax_payment,out,Counterparty_99,24325193.86,2025-03-20,2025-04-24
2025-04-19,6323.74,customer_payment,in,Counterparty_2,24331517.6,,
2025-04-19,563.28,software_subscription,out,Counterparty_59,24330954.32,2025-04-01,2025-04-27
2025-04-19,7666.42,asset_sale,in,Counterparty_90,24338620.74,,
2025-04-19,2153.76,payroll,out,Counterparty_75,24336466.98,2025-03-19,2025-04-17
2025-04-19,1754.99,investment_income,in,Counterparty_33,24338221.97,,
2025-04-19,114.66,utilities,out,Counterparty_15,24338107.31,2025-03-19,2025-04-25
2025-04-19,7980.0,investment_income,in,Counterparty_44,24346087.31,,
2025-04-19,1528.93,T&E,out,Counterparty_67,24344558.38,2025-03-24,2025-04-28
2025-04-19,849.71,investment_income,in,Counterparty_84,24345408.09,,
2025-04-19,2591.7,utilities,out,Counterparty_25,24342816.39,2025-03-31,2025-04-30
2025-04-19,3345.08,rent,out,Counterparty_73,24339471.31,2025-03-17,2025-04-22
2025-04-19,1062.28,customer_payment,in,Counterparty_17,24340533.59,,
2025-04-19,5226.37,customer_payment,in,Counterparty_46,24345759.96,,
2025-04-19,6015.79,payroll,out,Counterparty_29,24339744.17,2025-03-19,2025-04-25
2025-04-19,4735.8,utilities,out,Counterparty_94,24335008.37,2025-03-06,2025-04-13
2025-04-19,9293.23,customer_payment,in,Counterparty_85,24344301.6,,
2025-04-19,1274.22,customer_payment,in,Counterparty_80,24345575.82,,
2025-04-19,11664.81,investment_income,in,Counterparty_51,24357240.63,,
2025-04-19,1490.86,customer_payment,in,Counterparty_23,24358731.49,,
2025-04-19,1155.18,loan_repayment,out,Counterparty_46,24357576.31,2025-03-12,2025-04-15
2025-04-19,3909.08,supplier_payment,out,Counterparty_44,24353667.23,2025-04-01,2025-04-30
2025-04-20,2869.29,software_subscription,out,Counterparty_62,24350797.94,2025-04-03,2025-04-28
2025-04-20,877.25,T&E,out,Counterparty_1,24349920.69,2025-04-01,2025-05-03
2025-04-20,298.15,marketing_spend,out,Counterparty_21,24349622.54,2025-03-15,2025-04-10
2025-04-20,83.33,T&E,out,Counterparty_74,24349539.21,2025-03-27,2025-04-27
2025-04-20,1138.67,payroll,out,Counterparty_37,24348400.54,2025-03-07,2025-04-09
2025-04-20,721.47,supplier_payment,out,Counterparty_18,24347679.07,2025-03-20,2025-04-14
2025-04-20,1081.29,T&E,out,Counterparty_72,24346597.78,2025-03-15,2025-04-10
2025-04-20,2164.66,T&E,out,Counterparty_5,24344433.12,2025-03-13,2025-04-18
2025-04-20,3476.11,supplier_payment,out,Counterparty_62,24340957.01,2025-03-13,2025-04-16
2025-04-20,4425.04,payroll,out,Counterparty_91,24336531.97,2025-03-19,2025-04-26
2025-04-20,2805.13,rent,out,Counterparty_87,24333726.84,2025-03-18,2025-04-13
2025-04-20,2434.52,marketing_spend,out,Counterparty_54,24331292.32,2025-03-13,2025-04-08
2025-04-20,1266.88,payroll,out,Counterparty_87,24330025.44,2025-03-20,2025-04-23
2025-04-20,1225.71,software_subscription,out,Counterparty_17,24328799.73,2025-04-04,2025-05-01
2025-04-20,1778.53,utilities,out,Counterparty_63,24327021.2,2025-03-12,2025-04-07
2025-04-20,4059.82,loan_repayment,out,Counterparty_19,24322961.38,2025-03-21,2025-04-23
2025-04-20,3532.47,software_subscription,out,Counterparty_32,24319428.91,2025-03-15,2025-04-19
2025-04-20,11335.82,refund,in,Counterparty_49,24330764.73,,
2025-04-20,5206.0,investment_income,in,Counterparty_63,24335970.73,,
2025-04-20,1376.2,payroll,out,Counterparty_55,24334594.53,2025-03-22,2025-04-20
2025-04-20,6574.49,refund,in,Counterparty_26,24341169.02,,
2025-04-20,3300.08,refund,in,Counterparty_22,24344469.1,,
2025-04-20,2427.99,refund,in,Counterparty_43,24346897.09,,
2025-04-20,19.09,payroll,out,Counterparty_53,24346878.0,2025-04-01,2025-05-01
2025-04-20,7433.1,software_subscription,out,Counterparty_59,24339444.9,2025-03-23,2025-04-23
2025-04-20,29677.23,refund,in,Counterparty_66,24369122.13,,
2025-04-20,13866.99,asset_sale,in,Counterparty_25,24382989.12,,
2025-04-20,5282.56,refund,in,Counterparty_92,24388271.68,,
2025-04-20,2544.87,supplier_payment,out,Counterparty_30,24385726.81,2025-03-16,2025-04-16
2025-04-20,265.36,refund,in,Counterparty_83,24385992.17,,
2025-04-20,6374.78,credit,in,Counterparty_13,24392366.95,,
2025-04-20,4960.56,asset_sale,in,Counterparty_49,24397327.51,,
2025-04-20,6903.73,investment_income,in,Counterparty_64,24404231.24,,
2025-04-20,5776.69,customer_payment,in,Counterparty_18,24410007.93,,
2025-04-20,4090.35,customer_payment,in,Counterparty_38,24414098.28,,
2025-04-20,3766.68,loan_repayment,out,Counterparty_45,24410331.6,2025-03-13,2025-04-09
2025-04-20,591.46,asset_sale,in,Counterparty_29,24410923.06,,
2025-04-20,10454.53,refund,in,Counterparty_27,24421377.59,,
2025-04-20,68.57,investment_income,in,Counterparty_1,24421446.16,,
2025-04-20,558.81,customer_payment,in,Counterparty_72,24422004.97,,
2025-04-20,188.29,rent,out,Counterparty_30,24421816.68,2025-03-25,2025-04-21
2025-04-20,7113.59,credit,in,Counterparty_15,24428930.27,,
2025-04-20,16488.3,asset_sale,in,Counterparty_46,24445418.57,,
2025-04-20,2847.76,marketing_spend,out,Counterparty_39,24442570.81,2025-03-19,2025-04-14
2025-04-20,13000.1,investment_income,in,Counterparty_92,24455570.91,,
2025-04-20,3024.47,payroll,out,Counterparty_29,24452546.44,2025-03-26,2025-04-23
2025-04-20,2826.95,credit,in,Counterparty_6,24455373.39,,
2025-04-20,254.69,software_subscription,out,Counterparty_50,24455118.7,2025-03-29,2025-05-03
2025-04-20,1261.09,T&E,out,Counterparty_43,24453857.61,2025-03-25,2025-04-19
2025-04-20,7951.07,asset_sale,in,Counterparty_66,24461808.68,,
2025-04-20,1803.56,utilities,out,Counterparty_58,24460005.12,2025-03-23,2025-04-22
2025-04-20,3158.09,utilities,out,Counterparty_45,24456847.03,2025-03-28,2025-04-27
2025-04-20,1224.46,software_subscription,out,Counterparty_83,24455622.57,2025-03-29,2025-04-26
2025-04-20,7370.91,asset_sale,in,Counterparty_35,24462993.48,,
2025-04-20,24574.96,customer_payment,in,Counterparty_43,24487568.44,,
2025-04-20,9085.75,refund,in,Counterparty_46,24496654.19,,
2025-04-20,3606.82,rent,out,Counterparty_65,24493047.37,2025-03-11,2025-04-10
2025-04-20,7383.87,investment_income,in,Counterparty_32,24500431.24,,
2025-04-20,8944.76,utilities,out,Counterparty_44,24491486.48,2025-03-12,2025-04-14
2025-04-20,1230.31,marketing_spend,out,Counterparty_40,24490256.17,2025-03-28,2025-04-27
2025-04-20,5200.47,refund,in,Counterparty_87,24495456.64,,
2025-04-20,48.99,refund,in,Counterparty_6,24495505.63,,
2025-04-20,3088.66,customer_payment,in,Counterparty_90,24498594.29,,
2025-04-21,18467.26,investment_income,in,Counterparty_36,24517061.55,,
2025-04-21,9818.89,credit,in,Counterparty_86,24526880.44,,
2025-04-21,19651.0,customer_payment,in,Counterparty_38,24546531.44,,
2025-04-21,1323.68,investment_income,in,Counterparty_2,24547855.12,,
2025-04-21,1344.51,rent,out,Counterparty_72,24546510.61,2025-03-30,2025-05-03
2025-04-21,1398.76,asset_sale,in,Counterparty_58,24547909.37,,
2025-04-21,19601.73,marketing_spend,out,Counterparty_32,24528307.64,2025-04-05,2025-05-02
2025-04-21,1946.09,payroll,out,Counterparty_80,24526361.55,2025-04-02,2025-05-07
2025-04-21,4145.36,asset_sale,in,Counterparty_60,24530506.91,,
2025-04-21,5803.08,credit,in,Counterparty_80,24536309.99,,
2025-04-21,799.09,marketing_spend,out,Counterparty_90,24535510.9,2025-03-12,2025-04-17
2025-04-21,6247.62,credit,in,Counterparty_82,24541758.52,,
2025-04-21,1181.97,utilities,out,Counterparty_59,24540576.55,2025-04-02,2025-05-05
2025-04-21,6547.4,software_subscription,out,Counterparty_40,24534029.15,2025-03-18,2025-04-12
2025-04-21,1395.98,credit,in,Counterparty_35,24535425.13,,
2025-04-21,96.71,customer_payment,in,Counterparty_29,24535521.84,,
2025-04-21,9682.55,credit,in,Counterparty_16,24545204.39,,
2025-04-21,4027.63,credit,in,Counterparty_59,24549232.02,,
2025-04-21,8618.29,customer_payment,in,Counterparty_38,24557850.31,,
2025-04-21,5162.43,investment_income,in,Counterparty_65,24563012.74,,
2025-04-21,1236.82,refund,in,Counterparty_76,24564249.56,,
2025-04-21,5601.37,T&E,out,Counterparty_83,24558648.19,2025-04-04,2025-05-10
2025-04-21,20485.11,credit,in,Counterparty_78,24579133.3,,
2025-04-21,1049.96,refund,in,Counterparty_30,24580183.26,,
2025-04-21,736.85,customer_payment,in,Counterparty_74,24580920.11,,
2025-04-21,2825.28,credit,in,Counterparty_39,24583745.39,,
2025-04-21,1989.67,customer_payment,in,Counterparty_85,24585735.06,,
2025-04-21,2050.28,asset_sale,in,Counterparty_98,24587785.34,,
2025-04-21,2477.6,credit,in,Counterparty_49,24590262.94,,
2025-04-21,3480.35,asset_sale,in,Counterparty_17,24593743.29,,
2025-04-21,4555.88,asset_sale,in,Counterparty_10,24598299.17,,
2025-04-21,9851.4,refund,in,Counterparty_30,24608150.57,,
2025-04-21,8739.6,asset_sale,in,Counterparty_43,24616890.17,,
2025-04-21,749.5,loan_repayment,out,Counterparty_18,24616140.67,2025-04-01,2025-05-03
2025-04-21,703.42,tax_payment,out,Counterparty_88,24615437.25,2025-03-11,2025-04-14
2025-04-21,3610.28,customer_payment,in,Counterparty_94,24619047.53,,
2025-04-21,49.34,credit,in,Counterparty_29,24619096.87,,
2025-04-21,3869.64,software_subscription,out,Counterparty_19,24615227.23,2025-03-17,2025-04-25
2025-04-21,1107.28,payroll,out,Counterparty_5,24614119.95,2025-03-29,2025-04-30
2025-04-21,2325.18,tax_payment,out,Counterparty_67,24611794.77,2025-03-13,2025-04-12
2025-04-21,4297.51,credit,in,Counterparty_32,24616092.28,,
2025-04-21,14839.16,software_subscription,out,Counterparty_37,24601253.12,2025-03-20,2025-04-23
2025-04-21,15973.99,T&E,out,Counterparty_59,24585279.13,2025-04-05,2025-05-10
2025-04-21,11926.62,marketing_spend,out,Counterparty_40,24573352.51,2025-03-10,2025-04-18
2025-04-21,2329.61,customer_payment,in,Counterparty_88,24575682.12,,
2025-04-21,4285.52,supplier_payment,out,Counterparty_94,24571396.6,2025-03-28,2025-04-27
2025-04-21,36416.69,credit,in,Counterparty_1,24607813.29,,
2025-04-21,1604.43,refund,in,Counterparty_12,24609417.72,,
2025-04-21,5167.76,refund,in,Counterparty_32,24614585.48,,
2025-04-21,5134.29,tax_payment,out,Counterparty_67,24609451.19,2025-03-20,2025-04-14
2025-04-21,757.53,T&E,out,Counterparty_32,24608693.66,2025-03-26,2025-04-24
2025-04-21,1125.4,supplier_payment,out,Counterparty_68,24607568.26,2025-04-03,2025-05-08
2025-04-21,3991.6,rent,out,Counterparty_36,24603576.66,2025-04-05,2025-05-04
2025-04-21,4178.54,rent,out,Counterparty_20,24599398.12,2025-03-27,2025-04-29
2025-04-21,7289.38,tax_payment,out,Counterparty_34,24592108.74,2025-03-16,2025-04-14
2025-04-21,2417.18,refund,in,Counterparty_90,24594525.92,,
2025-04-21,1718.4,utilities,out,Counterparty_86,24592807.52,2025-03-25,2025-04-24
2025-04-21,1009.82,loan_repayment,out,Counterparty_7,24591797.7,2025-03-30,2025-04-27
2025-04-21,289.33,rent,out,Counterparty_89,24591508.37,2025-03-11,2025-04-15
2025-04-22,2486.7,customer_payment,in,Counterparty_41,24593995.07,,
2025-04-22,3059.99,customer_payment,in,Counterparty_68,24597055.06,,
2025-04-22,16144.85,asset_sale,in,Counterparty_70,24613199.91,,
2025-04-22,843.42,credit,in,Counterparty_40,24614043.33,,
2025-04-22,967.81,refund,in,Counterparty_26,24615011.14,,
2025-04-22,3138.59,utilities,out,Counterparty_5,24611872.55,2025-03-30,2025-05-08
2025-04-22,9436.91,customer_payment,in,Counterparty_89,24621309.46,,
2025-04-22,12140.21,refund,in,Counterparty_14,24633449.67,,
2025-04-22,4995.13,refund,in,Counterparty_8,24638444.8,,
2025-04-22,2439.17,loan_repayment,out,Counterparty_39,24636005.63,2025-03-09,2025-04-16
2025-04-22,558.22,loan_repayment,out,Counterparty_51,24635447.41,2025-03-23,2025-04-18
2025-04-22,2400.53,investment_income,in,Counterparty_51,24637847.94,,
2025-04-22,5006.97,customer_payment,in,Counterparty_48,24642854.91,,
2025-04-22,1121.04,tax_payment,out,Counterparty_59,24641733.87,2025-04-05,2025-05-10
2025-04-22,10278.53,utilities,out,Counterparty_9,24631455.34,2025-03-25,2025-04-29
2025-04-22,6842.89,refund,in,Counterparty_8,24638298.23,,
2025-04-22,9954.22,refund,in,Counterparty_98,24648252.45,,
2025-04-22,1038.72,T&E,out,Counterparty_71,24647213.73,2025-03-10,2025-04-15
2025-04-22,3760.94,software_subscription,out,Counterparty_72,24643452.79,2025-03-09,2025-04-06
2025-04-22,7132.1,refund,in,Counterparty_53,24650584.89,,
2025-04-22,6768.92,rent,out,Counterparty_78,24643815.97,2025-03-27,2025-05-01
2025-04-22,708.52,loan_repayment,out,Counterparty_41,24643107.45,2025-03-22,2025-04-19
2025-04-22,1965.97,payroll,out,Counterparty_9,24641141.48,2025-03-14,2025-04-09
2025-04-22,12193.31,rent,out,Counterparty_11,24628948.17,2025-03-18,2025-04-18
2025-04-22,22593.59,credit,in,Counterparty_50,24651541.76,,
2025-04-22,5788.88,refund,in,Counterparty_60,24657330.64,,
2025-04-22,2928.02,investment_income,in,Counterparty_28,24660258.66,,
2025-04-22,2788.78,software_subscription,out,Counterparty_68,24657469.88,2025-03-26,2025-04-23
2025-04-22,1138.85,software_subscription,out,Counterparty_49,24656331.03,2025-03-14,2025-04-13
2025-04-22,6834.5,asset_sale,in,Counterparty_11,24663165.53,,
2025-04-22,14010.09,credit,in,Counterparty_87,24677175.62,,
2025-04-22,397.34,software_subscription,out,Counterparty_79,24676778.28,2025-03-19,2025-04-23
2025-04-22,2141.57,loan_repayment,out,Counterparty_44,24674636.71,2025-03-12,2025-04-15
2025-04-22,4677.52,credit,in,Counterparty_54,24679314.23,,
2025-04-22,5603.68,tax_payment,out,Counterparty_39,24673710.55,2025-03-29,2025-05-02
2025-04-22,13618.38,utilities,out,Counterparty_15,24660092.17,2025-03-28,2025-04-25
2025-04-22,6363.01,asset_sale,in,Counterparty_67,24666455.18,,
2025-04-22,257.82,loan_repayment,out,Counterparty_41,24666197.36,2025-03-17,2025-04-24
2025-04-22,13770.75,payroll,out,Counterparty_51,24652426.61,2025-04-07,2025-05-10
2025-04-22,5156.42,credit,in,Counterparty_51,24657583.03,,
2025-04-22,3815.16,loan_repayment,out,Counterparty_57,24653767.87,2025-03-21,2025-04-29
2025-04-22,377.6,T&E,out,Counterparty_33,24653390.27,2025-04-02,2025-05-03
2025-04-22,2895.29,customer_payment,in,Counterparty_5,24656285.56,,
2025-04-22,1672.78,loan_repayment,out,Counterparty_51,24654612.78,2025-03-31,2025-04-26
2025-04-22,14081.57,T&E,out,Counterparty_95,24640531.21,2025-03-13,2025-04-09
2025-04-22,1984.03,refund,in,Counterparty_72,24642515.24,,
2025-04-22,2819.9,marketing_spend,out,Counterparty_59,24639695.34,2025-04-04,2025-05-07
2025-04-22,8467.44,investment_income,in,Counterparty_55,24648162.78,,
2025-04-22,3092.98,credit,in,Counterparty_40,24651255.76,,
2025-04-22,1918.85,marketing_spend,out,Counterparty_95,24649336.91,2025-03-16,2025-04-15
2025-04-22,1365.82,customer_payment,in,Counterparty_67,24650702.73,,
2025-04-22,408.0,tax_payment,out,Counterparty_57,24650294.73,2025-03-16,2025-04-14
2025-04-22,11173.61,refund,in,Counterparty_2,24661468.34,,
2025-04-22,675.67,supplier_payment,out,Counterparty_17,24660792.67,2025-03-17,2025-04-25
2025-04-22,10752.01,refund,in,Counterparty_36,24671544.68,,
2025-04-22,5288.34,asset_sale,in,Counterparty_38,24676833.02,,
2025-04-22,2342.58,customer_payment,in,Counterparty_48,24679175.6,,
2025-04-22,722.74,refund,in,Counterparty_53,24679898.34,,
2025-04-23,494.63,marketing_spend,out,Counterparty_86,24679403.71,2025-03-25,2025-04-30
2025-04-23,2683.31,asset_sale,in,Counterparty_50,24682087.02,,
2025-04-23,6366.14,refund,in,Counterparty_33,24688453.16,,
2025-04-23,12318.14,refund,in,Counterparty_77,24700771.3,,
2025-04-23,5442.53,asset_sale,in,Counterparty_65,24706213.83,,
2025-04-23,3853.96,credit,in,Counterparty_61,24710067.79,,
2025-04-23,4063.92,payroll,out,Counterparty_2,24706003.87,2025-03-22,2025-04-27
2025-04-23,17133.33,customer_payment,in,Counterparty_23,24723137.2,,
2025-04-23,6886.21,rent,out,Counterparty_60,24716250.99,2025-03-27,2025-04-27
2025-04-23,105.18,software_subscription,out,Counterparty_47,24716145.81,2025-03-24,2025-04-27
2025-04-23,4116.34,credit,in,Counterparty_25,24720262.15,,
2025-04-23,1048.08,investment_income,in,Counterparty_94,24721310.23,,
2025-04-23,261.85,refund,in,Counterparty_87,24721572.08,,
2025-04-23,9913.79,loan_repayment,out,Counterparty_63,24711658.29,2025-04-04,2025-05-07
2025-04-23,2226.02,utilities,out,Counterparty_80,24709432.27,2025-03-27,2025-04-25
2025-04-23,7345.47,asset_sale,in,Counterparty_19,24716777.74,,
2025-04-23,6466.3,tax_payment,out,Counterparty_71,24710311.44,2025-03-15,2025-04-16
2025-04-23,510.9,software_subscription,out,Counterparty_39,24709800.54,2025-04-01,2025-04-30
2025-04-23,4929.36,asset_sale,in,Counterparty_4,24714729.9,,
2025-04-23,12479.13,asset_sale,in,Counterparty_70,24727209.03,,
2025-04-23,1570.98,rent,out,Counterparty_11,24725638.05,2025-03-25,2025-05-03
2025-04-23,24.07,payroll,out,Counterparty_91,24725613.98,2025-03-18,2025-04-12
2025-04-23,965.5,tax_payment,out,Counterparty_7,24724648.48,2025-03-31,2025-05-08
2025-04-23,644.96,marketing_spend,out,Counterparty_28,24724003.52,2025-03-25,2025-04-20
2025-04-23,2436.0,investment_income,in,Counterparty_79,24726439.52,,
2025-04-23,1423.75,loan_repayment,out,Counterparty_84,24725015.77,2025-03-20,2025-04-16
2025-04-23,2197.49,payroll,out,Counterparty_73,24722818.28,2025-04-07,2025-05-16
2025-04-23,187.27,tax_payment,out,Counterparty_41,24722631.01,2025-03-16,2025-04-18
2025-04-23,1422.4,loan_repayment,out,Counterparty_4,24721208.61,2025-03-27,2025-04-22
2025-04-23,3198.91,customer_payment,in,Counterparty_92,24724407.52,,
2025-04-23,5872.55,software_subscription,out,Counterparty_9,24718534.97,2025-03-23,2025-04-27
2025-04-23,184.95,supplier_payment,out,Counterparty_84,24718350.02,2025-03-12,2025-04-10
2025-04-23,4663.43,supplier_payment,out,Counterparty_13,24713686.59,2025-03-17,2025-04-23
2025-04-23,77.59,tax_payment,out,Counterparty_44,24713609.0,2025-04-06,2025-05-06
2025-04-23,13772.2,software_subscription,out,Counterparty_18,24699836.8,2025-03-30,2025-05-05
2025-04-23,131.55,utilities,out,Counterparty_90,24699705.25,2025-03-16,2025-04-22
2025-04-23,1336.54,loan_repayment,out,Counterparty_26,24698368.71,2025-03-27,2025-05-02
2025-04-23,5007.35,marketing_spend,out,Counterparty_65,24693361.36,2025-03-23,2025-04-22
2025-04-23,4813.77,loan_repayment,out,Counterparty_51,24688547.59,2025-03-11,2025-04-15
2025-04-23,175.89,supplier_payment,out,Counterparty_70,24688371.7,2025-03-24,2025-04-18
2025-04-23,12062.57,investment_income,in,Counterparty_3,24700434.27,,
2025-04-23,9831.38,software_subscription,out,Counterparty_46,24690602.89,2025-04-02,2025-04-27
2025-04-23,1758.91,T&E,out,Counterparty_88,24688843.98,2025-03-13,2025-04-11
2025-04-23,3669.47,refund,in,Counterparty_27,24692513.45,,
2025-04-23,5106.76,asset_sale,in,Counterparty_88,24697620.21,,
2025-04-23,2568.52,payroll,out,Counterparty_95,24695051.69,2025-03-31,2025-05-02
2025-04-23,3693.93,customer_payment,in,Counterparty_94,24698745.62,,
2025-04-23,5889.31,supplier_payment,out,Counterparty_9,24692856.31,2025-03-21,2025-04-18
2025-04-23,28.34,rent,out,Counterparty_90,24692827.97,2025-03-18,2025-04-21
2025-04-23,12501.12,refund,in,Counterparty_30,24705329.09,,
2025-04-23,2149.26,utilities,out,Counterparty_61,24703179.83,2025-03-24,2025-04-23
2025-04-23,882.05,T&E,out,Counterparty_38,24702297.78,2025-04-08,2025-05-07
2025-04-23,2410.94,utilities,out,Counterparty_20,24699886.84,2025-04-03,2025-05-03
2025-04-23,373.52,credit,in,Counterparty_16,24700260.36,,
2025-04-23,3488.29,investment_income,in,Counterparty_51,24703748.65,,
2025-04-23,5080.08,marketing_spend,out,Counterparty_51,24698668.57,2025-03-25,2025-04-27
2025-04-23,6713.73,tax_payment,out,Counterparty_68,24691954.84,2025-03-13,2025-04-08
2025-04-23,7714.38,marketing_spend,out,Counterparty_30,24684240.46,2025-03-15,2025-04-22
2025-04-23,13324.59,payroll,out,Counterparty_24,24670915.87,2025-03-22,2025-04-25
2025-04-23,1774.95,refund,in,Counterparty_54,24672690.82,,
2025-04-24,3066.52,credit,in,Counterparty_91,24675757.34,,
2025-04-24,11800.18,customer_payment,in,Counterparty_44,24687557.52,,
2025-04-24,428.23,customer_payment,in,Counterparty_20,24687985.75,,
2025-04-24,3344.59,asset_sale,in,Counterparty_83,24691330.34,,
2025-04-24,7003.03,asset_sale,in,Counterparty_99,24698333.37,,
2025-04-24,1400.18,customer_payment,in,Counterparty_1,24699733.55,,
2025-04-24,7056.69,asset_sale,in,Counterparty_89,24706790.24,,
2025-04-24,14612.6,credit,in,Counterparty_91,24721402.84,,
2025-04-24,5199.71,payroll,out,Counterparty_31,24716203.13,2025-03-15,2025-04-15
2025-04-24,1213.77,asset_sale,in,Counterparty_78,24717416.9,,
2025-04-24,6692.64,customer_payment,in,Counterparty_41,24724109.54,,
2025-04-24,8233.99,investment_income,in,Counterparty_90,24732343.53,,
2025-04-24,728.28,investment_income,in,Counterparty_80,24733071.81,,
2025-04-24,12775.78,supplier_payment,out,Counterparty_17,24720296.03,2025-03-29,2025-04-29
2025-04-24,10095.51,T&E,out,Counterparty_2,24710200.52,2025-03-28,2025-04-23
2025-04-24,766.65,investment_income,in,Counterparty_32,24710967.17,,
2025-04-24,1108.03,tax_payment,out,Counterparty_26,24709859.14,2025-03-24,2025-04-26
2025-04-24,2807.36,tax_payment,out,Counterparty_64,24707051.78,2025-03-31,2025-05-05
2025-04-24,3768.04,investment_income,in,Counterparty_53,24710819.82,,
2025-04-24,14412.11,credit,in,Counterparty_76,24725231.93,,
2025-04-24,1265.41,investment_income,in,Counterparty_35,24726497.34,,
2025-04-24,2124.8,refund,in,Counterparty_18,24728622.14,,
2025-04-24,3110.22,credit,in,Counterparty_15,24731732.36,,
2025-04-24,2954.43,customer_payment,in,Counterparty_10,24734686.79,,
2025-04-24,5232.36,asset_sale,in,Counterparty_33,24739919.15,,
2025-04-24,7703.1,software_subscription,out,Counterparty_67,24732216.05,2025-04-03,2025-05-03
2025-04-24,3149.56,customer_payment,in,Counterparty_56,24735365.61,,
2025-04-24,3696.26,payroll,out,Counterparty_32,24731669.35,2025-03-11,2025-04-13
2025-04-24,1852.35,refund,in,Counterparty_41,24733521.7,,
2025-04-24,4304.36,payroll,out,Counterparty_93,24729217.34,2025-03-23,2025-04-25
2025-04-24,4134.91,customer_payment,in,Counterparty_32,24733352.25,,
2025-04-24,224.77,utilities,out,Counterparty_52,24733127.48,2025-03-29,2025-04-24
2025-04-24,800.96,investment_income,in,Counterparty_84,24733928.44,,
2025-04-24,515.59,T&E,out,Counterparty_45,24733412.85,2025-04-05,2025-05-05
2025-04-24,3394.24,credit,in,Counterparty_84,24736807.09,,
2025-04-24,4058.82,T&E,out,Counterparty_31,24732748.27,2025-04-06,2025-05-01
2025-04-24,1277.49,customer_payment,in,Counterparty_72,24734025.76,,
2025-04-24,1211.24,tax_payment,out,Counterparty_14,24732814.52,2025-03-29,2025-04-24
2025-04-24,2511.37,supplier_payment,out,Counterparty_26,24730303.15,2025-03-18,2025-04-21
2025-04-24,3539.49,asset_sale,in,Counterparty_41,24733842.64,,
2025-04-24,1132.23,tax_payment,out,Counterparty_39,24732710.41,2025-04-09,2025-05-10
2025-04-24,488.62,customer_payment,in,Counterparty_18,24733199.03,,
2025-04-24,2162.51,asset_sale,in,Counterparty_12,24735361.54,,
2025-04-24,4211.71,loan_repayment,out,Counterparty_29,24731149.83,2025-03-26,2025-04-27
2025-04-24,5291.95,refund,in,Counterparty_52,24736441.78,,
2025-04-24,3247.18,payroll,out,Counterparty_1,24733194.6,2025-03-15,2025-04-19
2025-04-24,1312.91,supplier_payment,out,Counterparty_93,24731881.69,2025-04-04,2025-05-10
2025-04-24,7231.78,refund,in,Counterparty_87,24739113.47,,
2025-04-24,4603.98,payroll,out,Counterparty_25,24734509.49,2025-03-25,2025-05-01
2025-04-24,2727.55,T&E,out,Counterparty_51,24731781.94,2025-04-03,2025-05-03
2025-04-24,1444.77,loan_repayment,out,Counterparty_90,24730337.17,2025-03-13,2025-04-19
2025-04-24,5180.54,supplier_payment,out,Counterparty_40,24725156.63,2025-03-27,2025-04-21
2025-04-24,6449.26,refund,in,Counterparty_2,24731605.89,,
2025-04-24,6987.54,customer_payment,in,Counterparty_12,24738593.43,,
2025-04-24,3852.76,loan_repayment,out,Counterparty_23,24734740.67,2025-03-26,2025-04-26
2025-04-24,2332.13,utilities,out,Counterparty_54,24732408.54,2025-04-04,2025-05-13
2025-04-24,812.59,rent,out,Counterparty_19,24731595.95,2025-04-03,2025-04-30
2025-04-24,5056.05,loan_repayment,out,Counterparty_28,24726539.9,2025-03-14,2025-04-21
2025-04-24,1785.83,rent,out,Counterparty_96,24724754.07,2025-03-20,2025-04-22
2025-04-24,3319.43,supplier_payment,out,Counterparty_47,24721434.64,2025-03-28,2025-04-28
2025-04-24,9904.84,T&E,out,Counterparty_1,24711529.8,2025-03-12,2025-04-08
2025-04-24,9968.22,utilities,out,Counterparty_22,24701561.58,2025-04-07,2025-05-10
2025-04-24,1296.97,loan_repayment,out,Counterparty_93,24700264.61,2025-03-29,2025-04-27
2025-04-24,124.23,customer_payment,in,Counterparty_38,24700388.84,,
2025-04-24,239.18,refund,in,Counterparty_34,24700628.02,,
2025-04-24,12211.89,marketing_spend,out,Counterparty_68,24688416.13,2025-03-13,2025-04-15
2025-04-24,5695.91,customer_payment,in,Counterparty_69,24694112.04,,
2025-04-24,11941.34,customer_payment,in,Counterparty_18,24706053.38,,
2025-04-24,2518.19,T&E,out,Counterparty_64,24703535.19,2025-03-14,2025-04-19
2025-04-25,2597.28,tax_payment,out,Counterparty_30,24700937.91,2025-03-19,2025-04-18
2025-04-25,207.32,software_subscription,out,Counterparty_28,24700730.59,2025-03-12,2025-04-09
2025-04-25,3110.37,marketing_spend,out,Counterparty_84,24697620.22,2025-03-20,2025-04-21
2025-04-25,5753.18,T&E,out,Counterparty_24,24691867.04,2025-03-15,2025-04-23
2025-04-25,5208.32,tax_payment,out,Counterparty_96,24686658.72,2025-03-15,2025-04-14
2025-04-25,5314.3,refund,in,Counterparty_21,24691973.02,,
2025-04-25,4905.28,software_subscription,out,Counterparty_83,24687067.74,2025-03-28,2025-04-25
2025-04-25,348.7,asset_sale,in,Counterparty_22,24687416.44,,
2025-04-25,3917.45,supplier_payment,out,Counterparty_58,24683498.99,2025-03-28,2025-04-22
2025-04-25,4289.81,payroll,out,Counterparty_62,24679209.18,2025-04-04,2025-05-04
2025-04-25,556.76,loan_repayment,out,Counterparty_30,24678652.42,2025-04-05,2025-05-07
2025-04-25,5526.43,asset_sale,in,Counterparty_91,24684178.85,,
2025-04-25,1328.89,loan_repayment,out,Counterparty_60,24682849.96,2025-04-06,2025-05-03
2025-04-25,127.27,T&E,out,Counterparty_47,24682722.69,2025-03-17,2025-04-18
2025-04-25,2151.38,credit,in,Counterparty_10,24684874.07,,
2025-04-25,1374.0,supplier_payment,out,Counterparty_38,24683500.07,2025-04-09,2025-05-07
2025-04-25,9123.83,marketing_spend,out,Counterparty_64,24674376.24,2025-04-03,2025-04-29
2025-04-25,2069.04,supplier_payment,out,Counterparty_30,24672307.2,2025-03-29,2025-04-26
2025-04-25,558.25,utilities,out,Counterparty_56,24671748.95,2025-03-13,2025-04-14
2025-04-25,776.57,payroll,out,Counterparty_57,24670972.38,2025-03-26,2025-04-22
2025-04-25,970.67,asset_sale,in,Counterparty_21,24671943.05,,
2025-04-25,8853.39,supplier_payment,out,Counterparty_66,24663089.66,2025-04-08,2025-05-04
2025-04-25,60.66,utilities,out,Counterparty_37,24663029.0,2025-04-07,2025-05-03
2025-04-25,1794.92,T&E,out,Counterparty_97,24661234.08,2025-03-23,2025-05-01
2025-04-25,1231.32,loan_repayment,out,Counterparty_90,24660002.76,2025-03-14,2025-04-22
2025-04-25,2465.11,rent,out,Counterparty_30,24657537.65,2025-03-22,2025-04-21
2025-04-25,2120.33,loan_repayment,out,Counterparty_60,24655417.32,2025-03-18,2025-04-20
2025-04-25,4029.58,tax_payment,out,Counterparty_36,24651387.74,2025-03-18,2025-04-14
2025-04-25,10907.78,refund,in,Counterparty_30,24662295.52,,
2025-04-25,551.9,tax_payment,out,Counterparty_87,24661743.62,2025-04-10,2025-05-08
2025-04-25,50.09,software_subscription,out,Counterparty_58,24661693.53,2025-04-08,2025-05-07
2025-04-25,3273.56,refund,in,Counterparty_72,24664967.09,,
2025-04-25,6155.94,investment_income,in,Counterparty_16,24671123.03,,
2025-04-25,4165.82,asset_sale,in,Counterparty_77,24675288.85,,
2025-04-25,4553.13,refund,in,Counterparty_41,24679841.98,,
2025-04-25,3675.52,customer_payment,in,Counterparty_99,24683517.5,,
2025-04-25,18391.18,investment_income,in,Counterparty_35,24701908.68,,
2025-04-25,1507.59,supplier_payment,out,Counterparty_55,24700401.09,2025-03-30,2025-04-29
2025-04-25,8564.98,rent,out,Counterparty_99,24691836.11,2025-03-22,2025-04-18
2025-04-25,4660.67,supplier_payment,out,Counterparty_81,24687175.44,2025-04-01,2025-05-07
2025-04-25,12613.46,refund,in,Counterparty_22,24699788.9,,
2025-04-25,913.06,credit,in,Counterparty_6,24700701.96,,
2025-04-25,5418.71,asset_sale,in,Counterparty_79,24706120.67,,
2025-04-25,1771.16,investment_income,in,Counterparty_92,24707891.83,,
2025-04-25,143.3,software_subscription,out,Counterparty_61,24707748.53,2025-04-01,2025-05-03
2025-04-25,6072.17,refund,in,Counterparty_38,24713820.7,,
2025-04-25,640.48,customer_payment,in,Counterparty_79,24714461.18,,
2025-04-25,777.39,credit,in,Counterparty_31,24715238.57,,
2025-04-25,1965.45,credit,in,Counterparty_88,24717204.02,,
2025-04-25,6893.55,refund,in,Counterparty_25,24724097.57,,
2025-04-25,6725.87,payroll,out,Counterparty_96,24717371.7,2025-03-31,2025-04-28
2025-04-25,383.87,customer_payment,in,Counterparty_29,24717755.57,,
2025-04-25,480.43,asset_sale,in,Counterparty_39,24718236.0,,
2025-04-25,510.27,investment_income,in,Counterparty_15,24718746.27,,
2025-04-26,3287.29,tax_payment,out,Counterparty_12,24715458.98,2025-03-19,2025-04-13
2025-04-26,4017.89,rent,out,Counterparty_22,24711441.09,2025-03-13,2025-04-13
2025-04-26,2965.84,supplier_payment,out,Counterparty_84,24708475.25,2025-03-21,2025-04-16
2025-04-26,2077.74,loan_repayment,out,Counterparty_12,24706397.51,2025-03-29,2025-05-03
2025-04-26,696.09,supplier_payment,out,Counterparty_12,24705701.42,2025-03-18,2025-04-17
2025-04-26,392.71,customer_payment,in,Counterparty_11,24706094.13,,
2025-04-26,5093.26,investment_income,in,Counterparty_91,24711187.39,,
2025-04-26,2351.74,tax_payment,out,Counterparty_6,24708835.65,2025-03-18,2025-04-26
2025-04-26,1313.66,marketing_spend,out,Counterparty_33,24707521.99,2025-03-15,2025-04-20
2025-04-26,11433.57,payroll,out,Counterparty_29,24696088.42,2025-03-19,2025-04-16
2025-04-26,5269.9,tax_payment,out,Counterparty_5,24690818.52,2025-04-08,2025-05-06
2025-04-26,3984.26,software_subscription,out,Counterparty_71,24686834.26,2025-03-24,2025-04-25
2025-04-26,481.56,supplier_payment,out,Counterparty_98,24686352.7,2025-04-10,2025-05-09
2025-04-26,23184.14,customer_payment,in,Counterparty_1,24709536.84,,
2025-04-26,248.5,software_subscription,out,Counterparty_46,24709288.34,2025-03-29,2025-04-26
2025-04-26,582.1,tax_payment,out,Counterparty_68,24708706.24,2025-03-17,2025-04-19
2025-04-26,1986.02,supplier_payment,out,Counterparty_46,24706720.22,2025-03-27,2025-04-30
2025-04-26,1001.6,marketing_spend,out,Counterparty_4,24705718.62,2025-03-28,2025-04-29
2025-04-26,1920.95,investment_income,in,Counterparty_13,24707639.57,,
2025-04-26,7316.91,asset_sale,in,Counterparty_15,24714956.48,,
2025-04-26,5906.95,customer_payment,in,Counterparty_13,24720863.43,,
2025-04-26,3896.95,customer_payment,in,Counterparty_78,24724760.38,,
2025-04-26,7461.92,asset_sale,in,Counterparty_72,24732222.3,,
2025-04-26,873.26,asset_sale,in,Counterparty_24,24733095.56,,
2025-04-26,6981.99,payroll,out,Counterparty_35,24726113.57,2025-03-31,2025-04-28
2025-04-26,4782.21,payroll,out,Counterparty_65,24721331.36,2025-04-11,2025-05-20
2025-04-26,4278.41,rent,out,Counterparty_91,24717052.95,2025-03-28,2025-04-30
2025-04-26,4189.9,refund,in,Counterparty_44,24721242.85,,
2025-04-26,914.01,T&E,out,Counterparty_61,24720328.84,2025-04-01,2025-04-27
2025-04-26,2605.52,utilities,out,Counterparty_64,24717723.32,2025-04-09,2025-05-07
2025-04-26,2935.81,T&E,out,Counterparty_73,24714787.51,2025-04-10,2025-05-11
2025-04-26,5299.78,refund,in,Counterparty_40,24720087.29,,
2025-04-26,15003.1,investment_income,in,Counterparty_93,24735090.39,,
2025-04-26,1023.72,utilities,out,Counterparty_35,24734066.67,2025-04-02,2025-05-10
2025-04-26,3175.17,payroll,out,Counterparty_61,24730891.5,2025-03-16,2025-04-11
2025-04-26,9389.18,asset_sale,in,Counterparty_28,24740280.68,,
2025-04-26,2637.17,supplier_payment,out,Counterparty_92,24737643.51,2025-03-28,2025-04-25
2025-04-26,2754.1,asset_sale,in,Counterparty_42,24740397.61,,
2025-04-26,8526.23,credit,in,Counterparty_68,24748923.84,,
2025-04-26,2923.3,refund,in,Counterparty_28,24751847.14,,
2025-04-26,352.14,software_subscription,out,Counterparty_66,24751495.0,2025-03-19,2025-04-16
2025-04-26,16546.69,loan_repayment,out,Counterparty_9,24734948.31,2025-03-31,2025-04-28
2025-04-26,658.2,software_subscription,out,Counterparty_5,24734290.11,2025-03-24,2025-04-20
2025-04-26,1471.33,investment_income,in,Counterparty_20,24735761.44,,
2025-04-26,1968.5,customer_payment,in,Counterparty_47,24737729.94,,
2025-04-26,5246.41,software_subscription,out,Counterparty_6,24732483.53,2025-04-06,2025-05-02
2025-04-26,4261.86,payroll,out,Counterparty_23,24728221.67,2025-03-23,2025-04-29
2025-04-26,1549.72,loan_repayment,out,Counterparty_59,24726671.95,2025-03-25,2025-04-20
2025-04-27,3641.06,software_subscription,out,Counterparty_70,24723030.89,2025-03-21,2025-04-19
2025-04-27,1992.4,loan_repayment,out,Counterparty_23,24721038.49,2025-04-06,2025-05-14
2025-04-27,302.22,software_subscription,out,Counterparty_51,24720736.27,2025-04-09,2025-05-15
2025-04-27,3952.64,software_subscription,out,Counterparty_69,24716783.63,2025-04-05,2025-05-04
2025-04-27,317.15,rent,out,Counterparty_31,24716466.48,2025-04-10,2025-05-19
2025-04-27,255.55,supplier_payment,out,Counterparty_94,24716210.93,2025-04-08,2025-05-13
2025-04-27,1620.71,marketing_spend,out,Counterparty_16,24714590.22,2025-04-03,2025-05-07
2025-04-27,751.28,utilities,out,Counterparty_25,24713838.94,2025-04-09,2025-05-17
2025-04-27,160.97,utilities,out,Counterparty_37,24713677.97,2025-04-07,2025-05-03
2025-04-27,5227.3,utilities,out,Counterparty_86,24708450.67,2025-03-26,2025-04-26
2025-04-27,692.12,rent,out,Counterparty_84,24707758.55,2025-03-25,2025-04-29
2025-04-27,2062.56,tax_payment,out,Counterparty_47,24705695.99,2025-03-30,2025-05-05
2025-04-27,1359.95,loan_repayment,out,Counterparty_97,24704336.04,2025-03-30,2025-04-26
2025-04-27,4852.73,customer_payment,in,Counterparty_61,24709188.77,,
2025-04-27,243.28,loan_repayment,out,Counterparty_64,24708945.49,2025-03-19,2025-04-21
2025-04-27,3393.62,asset_sale,in,Counterparty_13,24712339.11,,
2025-04-27,2051.5,rent,out,Counterparty_90,24710287.61,2025-03-18,2025-04-14
2025-04-27,2398.0,investment_income,in,Counterparty_27,24712685.61,,
2025-04-27,320.42,software_subscription,out,Counterparty_55,24712365.19,2025-03-19,2025-04-16
2025-04-27,737.47,refund,in,Counterparty_94,24713102.66,,
2025-04-27,24332.12,investment_income,in,Counterparty_22,24737434.78,,
2025-04-27,5389.59,customer_payment,in,Counterparty_14,24742824.37,,
2025-04-27,1544.66,utilities,out,Counterparty_78,24741279.71,2025-04-02,2025-05-05
2025-04-27,2007.67,credit,in,Counterparty_92,24743287.38,,
2025-04-27,11180.09,refund,in,Counterparty_50,24754467.47,,
2025-04-27,1209.4,T&E,out,Counterparty_30,24753258.07,2025-03-16,2025-04-22
2025-04-27,5500.38,T&E,out,Counterparty_65,24747757.69,2025-03-14,2025-04-11
2025-04-27,3685.66,supplier_payment,out,Counterparty_8,24744072.03,2025-03-20,2025-04-14
2025-04-27,3104.2,refund,in,Counterparty_94,24747176.23,,
2025-04-27,2456.91,tax_payment,out,Counterparty_91,24744719.32,2025-04-01,2025-05-06
2025-04-27,3861.42,marketing_spend,out,Counterparty_88,24740857.9,2025-03-19,2025-04-13
2025-04-27,443.46,rent,out,Counterparty_6,24740414.44,2025-03-23,2025-04-18
2025-04-27,6110.95,rent,out,Counterparty_30,24734303.49,2025-04-05,2025-05-02
2025-04-27,6526.62,credit,in,Counterparty_90,24740830.11,,
2025-04-27,382.02,utilities,out,Counterparty_99,24740448.09,2025-04-12,2025-05-16
2025-04-27,6992.24,payroll,out,Counterparty_22,24733455.85,2025-04-12,2025-05-17
2025-04-27,7432.3,supplier_payment,out,Counterparty_70,24726023.55,2025-03-21,2025-04-28
2025-04-27,3228.2,investment_income,in,Counterparty_5,24729251.75,,
2025-04-27,8176.08,supplier_payment,out,Counterparty_46,24721075.67,2025-03-15,2025-04-17
2025-04-27,3401.08,software_subscription,out,Counterparty_40,24717674.59,2025-04-01,2025-05-04
2025-04-27,325.54,supplier_payment,out,Counterparty_44,24717349.05,2025-03-25,2025-05-01
2025-04-27,1848.72,asset_sale,in,Counterparty_43,24719197.77,,
2025-04-27,1456.65,marketing_spend,out,Counterparty_36,24717741.12,2025-04-02,2025-05-11
2025-04-27,21.42,investment_income,in,Counterparty_18,24717762.54,,
2025-04-27,1457.03,credit,in,Counterparty_95,24719219.57,,
2025-04-27,1106.75,utilities,out,Counterparty_52,24718112.82,2025-04-11,2025-05-15
2025-04-27,2913.46,software_subscription,out,Counterparty_40,24715199.36,2025-03-31,2025-05-08
2025-04-27,122.66,credit,in,Counterparty_28,24715322.02,,
2025-04-27,20547.53,customer_payment,in,Counterparty_88,24735869.55,,
2025-04-27,360.01,refund,in,Counterparty_80,24736229.56,,
2025-04-27,5035.84,customer_payment,in,Counterparty_44,24741265.4,,
2025-04-27,2.89,payroll,out,Counterparty_22,24741262.51,2025-04-07,2025-05-09
2025-04-27,5088.46,credit,in,Counterparty_88,24746350.97,,
2025-04-27,8715.95,supplier_payment,out,Counterparty_74,24737635.02,2025-04-07,2025-05-05
2025-04-27,4476.62,tax_payment,out,Counterparty_69,24733158.4,2025-03-17,2025-04-19
2025-04-27,4294.27,refund,in,Counterparty_19,24737452.67,,
2025-04-27,1065.18,refund,in,Counterparty_19,24738517.85,,
2025-04-27,3764.15,T&E,out,Counterparty_31,24734753.7,2025-04-05,2025-05-13
2025-04-28,2905.1,payroll,out,Counterparty_88,24731848.6,2025-03-29,2025-05-05
2025-04-28,3089.55,refund,in,Counterparty_70,24734938.15,,
2025-04-28,5509.8,credit,in,Counterparty_10,24740447.95,,
2025-04-28,1767.98,investment_income,in,Counterparty_61,24742215.93,,
2025-04-28,587.11,payroll,out,Counterparty_10,24741628.82,2025-03-23,2025-04-17
2025-04-28,3334.01,utilities,out,Counterparty_98,24738294.81,2025-04-10,2025-05-16
2025-04-28,3631.11,supplier_payment,out,Counterparty_75,24734663.7,2025-04-07,2025-05-07
2025-04-28,421.75,customer_payment,in,Counterparty_91,24735085.45,,
2025-04-28,5374.99,refund,in,Counterparty_81,24740460.44,,
2025-04-28,15176.03,asset_sale,in,Counterparty_30,24755636.47,,
2025-04-28,1199.28,customer_payment,in,Counterparty_18,24756835.75,,
2025-04-28,5555.61,investment_income,in,Counterparty_95,24762391.36,,
2025-04-28,2672.89,refund,in,Counterparty_32,24765064.25,,
2025-04-28,2285.77,marketing_spend,out,Counterparty_91,24762778.48,2025-04-04,2025-05-05
2025-04-28,3658.35,asset_sale,in,Counterparty_19,24766436.83,,
2025-04-28,1404.13,marketing_spend,out,Counterparty_43,24765032.7,2025-03-21,2025-04-16
2025-04-28,14191.02,customer_payment,in,Counterparty_68,24779223.72,,
2025-04-28,2201.78,credit,in,Counterparty_39,24781425.5,,
2025-04-28,4413.05,customer_payment,in,Counterparty_93,24785838.55,,
2025-04-28,108.92,payroll,out,Counterparty_67,24785729.63,2025-04-11,2025-05-17
2025-04-28,550.22,supplier_payment,out,Counterparty_47,24785179.41,2025-04-01,2025-04-29
2025-04-28,4370.81,asset_sale,in,Counterparty_82,24789550.22,,
2025-04-28,1096.11,customer_payment,in,Counterparty_78,24790646.33,,
2025-04-28,3650.44,refund,in,Counterparty_72,24794296.77,,
2025-04-28,10813.58,investment_income,in,Counterparty_79,24805110.35,,
2025-04-28,2701.56,customer_payment,in,Counterparty_86,24807811.91,,
2025-04-28,1910.49,customer_payment,in,Counterparty_90,24809722.4,,
2025-04-28,26906.91,supplier_payment,out,Counterparty_90,24782815.49,2025-04-13,2025-05-13
2025-04-28,2380.19,utilities,out,Counterparty_75,24780435.3,2025-03-27,2025-04-25
2025-04-28,876.04,tax_payment,out,Counterparty_36,24779559.26,2025-04-06,2025-05-14
2025-04-28,2198.9,customer_payment,in,Counterparty_13,24781758.16,,
2025-04-28,3758.2,T&E,out,Counterparty_86,24777999.96,2025-04-08,2025-05-12
2025-04-28,487.7,customer_payment,in,Counterparty_26,24778487.66,,
2025-04-28,4373.73,investment_income,in,Counterparty_75,24782861.39,,
2025-04-28,15786.35,refund,in,Counterparty_84,24798647.74,,
2025-04-28,3855.25,utilities,out,Counterparty_27,24794792.49,2025-03-20,2025-04-22
2025-04-28,960.21,credit,in,Counterparty_66,24795752.7,,
2025-04-28,7756.77,supplier_payment,out,Counterparty_49,24787995.93,2025-03-21,2025-04-17
2025-04-28,1593.2,tax_payment,out,Counterparty_58,24786402.73,2025-04-01,2025-04-30
2025-04-28,2552.62,credit,in,Counterparty_10,24788955.35,,
2025-04-28,6407.67,rent,out,Counterparty_77,24782547.68,2025-03-15,2025-04-16
2025-04-28,2688.31,supplier_payment,out,Counterparty_28,24779859.37,2025-03-31,2025-05-09
2025-04-28,6193.36,investment_income,in,Counterparty_59,24786052.73,,
2025-04-28,2152.33,payroll,out,Counterparty_42,24783900.4,2025-03-25,2025-04-19
2025-04-28,1772.12,software_subscription,out,Counterparty_63,24782128.28,2025-03-21,2025-04-21
2025-04-29,10809.89,utilities,out,Counterparty_51,24771318.39,2025-03-21,2025-04-28
2025-04-29,424.66,asset_sale,in,Counterparty_65,24771743.05,,
2025-04-29,5977.49,marketing_spend,out,Counterparty_4,24765765.56,2025-04-09,2025-05-17
2025-04-29,3476.7,asset_sale,in,Counterparty_90,24769242.26,,
2025-04-29,3897.98,customer_payment,in,Counterparty_3,24773140.24,,
2025-04-29,4369.64,refund,in,Counterparty_83,24777509.88,,
2025-04-29,3202.27,asset_sale,in,Counterparty_70,24780712.15,,
2025-04-29,9393.06,rent,out,Counterparty_21,24771319.09,2025-04-05,2025-05-13
2025-04-29,3001.47,loan_repayment,out,Counterparty_57,24768317.62,2025-04-05,2025-05-13
2025-04-29,8141.87,credit,in,Counterparty_93,24776459.49,,
2025-04-29,10388.36,credit,in,Counterparty_45,24786847.85,,
2025-04-29,899.4,investment_income,in,Counterparty_10,24787747.25,,
2025-04-29,0.01,refund,in,Counterparty_65,24787747.26,,
2025-04-29,2017.17,supplier_payment,out,Counterparty_49,24785730.09,2025-03-26,2025-04-30
2025-04-29,3880.52,marketing_spend,out,Counterparty_61,24781849.57,2025-04-01,2025-05-04
2025-04-29,9724.52,refund,in,Counterparty_10,24791574.09,,
2025-04-29,2286.75,investment_income,in,Counterparty_89,24793860.84,,
2025-04-29,189.71,asset_sale,in,Counterparty_9,24794050.55,,
2025-04-29,10815.92,credit,in,Counterparty_94,24804866.47,,
2025-04-29,9765.93,supplier_payment,out,Counterparty_46,24795100.54,2025-03-30,2025-05-05
2025-04-29,4665.6,tax_payment,out,Counterparty_52,24790434.94,2025-03-19,2025-04-22
2025-04-29,1722.83,marketing_spend,out,Counterparty_29,24788712.11,2025-03-24,2025-04-29
2025-04-29,1241.87,credit,in,Counterparty_18,24789953.98,,
2025-04-29,5281.63,refund,in,Counterparty_83,24795235.61,,
2025-04-29,5417.92,T&E,out,Counterparty_74,24789817.69,2025-04-02,2025-05-07
2025-04-29,13.29,asset_sale,in,Counterparty_91,24789830.98,,
2025-04-29,424.56,T&E,out,Counterparty_73,24789406.42,2025-04-05,2025-05-13
2025-04-29,5695.52,tax_payment,out,Counterparty_96,24783710.9,2025-04-05,2025-05-10
2025-04-29,5934.25,payroll,out,Counterparty_28,24777776.65,2025-03-27,2025-04-30
2025-04-29,1518.91,rent,out,Counterparty_3,24776257.74,2025-04-09,2025-05-13
2025-04-29,4177.24,supplier_payment,out,Counterparty_11,24772080.5,2025-03-26,2025-04-23
2025-04-29,4934.75,utilities,out,Counterparty_21,24767145.75,2025-04-14,2025-05-18
2025-04-29,13687.88,asset_sale,in,Counterparty_83,24780833.63,,
2025-04-29,3053.89,rent,out,Counterparty_62,24777779.74,2025-03-21,2025-04-19
2025-04-29,1464.5,refund,in,Counterparty_42,24779244.24,,
2025-04-29,766.12,utilities,out,Counterparty_40,24778478.12,2025-04-12,2025-05-19
2025-04-29,218.98,T&E,out,Counterparty_25,24778259.14,2025-03-16,2025-04-15
2025-04-29,2685.11,loan_repayment,out,Counterparty_2,24775574.03,2025-03-16,2025-04-15
2025-04-29,1877.58,supplier_payment,out,Counterparty_36,24773696.45,2025-03-23,2025-04-28
2025-04-29,4694.7,supplier_payment,out,Counterparty_37,24769001.75,2025-04-13,2025-05-10
2025-04-29,2910.5,customer_payment,in,Counterparty_61,24771912.25,,
2025-04-29,4131.95,investment_income,in,Counterparty_70,24776044.2,,
2025-04-29,4859.85,supplier_payment,out,Counterparty_44,24771184.35,2025-03-29,2025-05-06
2025-04-29,15674.23,marketing_spend,out,Counterparty_67,24755510.12,2025-04-07,2025-05-13
2025-04-29,679.39,payroll,out,Counterparty_23,24754830.73,2025-03-27,2025-04-26
2025-04-29,759.66,marketing_spend,out,Counterparty_41,24754071.07,2025-03-22,2025-04-23
2025-04-29,9541.76,customer_payment,in,Counterparty_18,24763612.83,,
2025-04-29,1606.05,marketing_spend,out,Counterparty_57,24762006.78,2025-03-31,2025-04-26
2025-04-29,780.5,tax_payment,out,Counterparty_65,24761226.28,2025-03-31,2025-04-28
2025-04-29,385.99,supplier_payment,out,Counterparty_40,24760840.29,2025-03-20,2025-04-20
2025-04-30,5077.06,T&E,out,Counterparty_85,24755763.23,2025-03-29,2025-05-02
2025-04-30,458.01,marketing_spend,out,Counterparty_40,24755305.22,2025-04-12,2025-05-14
2025-04-30,150.36,refund,in,Counterparty_46,24755455.58,,
2025-04-30,2465.16,supplier_payment,out,Counterparty_54,24752990.42,2025-04-13,2025-05-18
2025-04-30,6781.46,customer_payment,in,Counterparty_24,24759771.88,,
2025-04-30,62.87,rent,out,Counterparty_68,24759709.01,2025-04-01,2025-05-03
2025-04-30,816.21,credit,in,Counterparty_9,24760525.22,,
2025-04-30,996.3,customer_payment,in,Counterparty_53,24761521.52,,
2025-04-30,1029.95,investment_income,in,Counterparty_87,24762551.47,,
2025-04-30,5037.61,refund,in,Counterparty_10,24767589.08,,
2025-04-30,5045.93,refund,in,Counterparty_94,24772635.01,,
2025-04-30,469.67,investment_income,in,Counterparty_66,24773104.68,,
2025-04-30,446.41,credit,in,Counterparty_8,24773551.09,,
2025-04-30,1671.63,asset_sale,in,Counterparty_29,24775222.72,,
2025-04-30,8932.94,refund,in,Counterparty_63,24784155.66,,
2025-04-30,3046.67,credit,in,Counterparty_9,24787202.33,,
2025-04-30,5829.06,payroll,out,Counterparty_41,24781373.27,2025-04-08,2025-05-14
2025-04-30,2506.73,marketing_spend,out,Counterparty_69,24778866.54,2025-03-21,2025-04-23
2025-04-30,3249.69,software_subscription,out,Counterparty_37,24775616.85,2025-03-27,2025-04-25
2025-04-30,11.7,software_subscription,out,Counterparty_95,24775605.15,2025-04-14,2025-05-15
2025-04-30,7986.86,utilities,out,Counterparty_29,24767618.29,2025-03-19,2025-04-17
2025-04-30,3991.82,marketing_spend,out,Counterparty_32,24763626.47,2025-03-26,2025-05-03
2025-04-30,2180.41,rent,out,Counterparty_65,24761446.06,2025-03-27,2025-04-27
2025-04-30,6115.07,software_subscription,out,Counterparty_21,24755330.99,2025-04-06,2025-05-15
2025-04-30,12368.14,marketing_spend,out,Counterparty_81,24742962.85,2025-04-09,2025-05-17
2025-04-30,2916.26,supplier_payment,out,Counterparty_86,24740046.59,2025-04-04,2025-05-04
2025-04-30,5873.67,software_subscription,out,Counterparty_78,24734172.92,2025-03-28,2025-05-02
2025-04-30,1407.76,loan_repayment,out,Counterparty_39,24732765.16,2025-03-29,2025-05-02
2025-04-30,940.16,utilities,out,Counterparty_20,24731825.0,2025-03-19,2025-04-13
2025-04-30,1638.79,utilities,out,Counterparty_7,24730186.21,2025-04-09,2025-05-17
2025-04-30,933.02,payroll,out,Counterparty_60,24729253.19,2025-03-25,2025-04-19
2025-04-30,36.73,T&E,out,Counterparty_92,24729216.46,2025-04-03,2025-05-03
2025-04-30,77.19,payroll,out,Counterparty_68,24729139.27,2025-03-24,2025-04-23
2025-04-30,96.37,tax_payment,out,Counterparty_86,24729042.9,2025-04-10,2025-05-13
2025-04-30,651.01,tax_payment,out,Counterparty_98,24728391.89,2025-04-12,2025-05-16
2025-04-30,3854.87,rent,out,Counterparty_65,24724537.02,2025-03-25,2025-04-30
2025-04-30,1353.05,supplier_payment,out,Counterparty_40,24723183.97,2025-03-24,2025-04-29
2025-04-30,9950.73,loan_repayment,out,Counterparty_15,24713233.24,2025-03-21,2025-04-15
2025-04-30,3599.24,payroll,out,Counterparty_66,24709634.0,2025-04-11,2025-05-10
2025-04-30,851.38,loan_repayment,out,Counterparty_47,24708782.62,2025-03-20,2025-04-21
2025-04-30,1949.86,software_subscription,out,Counterparty_14,24706832.76,2025-04-07,2025-05-10
2025-04-30,3171.34,asset_sale,in,Counterparty_63,24710004.1,,
2025-04-30,8918.78,refund,in,Counterparty_99,24718922.88,,
2025-04-30,189.52,T&E,out,Counterparty_69,24718733.36,2025-04-15,2025-05-16
2025-04-30,11940.68,refund,in,Counterparty_6,24730674.04,,
2025-04-30,2931.46,refund,in,Counterparty_30,24733605.5,,
2025-04-30,5716.42,customer_payment,in,Counterparty_31,24739321.92,,
2025-04-30,5709.46,credit,in,Counterparty_90,24745031.38,,
2025-04-30,629.68,asset_sale,in,Counterparty_20,24745661.06,,
2025-04-30,4003.33,credit,in,Counterparty_48,24749664.39,,
2025-04-30,375.06,refund,in,Counterparty_86,24750039.45,,
2025-04-30,11058.03,credit,in,Counterparty_69,24761097.48,,
2025-04-30,5425.59,asset_sale,in,Counterparty_21,24766523.07,,
2025-04-30,2253.31,rent,out,Counterparty_57,24764269.76,2025-03-24,2025-04-27
2025-04-30,532.63,rent,out,Counterparty_64,24763737.13,2025-03-27,2025-05-03
2025-04-30,761.06,software_subscription,out,Counterparty_65,24762976.07,2025-04-06,2025-05-09
2025-04-30,392.5,software_subscription,out,Counterparty_38,24762583.57,2025-03-28,2025-04-28
2025-04-30,353.34,supplier_payment,out,Counterparty_82,24762230.23,2025-03-18,2025-04-26
2025-04-30,600.61,tax_payment,out,Counterparty_29,24761629.62,2025-04-07,2025-05-15
2025-04-30,3196.87,rent,out,Counterparty_46,24758432.75,2025-04-09,2025-05-04
2025-04-30,9462.26,investment_income,in,Counterparty_2,24767895.01,,
2025-04-30,3210.83,marketing_spend,out,Counterparty_95,24764684.18,2025-03-29,2025-04-28
2025-05-01,108.95,supplier_payment,out,Counterparty_77,24764575.23,2025-04-14,2025-05-16
2025-05-01,12772.66,tax_payment,out,Counterparty_86,24751802.57,2025-03-27,2025-05-04
2025-05-01,992.88,payroll,out,Counterparty_24,24750809.69,2025-04-07,2025-05-09
2025-05-01,1042.06,software_subscription,out,Counterparty_37,24749767.63,2025-04-14,2025-05-18
2025-05-01,22139.99,refund,in,Counterparty_94,24771907.62,,
2025-05-01,7397.44,credit,in,Counterparty_14,24779305.06,,
2025-05-01,10611.15,tax_payment,out,Counterparty_39,24768693.91,2025-03-27,2025-04-21
2025-05-01,3665.09,supplier_payment,out,Counterparty_10,24765028.82,2025-04-02,2025-05-07
2025-05-01,3866.31,customer_payment,in,Counterparty_63,24768895.13,,
2025-05-01,3585.04,software_subscription,out,Counterparty_76,24765310.09,2025-04-06,2025-05-07
2025-05-01,4534.42,refund,in,Counterparty_33,24769844.51,,
2025-05-01,3744.82,credit,in,Counterparty_26,24773589.33,,
2025-05-01,1671.64,T&E,out,Counterparty_12,24771917.69,2025-03-21,2025-04-17
2025-05-01,10713.07,asset_sale,in,Counterparty_40,24782630.76,,
2025-05-01,839.63,software_subscription,out,Counterparty_58,24781791.13,2025-03-20,2025-04-21
2025-05-01,468.91,marketing_spend,out,Counterparty_63,24781322.22,2025-04-07,2025-05-09
2025-05-01,1536.24,refund,in,Counterparty_35,24782858.46,,
2025-05-01,858.7,loan_repayment,out,Counterparty_82,24781999.76,2025-03-26,2025-04-24
2025-05-01,20480.71,investment_income,in,Counterparty_95,24802480.47,,
2025-05-01,1077.76,loan_repayment,out,Counterparty_90,24801402.71,2025-03-25,2025-04-25
2025-05-01,8400.8,utilities,out,Counterparty_60,24793001.91,2025-03-22,2025-04-28
2025-05-01,10009.13,supplier_payment,out,Counterparty_56,24782992.78,2025-03-26,2025-04-22
2025-05-01,165.3,T&E,out,Counterparty_82,24782827.48,2025-03-31,2025-04-25
2025-05-01,6464.51,supplier_payment,out,Counterparty_21,24776362.97,2025-03-26,2025-04-25
2025-05-01,1547.24,tax_payment,out,Counterparty_58,24774815.73,2025-03-31,2025-04-30
2025-05-01,1829.04,tax_payment,out,Counterparty_97,24772986.69,2025-03-19,2025-04-27
2025-05-01,2403.31,loan_repayment,out,Counterparty_55,24770583.38,2025-03-23,2025-04-23
2025-05-01,594.4,supplier_payment,out,Counterparty_79,24769988.98,2025-03-28,2025-04-25
2025-05-01,238.3,refund,in,Counterparty_89,24770227.28,,
2025-05-01,2607.01,investment_income,in,Counterparty_93,24772834.29,,
2025-05-01,443.25,payroll,out,Counterparty_15,24772391.04,2025-04-03,2025-05-05
2025-05-01,1997.86,refund,in,Counterparty_5,24774388.9,,
2025-05-01,19893.11,refund,in,Counterparty_73,24794282.01,,
2025-05-01,2434.3,tax_payment,out,Counterparty_18,24791847.71,2025-03-25,2025-04-24
2025-05-01,2652.78,payroll,out,Counterparty_11,24789194.93,2025-04-09,2025-05-18
2025-05-01,402.88,loan_repayment,out,Counterparty_92,24788792.05,2025-04-15,2025-05-10
2025-05-01,260.93,refund,in,Counterparty_72,24789052.98,,
2025-05-01,4738.43,credit,in,Counterparty_82,24793791.41,,
2025-05-01,6022.65,customer_payment,in,Counterparty_26,24799814.06,,
2025-05-01,11497.83,credit,in,Counterparty_64,24811311.89,,
2025-05-01,1504.23,asset_sale,in,Counterparty_25,24812816.12,,
2025-05-01,206.62,asset_sale,in,Counterparty_66,24813022.74,,
2025-05-01,1960.49,customer_payment,in,Counterparty_56,24814983.23,,
2025-05-01,8964.2,investment_income,in,Counterparty_9,24823947.43,,
2025-05-01,6169.02,refund,in,Counterparty_98,24830116.45,,
2025-05-01,16649.26,investment_income,in,Counterparty_34,24846765.71,,
2025-05-01,4687.2,investment_income,in,Counterparty_9,24851452.91,,
2025-05-01,12008.13,loan_repayment,out,Counterparty_10,24839444.78,2025-04-14,2025-05-17
2025-05-01,19324.79,refund,in,Counterparty_4,24858769.57,,
2025-05-01,2840.27,investment_income,in,Counterparty_32,24861609.84,,
2025-05-01,5274.39,asset_sale,in,Counterparty_16,24866884.23,,
2025-05-01,6406.15,investment_income,in,Counterparty_60,24873290.38,,
2025-05-01,15218.96,asset_sale,in,Counterparty_55,24888509.34,,
2025-05-01,3628.56,credit,in,Counterparty_42,24892137.9,,
2025-05-01,5833.6,refund,in,Counterparty_29,24897971.5,,
2025-05-01,303.77,loan_repayment,out,Counterparty_60,24897667.73,2025-04-09,2025-05-12
2025-05-01,2077.29,investment_income,in,Counterparty_72,24899745.02,,
2025-05-01,7025.0,marketing_spend,out,Counterparty_28,24892720.02,2025-03-27,2025-04-26
2025-05-02,5254.25,customer_payment,in,Counterparty_30,24897974.27,,
2025-05-02,5279.77,rent,out,Counterparty_31,24892694.5,2025-04-14,2025-05-15
2025-05-02,6303.8,investment_income,in,Counterparty_75,24898998.3,,
2025-05-02,1981.44,refund,in,Counterparty_78,24900979.74,,
2025-05-02,6064.45,refund,in,Counterparty_56,24907044.19,,
2025-05-02,5851.16,tax_payment,out,Counterparty_19,24901193.03,2025-03-23,2025-04-29
2025-05-02,7387.98,tax_payment,out,Counterparty_61,24893805.05,2025-03-23,2025-04-24
2025-05-02,1267.12,refund,in,Counterparty_63,24895072.17,,
2025-05-02,136.56,rent,out,Counterparty_61,24894935.61,2025-04-12,2025-05-16
2025-05-02,4224.91,loan_repayment,out,Counterparty_10,24890710.7,2025-03-23,2025-04-18
2025-05-02,4092.42,software_subscription,out,Counterparty_57,24886618.28,2025-04-01,2025-05-02
2025-05-02,8357.38,customer_payment,in,Counterparty_96,24894975.66,,
2025-05-02,721.03,payroll,out,Counterparty_92,24894254.63,2025-04-03,2025-05-05
2025-05-02,5111.11,refund,in,Counterparty_84,24899365.74,,
2025-05-02,10671.63,supplier_payment,out,Counterparty_65,24888694.11,2025-04-03,2025-05-12
2025-05-02,3338.14,investment_income,in,Counterparty_28,24892032.25,,
2025-05-02,1524.44,investment_income,in,Counterparty_62,24893556.69,,
2025-05-02,33868.17,refund,in,Counterparty_91,24927424.86,,
2025-05-02,5285.91,rent,out,Counterparty_87,24922138.95,2025-03-27,2025-04-27
2025-05-02,4419.76,software_subscription,out,Counterparty_31,24917719.19,2025-03-29,2025-05-04
2025-05-02,3124.7,refund,in,Counterparty_73,24920843.89,,
2025-05-02,1350.58,loan_repayment,out,Counterparty_35,24919493.31,2025-04-16,2025-05-25
2025-05-02,10853.84,customer_payment,in,Counterparty_23,24930347.15,,
2025-05-02,5233.35,credit,in,Counterparty_4,24935580.5,,
2025-05-02,924.48,supplier_payment,out,Counterparty_94,24934656.02,2025-04-06,2025-05-06
2025-05-02,19936.68,customer_payment,in,Counterparty_47,24954592.7,,
2025-05-02,10125.67,customer_payment,in,Counterparty_81,24964718.37,,
2025-05-02,12610.36,customer_payment,in,Counterparty_51,24977328.73,,
2025-05-02,16.53,T&E,out,Counterparty_6,24977312.2,2025-04-06,2025-05-11
2025-05-02,646.49,asset_sale,in,Counterparty_43,24977958.69,,
2025-05-02,3655.97,customer_payment,in,Counterparty_67,24981614.66,,
2025-05-02,7601.82,investment_income,in,Counterparty_23,24989216.48,,
2025-05-02,4867.6,software_subscription,out,Counterparty_45,24984348.88,2025-04-09,2025-05-17
2025-05-02,3568.13,tax_payment,out,Counterparty_26,24980780.75,2025-03-22,2025-04-29
2025-05-02,7923.67,investment_income,in,Counterparty_52,24988704.42,,
2025-05-02,2726.13,credit,in,Counterparty_47,24991430.55,,
2025-05-02,1625.58,loan_repayment,out,Counterparty_17,24989804.97,2025-04-08,2025-05-04
2025-05-02,2531.91,supplier_payment,out,Counterparty_81,24987273.06,2025-03-29,2025-05-05
2025-05-02,2182.47,customer_payment,in,Counterparty_42,24989455.53,,
2025-05-02,11241.32,refund,in,Counterparty_72,25000696.85,,
2025-05-02,434.33,T&E,out,Counterparty_24,25000262.52,2025-03-31,2025-04-30
2025-05-02,1556.0,asset_sale,in,Counterparty_73,25001818.52,,
2025-05-02,1569.91,T&E,out,Counterparty_92,25000248.61,2025-03-19,2025-04-17
2025-05-02,3499.94,credit,in,Counterparty_82,25003748.55,,
2025-05-02,5141.27,tax_payment,out,Counterparty_16,24998607.28,2025-03-26,2025-04-23
2025-05-02,5503.76,rent,out,Counterparty_38,24993103.52,2025-03-27,2025-04-21
2025-05-02,2671.39,refund,in,Counterparty_85,24995774.91,,
2025-05-02,6166.11,refund,in,Counterparty_52,25001941.02,,
2025-05-02,601.06,payroll,out,Counterparty_32,25001339.96,2025-04-09,2025-05-17
2025-05-02,6916.29,refund,in,Counterparty_98,25008256.25,,
2025-05-02,2770.36,payroll,out,Counterparty_56,25005485.89,2025-03-27,2025-05-02
2025-05-02,1970.39,rent,out,Counterparty_70,25003515.5,2025-04-05,2025-05-02
2025-05-02,4227.12,asset_sale,in,Counterparty_74,25007742.62,,
2025-05-02,190.77,utilities,out,Counterparty_37,25007551.85,2025-04-09,2025-05-05
2025-05-02,14266.11,investment_income,in,Counterparty_55,25021817.96,,
2025-05-02,17177.57,refund,in,Counterparty_93,25038995.53,,
2025-05-02,1162.21,software_subscription,out,Counterparty_6,25037833.32,2025-04-04,2025-05-11
2025-05-02,234.85,supplier_payment,out,Counterparty_88,25037598.47,2025-04-09,2025-05-14
2025-05-02,1282.13,asset_sale,in,Counterparty_15,25038880.6,,
2025-05-02,1218.2,credit,in,Counterparty_81,25040098.8,,
2025-05-02,5.67,marketing_spend,out,Counterparty_75,25040093.13,2025-03-29,2025-05-01
2025-05-02,4236.34,marketing_spend,out,Counterparty_97,25035856.79,2025-04-04,2025-04-29
2025-05-02,58.08,supplier_payment,out,Counterparty_16,25035798.71,2025-03-29,2025-04-27
2025-05-02,4946.77,utilities,out,Counterparty_2,25030851.94,2025-03-23,2025-04-26
2025-05-02,1059.9,utilities,out,Counterparty_78,25029792.04,2025-03-30,2025-04-24
2025-05-02,3418.86,payroll,out,Counterparty_75,25026373.18,2025-03-20,2025-04-16
2025-05-02,10094.94,customer_payment,in,Counterparty_98,25036468.12,,
2025-05-03,384.52,software_subscription,out,Counterparty_67,25036083.6,2025-04-13,2025-05-14
2025-05-03,1021.18,customer_payment,in,Counterparty_46,25037104.78,,
2025-05-03,2253.51,investment_income,in,Counterparty_64,25039358.29,,
2025-05-03,3492.26,customer_payment,in,Counterparty_33,25042850.55,,
2025-05-03,3256.47,rent,out,Counterparty_31,25039594.08,2025-04-07,2025-05-04
2025-05-03,1756.28,asset_sale,in,Counterparty_76,25041350.36,,
2025-05-03,1733.56,payroll,out,Counterparty_77,25039616.8,2025-03-29,2025-04-29
2025-05-03,1906.88,tax_payment,out,Counterparty_22,25037709.92,2025-04-13,2025-05-16
2025-05-03,324.29,credit,in,Counterparty_25,25038034.21,,
2025-05-03,1274.58,marketing_spend,out,Counterparty_60,25036759.63,2025-04-07,2025-05-06
2025-05-03,5042.85,loan_repayment,out,Counterparty_73,25031716.78,2025-04-06,2025-05-06
2025-05-03,126.16,loan_repayment,out,Counterparty_61,25031590.62,2025-04-18,2025-05-25
2025-05-03,11219.77,investment_income,in,Counterparty_4,25042810.39,,
2025-05-03,882.32,payroll,out,Counterparty_31,25041928.07,2025-04-13,2025-05-20
2025-05-03,970.14,credit,in,Counterparty_52,25042898.21,,
2025-05-03,9737.39,credit,in,Counterparty_85,25052635.6,,
2025-05-03,2024.39,credit,in,Counterparty_39,25054659.99,,
2025-05-03,2491.74,marketing_spend,out,Counterparty_98,25052168.25,2025-04-13,2025-05-22
2025-05-03,190.57,marketing_spend,out,Counterparty_72,25051977.68,2025-04-04,2025-05-11
2025-05-03,5030.61,asset_sale,in,Counterparty_36,25057008.29,,
2025-05-03,4426.0,marketing_spend,out,Counterparty_37,25052582.29,2025-04-16,2025-05-19
2025-05-03,13140.89,credit,in,Counterparty_66,25065723.18,,
2025-05-03,9009.19,marketing_spend,out,Counterparty_64,25056713.99,2025-04-16,2025-05-13
2025-05-03,3723.47,supplier_payment,out,Counterparty_89,25052990.52,2025-04-14,2025-05-13
2025-05-03,10830.27,supplier_payment,out,Counterparty_63,25042160.25,2025-04-02,2025-05-02
2025-05-03,2349.62,rent,out,Counterparty_17,25039810.63,2025-04-14,2025-05-22
2025-05-03,11084.44,customer_payment,in,Counterparty_39,25050895.07,,
2025-05-03,5069.09,credit,in,Counterparty_30,25055964.16,,
2025-05-03,1509.22,investment_income,in,Counterparty_6,25057473.38,,
2025-05-03,2706.58,rent,out,Counterparty_51,25054766.8,2025-03-27,2025-04-29
2025-05-03,2086.95,T&E,out,Counterparty_33,25052679.85,2025-04-10,2025-05-08
2025-05-03,3169.22,credit,in,Counterparty_42,25055849.07,,
2025-05-03,4218.23,T&E,out,Counterparty_54,25051630.84,2025-04-13,2025-05-22
2025-05-03,406.54,utilities,out,Counterparty_45,25051224.3,2025-04-12,2025-05-20
2025-05-03,3244.7,software_subscription,out,Counterparty_36,25047979.6,2025-03-24,2025-04-25
2025-05-03,845.96,supplier_payment,out,Counterparty_18,25047133.64,2025-04-06,2025-05-08
2025-05-03,5630.19,software_subscription,out,Counterparty_90,25041503.45,2025-03-26,2025-04-20
2025-05-03,1625.97,tax_payment,out,Counterparty_17,25039877.48,2025-04-12,2025-05-14
2025-05-03,1266.3,T&E,out,Counterparty_27,25038611.18,2025-04-04,2025-04-29
2025-05-03,241.66,loan_repayment,out,Counterparty_29,25038369.52,2025-04-18,2025-05-16
2025-05-03,8942.4,refund,in,Counterparty_20,25047311.92,,
2025-05-03,1501.05,tax_payment,out,Counterparty_26,25045810.87,2025-03-27,2025-04-29
2025-05-03,3867.84,refund,in,Counterparty_30,25049678.71,,
2025-05-03,1690.5,credit,in,Counterparty_70,25051369.21,,
2025-05-03,1358.3,supplier_payment,out,Counterparty_91,25050010.91,2025-04-11,2025-05-08
2025-05-03,16004.23,T&E,out,Counterparty_27,25034006.68,2025-03-21,2025-04-24
2025-05-03,2195.15,refund,in,Counterparty_75,25036201.83,,
2025-05-03,15535.14,asset_sale,in,Counterparty_46,25051736.97,,
2025-05-03,46.35,utilities,out,Counterparty_41,25051690.62,2025-04-18,2025-05-20
2025-05-03,5753.79,rent,out,Counterparty_46,25045936.83,2025-03-23,2025-05-01
2025-05-03,143.8,asset_sale,in,Counterparty_16,25046080.63,,
2025-05-03,797.56,asset_sale,in,Counterparty_89,25046878.19,,
2025-05-03,12094.69,utilities,out,Counterparty_28,25034783.5,2025-04-16,2025-05-19
2025-05-03,3022.78,credit,in,Counterparty_71,25037806.28,,
2025-05-03,3803.53,supplier_payment,out,Counterparty_2,25034002.75,2025-04-17,2025-05-24
2025-05-04,6570.1,payroll,out,Counterparty_12,25027432.65,2025-03-28,2025-04-24
2025-05-04,1196.4,tax_payment,out,Counterparty_94,25026236.25,2025-04-03,2025-05-12
2025-05-04,3082.15,asset_sale,in,Counterparty_94,25029318.4,,
2025-05-04,606.74,marketing_spend,out,Counterparty_47,25028711.66,2025-03-28,2025-04-28
2025-05-04,2797.85,credit,in,Counterparty_20,25031509.51,,
2025-05-04,7976.58,investment_income,in,Counterparty_29,25039486.09,,
2025-05-04,6522.54,rent,out,Counterparty_19,25032963.55,2025-04-18,2025-05-18
2025-05-04,520.21,asset_sale,in,Counterparty_15,25033483.76,,
2025-05-04,1607.45,credit,in,Counterparty_25,25035091.21,,
2025-05-04,9188.51,asset_sale,in,Counterparty_75,25044279.72,,
2025-05-04,1745.57,payroll,out,Counterparty_41,25042534.15,2025-03-26,2025-04-27
2025-05-04,506.94,supplier_payment,out,Counterparty_91,25042027.21,2025-04-12,2025-05-13
2025-05-04,5010.17,refund,in,Counterparty_69,25047037.38,,
2025-05-04,6236.56,investment_income,in,Counterparty_34,25053273.94,,
2025-05-04,1310.82,loan_repayment,out,Counterparty_52,25051963.12,2025-03-25,2025-04-28
2025-05-04,5021.13,marketing_spend,out,Counterparty_32,25046941.99,2025-03-23,2025-04-21
2025-05-04,1434.73,rent,out,Counterparty_74,25045507.26,2025-03-21,2025-04-27
2025-05-04,1490.72,loan_repayment,out,Counterparty_29,25044016.54,2025-04-13,2025-05-18
2025-05-04,566.78,supplier_payment,out,Counterparty_50,25043449.76,2025-04-18,2025-05-25
2025-05-04,4565.62,marketing_spend,out,Counterparty_72,25038884.14,2025-03-27,2025-05-03
2025-05-04,6018.23,refund,in,Counterparty_9,25044902.37,,
2025-05-04,4136.7,marketing_spend,out,Counterparty_16,25040765.67,2025-04-02,2025-05-02
2025-05-04,60.47,credit,in,Counterparty_93,25040826.14,,
2025-05-04,16019.88,asset_sale,in,Counterparty_17,25056846.02,,
2025-05-04,1078.41,T&E,out,Counterparty_75,25055767.61,2025-04-10,2025-05-17
2025-05-04,1189.47,payroll,out,Counterparty_44,25054578.14,2025-03-24,2025-04-29
2025-05-04,8171.97,refund,in,Counterparty_46,25062750.11,,
2025-05-04,2886.54,tax_payment,out,Counterparty_57,25059863.57,2025-04-02,2025-05-10
2025-05-04,1232.51,rent,out,Counterparty_78,25058631.06,2025-03-23,2025-04-30
2025-05-04,3212.38,credit,in,Counterparty_51,25061843.44,,
2025-05-04,208.04,rent,out,Counterparty_79,25061635.4,2025-04-15,2025-05-13
2025-05-04,7204.27,tax_payment,out,Counterparty_73,25054431.13,2025-04-17,2025-05-23
2025-05-04,793.58,payroll,out,Counterparty_1,25053637.55,2025-03-27,2025-05-04
2025-05-04,853.38,loan_repayment,out,Counterparty_36,25052784.17,2025-03-25,2025-05-02
2025-05-04,2518.58,customer_payment,in,Counterparty_64,25055302.75,,
2025-05-04,458.31,utilities,out,Counterparty_10,25054844.44,2025-04-01,2025-05-06
2025-05-04,2599.71,tax_payment,out,Counterparty_29,25052244.73,2025-04-17,2025-05-25
2025-05-04,12588.15,software_subscription,out,Counterparty_15,25039656.58,2025-04-16,2025-05-17
2025-05-04,6511.24,loan_repayment,out,Counterparty_69,25033145.34,2025-03-28,2025-05-04
2025-05-04,2209.47,T&E,out,Counterparty_87,25030935.87,2025-04-06,2025-05-11
2025-05-04,141.49,payroll,out,Counterparty_20,25030794.38,2025-04-18,2025-05-19
2025-05-04,92.26,customer_payment,in,Counterparty_78,25030886.64,,
2025-05-04,2763.83,marketing_spend,out,Counterparty_22,25028122.81,2025-04-04,2025-05-03
2025-05-04,3801.09,credit,in,Counterparty_63,25031923.9,,
2025-05-04,178.46,loan_repayment,out,Counterparty_62,25031745.44,2025-03-29,2025-05-05
2025-05-04,3848.02,rent,out,Counterparty_44,25027897.42,2025-03-24,2025-04-21
2025-05-04,5339.67,tax_payment,out,Counterparty_83,25022557.75,2025-04-10,2025-05-15
2025-05-04,9097.54,customer_payment,in,Counterparty_47,25031655.29,,
2025-05-04,11973.92,investment_income,in,Counterparty_56,25043629.21,,
2025-05-04,3104.36,marketing_spend,out,Counterparty_49,25040524.85,2025-04-12,2025-05-13
2025-05-04,701.94,customer_payment,in,Counterparty_3,25041226.79,,
2025-05-04,837.91,asset_sale,in,Counterparty_11,25042064.7,,
2025-05-04,544.77,software_subscription,out,Counterparty_99,25041519.93,2025-04-18,2025-05-15
2025-05-04,4328.4,rent,out,Counterparty_5,25037191.53,2025-03-23,2025-05-01
2025-05-04,12226.41,customer_payment,in,Counterparty_8,25049417.94,,
2025-05-04,6326.64,customer_payment,in,Counterparty_51,25055744.58,,
2025-05-04,135.05,utilities,out,Counterparty_80,25055609.53,2025-04-19,2025-05-23
2025-05-04,5039.48,supplier_payment,out,Counterparty_52,25050570.05,2025-04-05,2025-05-13
2025-05-04,7020.42,utilities,out,Counterparty_70,25043549.63,2025-03-26,2025-04-26
2025-05-04,866.03,credit,in,Counterparty_36,25044415.66,,
2025-05-04,7886.42,refund,in,Counterparty_96,25052302.08,,
2025-05-04,7783.29,supplier_payment,out,Counterparty_43,25044518.79,2025-03-23,2025-05-01
2025-05-04,4111.65,loan_repayment,out,Counterparty_12,25040407.14,2025-04-17,2025-05-22
2025-05-04,1391.27,refund,in,Counterparty_19,25041798.41,,
2025-05-04,1065.33,marketing_spend,out,Counterparty_85,25040733.08,2025-03-21,2025-04-24
2025-05-04,604.06,supplier_payment,out,Counterparty_27,25040129.02,2025-04-04,2025-05-12
2025-05-05,5044.14,utilities,out,Counterparty_65,25035084.88,2025-04-18,2025-05-19
2025-05-05,7157.95,refund,in,Counterparty_27,25042242.83,,
2025-05-05,2817.25,loan_repayment,out,Counterparty_76,25039425.58,2025-04-19,2025-05-27
2025-05-05,1039.34,marketing_spend,out,Counterparty_97,25038386.24,2025-03-24,2025-04-23
2025-05-05,2506.98,payroll,out,Counterparty_15,25035879.26,2025-03-29,2025-05-02
2025-05-05,11258.4,refund,in,Counterparty_65,25047137.66,,
2025-05-05,681.75,investment_income,in,Counterparty_25,25047819.41,,
2025-05-05,7974.84,refund,in,Counterparty_55,25055794.25,,
2025-05-05,3825.76,loan_repayment,out,Counterparty_40,25051968.49,2025-04-05,2025-05-05
2025-05-05,968.91,customer_payment,in,Counterparty_79,25052937.4,,
2025-05-05,1337.07,credit,in,Counterparty_43,25054274.47,,
2025-05-05,214.81,tax_payment,out,Counterparty_43,25054059.66,2025-03-30,2025-05-06
2025-05-05,2286.3,payroll,out,Counterparty_24,25051773.36,2025-03-31,2025-05-02
2025-05-05,2590.55,marketing_spend,out,Counterparty_47,25049182.81,2025-04-14,2025-05-22
2025-05-05,2540.65,customer_payment,in,Counterparty_70,25051723.46,,
2025-05-05,3412.5,supplier_payment,out,Counterparty_94,25048310.96,2025-03-30,2025-04-30
2025-05-05,4524.7,utilities,out,Counterparty_84,25043786.26,2025-04-01,2025-05-05
2025-05-05,5822.34,tax_payment,out,Counterparty_51,25037963.92,2025-04-01,2025-05-06
2025-05-05,11414.54,credit,in,Counterparty_19,25049378.46,,
2025-05-05,6940.53,utilities,out,Counterparty_50,25042437.93,2025-04-08,2025-05-11
2025-05-05,3555.11,supplier_payment,out,Counterparty_81,25038882.82,2025-03-29,2025-04-28
2025-05-05,2412.99,T&E,out,Counterparty_4,25036469.83,2025-04-18,2025-05-24
2025-05-05,2071.7,loan_repayment,out,Counterparty_19,25034398.13,2025-04-07,2025-05-09
2025-05-05,3223.92,supplier_payment,out,Counterparty_98,25031174.21,2025-03-23,2025-04-27
2025-05-05,4323.6,tax_payment,out,Counterparty_13,25026850.61,2025-03-26,2025-04-23
2025-05-05,8657.48,refund,in,Counterparty_17,25035508.09,,
2025-05-05,5358.69,loan_repayment,out,Counterparty_11,25030149.4,2025-03-27,2025-04-29
2025-05-05,2291.85,loan_repayment,out,Counterparty_43,25027857.55,2025-04-20,2025-05-19
2025-05-05,3088.84,supplier_payment,out,Counterparty_82,25024768.71,2025-04-04,2025-05-12
2025-05-05,1725.03,marketing_spend,out,Counterparty_65,25023043.68,2025-04-02,2025-05-03
2025-05-05,7852.85,software_subscription,out,Counterparty_39,25015190.83,2025-04-06,2025-05-15
2025-05-05,4752.08,asset_sale,in,Counterparty_38,25019942.91,,
2025-05-05,2114.11,payroll,out,Counterparty_32,25017828.8,2025-04-15,2025-05-17
2025-05-05,2943.35,credit,in,Counterparty_57,25020772.15,,
2025-05-05,11792.05,customer_payment,in,Counterparty_22,25032564.2,,
2025-05-05,4017.7,asset_sale,in,Counterparty_16,25036581.9,,
2025-05-05,1054.5,refund,in,Counterparty_3,25037636.4,,
2025-05-05,1486.14,software_subscription,out,Counterparty_93,25036150.26,2025-03-22,2025-04-20
2025-05-05,1984.99,utilities,out,Counterparty_5,25034165.27,2025-03-23,2025-04-27
2025-05-05,2446.26,utilities,out,Counterparty_64,25031719.01,2025-04-14,2025-05-19
2025-05-05,6666.0,refund,in,Counterparty_18,25038385.01,,
2025-05-05,144.4,supplier_payment,out,Counterparty_84,25038240.61,2025-03-24,2025-04-20
2025-05-05,163.6,tax_payment,out,Counterparty_52,25038077.01,2025-03-22,2025-04-26
2025-05-05,9481.35,investment_income,in,Counterparty_57,25047558.36,,
2025-05-05,833.5,credit,in,Counterparty_79,25048391.86,,
2025-05-05,6072.32,credit,in,Counterparty_14,25054464.18,,
2025-05-05,703.25,refund,in,Counterparty_36,25055167.43,,
2025-05-05,6227.83,payroll,out,Counterparty_9,25048939.6,2025-04-02,2025-04-30
2025-05-05,5502.78,refund,in,Counterparty_42,25054442.38,,
2025-05-05,24339.4,asset_sale,in,Counterparty_36,25078781.78,,
2025-05-05,924.03,payroll,out,Counterparty_65,25077857.75,2025-04-08,2025-05-03
2025-05-05,2678.73,rent,out,Counterparty_70,25075179.02,2025-04-06,2025-05-14
2025-05-05,2594.7,credit,in,Counterparty_48,25077773.72,,
2025-05-05,395.94,tax_payment,out,Counterparty_13,25077377.78,2025-03-28,2025-04-27
2025-05-05,5445.16,payroll,out,Counterparty_80,25071932.62,2025-04-05,2025-05-03
2025-05-05,3056.84,asset_sale,in,Counterparty_75,25074989.46,,
2025-05-05,3799.45,refund,in,Counterparty_57,25078788.91,,
2025-05-05,119.55,rent,out,Counterparty_83,25078669.36,2025-04-01,2025-05-08
2025-05-05,17718.17,credit,in,Counterparty_36,25096387.53,,
2025-05-05,2915.15,marketing_spend,out,Counterparty_6,25093472.38,2025-04-20,2025-05-16
2025-05-05,2890.63,customer_payment,in,Counterparty_25,25096363.01,,
2025-05-05,3384.52,customer_payment,in,Counterparty_11,25099747.53,,
2025-05-05,3359.16,software_subscription,out,Counterparty_74,25096388.37,2025-03-22,2025-04-23
2025-05-05,1089.71,credit,in,Counterparty_77,25097478.08,,
2025-05-06,1212.52,asset_sale,in,Counterparty_69,25098690.6,,
2025-05-06,8224.2,credit,in,Counterparty_74,25106914.8,,
2025-05-06,1049.88,customer_payment,in,Counterparty_88,25107964.68,,
2025-05-06,4498.36,customer_payment,in,Counterparty_31,25112463.04,,
2025-05-06,21142.16,credit,in,Counterparty_39,25133605.2,,
2025-05-06,3693.82,investment_income,in,Counterparty_73,25137299.02,,
2025-05-06,8279.77,credit,in,Counterparty_81,25145578.79,,
2025-05-06,2316.8,marketing_spend,out,Counterparty_72,25143261.99,2025-04-21,2025-05-16
2025-05-06,9759.04,credit,in,Counterparty_6,25153021.03,,
2025-05-06,1004.58,T&E,out,Counterparty_34,25152016.45,2025-04-06,2025-05-01
2025-05-06,12106.23,rent,out,Counterparty_65,25139910.22,2025-04-21,2025-05-23
2025-05-06,132.22,software_subscription,out,Counterparty_25,25139778.0,2025-03-23,2025-04-25
2025-05-06,1568.52,utilities,out,Counterparty_61,25138209.48,2025-03-28,2025-04-29
2025-05-06,1507.94,payroll,out,Counterparty_83,25136701.54,2025-04-04,2025-05-01
2025-05-06,726.3,payroll,out,Counterparty_52,25135975.24,2025-04-15,2025-05-11
2025-05-06,1918.1,loan_repayment,out,Counterparty_94,25134057.14,2025-04-11,2025-05-07
2025-05-06,838.45,refund,in,Counterparty_47,25134895.59,,
2025-05-06,1467.28,supplier_payment,out,Counterparty_30,25133428.31,2025-03-30,2025-05-04
2025-05-06,4797.42,customer_payment,in,Counterparty_22,25138225.73,,
2025-05-06,3302.96,rent,out,Counterparty_28,25134922.77,2025-04-20,2025-05-15
2025-05-06,2044.14,marketing_spend,out,Counterparty_46,25132878.63,2025-04-14,2025-05-15
2025-05-06,20703.72,customer_payment,in,Counterparty_88,25153582.35,,
2025-05-06,11323.63,utilities,out,Counterparty_40,25142258.72,2025-04-05,2025-05-06
2025-05-06,1066.08,software_subscription,out,Counterparty_86,25141192.64,2025-04-20,2025-05-19
2025-05-06,17215.84,utilities,out,Counterparty_7,25123976.8,2025-04-14,2025-05-19
2025-05-06,4208.91,rent,out,Counterparty_32,25119767.89,2025-04-06,2025-05-05
2025-05-06,11532.21,investment_income,in,Counterparty_56,25131300.1,,
2025-05-06,451.78,tax_payment,out,Counterparty_77,25130848.32,2025-03-23,2025-04-18
2025-05-06,408.86,payroll,out,Counterparty_86,25130439.46,2025-04-13,2025-05-17
2025-05-06,2585.89,credit,in,Counterparty_94,25133025.35,,
2025-05-06,397.33,marketing_spend,out,Counterparty_20,25132628.02,2025-04-03,2025-05-02
2025-05-06,3037.81,software_subscription,out,Counterparty_12,25129590.21,2025-04-18,2025-05-22
2025-05-06,9645.25,refund,in,Counterparty_25,25139235.46,,
2025-05-06,7043.4,rent,out,Counterparty_52,25132192.06,2025-03-27,2025-04-22
2025-05-06,5774.56,T&E,out,Counterparty_3,25126417.5,2025-04-03,2025-04-30
2025-05-06,796.63,refund,in,Counterparty_50,25127214.13,,
2025-05-06,2076.04,customer_payment,in,Counterparty_66,25129290.17,,
2025-05-06,655.08,supplier_payment,out,Counterparty_55,25128635.09,2025-03-29,2025-04-27
2025-05-07,886.71,utilities,out,Counterparty_96,25127748.38,2025-03-26,2025-04-25
2025-05-07,5793.86,supplier_payment,out,Counterparty_94,25121954.52,2025-04-15,2025-05-12
2025-05-07,8407.39,refund,in,Counterparty_28,25130361.91,,
2025-05-07,276.66,supplier_payment,out,Counterparty_22,25130085.25,2025-04-15,2025-05-12
2025-05-07,377.75,customer_payment,in,Counterparty_95,25130463.0,,
2025-05-07,12852.43,asset_sale,in,Counterparty_88,25143315.43,,
2025-05-07,8431.24,customer_payment,in,Counterparty_40,25151746.67,,
2025-05-07,18163.98,utilities,out,Counterparty_25,25133582.69,2025-04-08,2025-05-12
2025-05-07,26.17,credit,in,Counterparty_5,25133608.86,,
2025-05-07,7621.77,investment_income,in,Counterparty_52,25141230.63,,
2025-05-07,1160.39,rent,out,Counterparty_29,25140070.24,2025-04-11,2025-05-09
2025-05-07,2950.77,payroll,out,Counterparty_48,25137119.47,2025-04-01,2025-05-07
2025-05-07,4785.21,credit,in,Counterparty_96,25141904.68,,
2025-05-07,321.77,investment_income,in,Counterparty_26,25142226.45,,
2025-05-07,1753.94,rent,out,Counterparty_59,25140472.51,2025-04-04,2025-05-10
2025-05-07,6041.44,utilities,out,Counterparty_44,25134431.07,2025-04-15,2025-05-21
2025-05-07,162.57,refund,in,Counterparty_2,25134593.64,,
2025-05-07,8238.61,asset_sale,in,Counterparty_54,25142832.25,,
2025-05-07,864.17,investment_income,in,Counterparty_25,25143696.42,,
2025-05-07,1109.22,refund,in,Counterparty_73,25144805.64,,
2025-05-07,597.19,marketing_spend,out,Counterparty_47,25144208.45,2025-03-30,2025-04-27
2025-05-07,5368.19,rent,out,Counterparty_5,25138840.26,2025-03-31,2025-04-27
2025-05-07,30.66,payroll,out,Counterparty_99,25138809.6,2025-04-19,2025-05-18
2025-05-07,1373.12,investment_income,in,Counterparty_49,25140182.72,,
2025-05-07,1518.17,credit,in,Counterparty_52,25141700.89,,
2025-05-07,1203.28,credit,in,Counterparty_82,25142904.17,,
2025-05-07,4992.98,tax_payment,out,Counterparty_63,25137911.19,2025-04-15,2025-05-11
2025-05-07,420.44,software_subscription,out,Counterparty_23,25137490.75,2025-04-16,2025-05-14
2025-05-07,6756.22,software_subscription,out,Counterparty_48,25130734.53,2025-04-19,2025-05-23
2025-05-07,1860.34,refund,in,Counterparty_78,25132594.87,,
2025-05-07,1801.49,software_subscription,out,Counterparty_30,25130793.38,2025-04-06,2025-05-14
2025-05-07,7355.9,refund,in,Counterparty_58,25138149.28,,
2025-05-07,911.68,T&E,out,Counterparty_60,25137237.6,2025-04-12,2025-05-16
2025-05-07,914.3,T&E,out,Counterparty_36,25136323.3,2025-04-13,2025-05-08
2025-05-07,1202.43,credit,in,Counterparty_3,25137525.73,,
2025-05-07,2268.5,supplier_payment,out,Counterparty_76,25135257.23,2025-04-02,2025-04-28
2025-05-07,5877.12,supplier_payment,out,Counterparty_48,25129380.11,2025-04-20,2025-05-18
2025-05-07,2766.71,payroll,out,Counterparty_55,25126613.4,2025-04-20,2025-05-17
2025-05-07,5903.26,investment_income,in,Counterparty_51,25132516.66,,
2025-05-07,1048.99,tax_payment,out,Counterparty_53,25131467.67,2025-04-16,2025-05-14
2025-05-07,7671.47,asset_sale,in,Counterparty_69,25139139.14,,
2025-05-07,2662.07,rent,out,Counterparty_75,25136477.07,2025-04-18,2025-05-23
2025-05-07,282.71,payroll,out,Counterparty_22,25136194.36,2025-04-05,2025-05-09
2025-05-07,3820.3,credit,in,Counterparty_40,25140014.66,,
2025-05-07,751.97,loan_repayment,out,Counterparty_21,25139262.69,2025-03-27,2025-04-21
2025-05-07,1607.16,payroll,out,Counterparty_60,25137655.53,2025-04-05,2025-05-04
2025-05-07,2280.82,marketing_spend,out,Counterparty_54,25135374.71,2025-04-03,2025-05-01
2025-05-07,215.83,rent,out,Counterparty_84,25135158.88,2025-04-16,2025-05-22
2025-05-07,1918.15,tax_payment,out,Counterparty_22,25133240.73,2025-04-13,2025-05-14
2025-05-07,3308.91,software_subscription,out,Counterparty_21,25129931.82,2025-04-22,2025-05-27
2025-05-07,217.17,refund,in,Counterparty_78,25130148.99,,
2025-05-07,6971.17,asset_sale,in,Counterparty_64,25137120.16,,
2025-05-07,1207.05,rent,out,Counterparty_63,25135913.11,2025-04-17,2025-05-25
2025-05-07,1224.1,supplier_payment,out,Counterparty_25,25134689.01,2025-04-06,2025-05-03
2025-05-07,3869.05,T&E,out,Counterparty_85,25130819.96,2025-03-30,2025-05-06
2025-05-07,2663.99,tax_payment,out,Counterparty_21,25128155.97,2025-04-06,2025-05-11
2025-05-08,8441.23,credit,in,Counterparty_18,25136597.2,,
2025-05-08,706.02,supplier_payment,out,Counterparty_90,25135891.18,2025-04-18,2025-05-13
2025-05-08,506.08,utilities,out,Counterparty_76,25135385.1,2025-03-29,2025-04-30
2025-05-08,606.1,investment_income,in,Counterparty_91,25135991.2,,
2025-05-08,5393.95,marketing_spend,out,Counterparty_7,25130597.25,2025-03-31,2025-05-03
2025-05-08,307.29,tax_payment,out,Counterparty_91,25130289.96,2025-03-31,2025-04-30
2025-05-08,688.39,payroll,out,Counterparty_37,25129601.57,2025-04-17,2025-05-22
2025-05-08,3796.17,payroll,out,Counterparty_53,25125805.4,2025-03-26,2025-05-02
2025-05-08,2266.62,software_subscription,out,Counterparty_7,25123538.78,2025-04-21,2025-05-29
2025-05-08,6934.29,tax_payment,out,Counterparty_98,25116604.49,2025-04-19,2025-05-14
2025-05-08,5488.58,payroll,out,Counterparty_11,25111115.91,2025-04-22,2025-05-22
2025-05-08,3662.49,marketing_spend,out,Counterparty_99,25107453.42,2025-04-09,2025-05-17
2025-05-08,18620.66,loan_repayment,out,Counterparty_20,25088832.76,2025-04-21,2025-05-26
2025-05-08,386.66,payroll,out,Counterparty_5,25088446.1,2025-04-06,2025-05-04
2025-05-08,2375.54,T&E,out,Counterparty_12,25086070.56,2025-03-31,2025-05-02
2025-05-08,608.42,supplier_payment,out,Counterparty_19,25085462.14,2025-04-16,2025-05-20
2025-05-08,480.77,utilities,out,Counterparty_51,25084981.37,2025-04-15,2025-05-11
2025-05-08,1425.74,rent,out,Counterparty_65,25083555.63,2025-04-03,2025-05-03
2025-05-08,1466.55,loan_repayment,out,Counterparty_78,25082089.08,2025-04-20,2025-05-15
2025-05-08,5809.63,utilities,out,Counterparty_84,25076279.45,2025-04-20,2025-05-17
2025-05-08,1920.13,utilities,out,Counterparty_1,25074359.32,2025-04-09,2025-05-04
2025-05-08,5012.28,rent,out,Counterparty_92,25069347.04,2025-04-10,2025-05-16
2025-05-08,29348.74,refund,in,Counterparty_22,25098695.78,,
2025-05-08,21355.14,refund,in,Counterparty_62,25120050.92,,
2025-05-08,6754.87,investment_income,in,Counterparty_83,25126805.79,,
2025-05-08,9371.33,investment_income,in,Counterparty_38,25136177.12,,
2025-05-08,0.14,marketing_spend,out,Counterparty_56,25136176.98,2025-04-03,2025-05-04
2025-05-08,2089.76,loan_repayment,out,Counterparty_57,25134087.22,2025-04-05,2025-05-01
2025-05-08,2509.88,loan_repayment,out,Counterparty_35,25131577.34,2025-03-30,2025-04-25
2025-05-08,217.27,T&E,out,Counterparty_22,25131360.07,2025-04-03,2025-05-08
2025-05-08,272.81,marketing_spend,out,Counterparty_65,25131087.26,2025-03-25,2025-05-03
2025-05-08,4145.41,utilities,out,Counterparty_61,25126941.85,2025-03-27,2025-04-29
2025-05-08,1932.62,loan_repayment,out,Counterparty_83,25125009.23,2025-04-19,2025-05-28
2025-05-08,1340.24,loan_repayment,out,Counterparty_36,25123668.99,2025-04-20,2025-05-29
2025-05-08,2648.31,payroll,out,Counterparty_48,25121020.68,2025-04-09,2025-05-10
2025-05-08,1673.53,rent,out,Counterparty_5,25119347.15,2025-04-21,2025-05-27
2025-05-08,7242.45,software_subscription,out,Counterparty_74,25112104.7,2025-03-29,2025-05-07
2025-05-08,3513.68,software_subscription,out,Counterparty_88,25108591.02,2025-04-06,2025-05-01
2025-05-08,2968.1,investment_income,in,Counterparty_83,25111559.12,,
2025-05-08,1233.9,customer_payment,in,Counterparty_17,25112793.02,,
2025-05-08,8711.19,asset_sale,in,Counterparty_66,25121504.21,,
2025-05-08,8966.5,investment_income,in,Counterparty_47,25130470.71,,
2025-05-08,15.93,credit,in,Counterparty_34,25130486.64,,
2025-05-08,358.31,asset_sale,in,Counterparty_46,25130844.95,,
2025-05-08,6844.92,credit,in,Counterparty_66,25137689.87,,
2025-05-08,4364.82,refund,in,Counterparty_36,25142054.69,,
2025-05-08,4641.38,customer_payment,in,Counterparty_5,25146696.07,,
2025-05-08,21561.16,asset_sale,in,Counterparty_17,25168257.23,,
2025-05-08,4226.66,credit,in,Counterparty_42,25172483.89,,
2025-05-08,1290.59,customer_payment,in,Counterparty_97,25173774.48,,
2025-05-08,4314.79,customer_payment,in,Counterparty_80,25178089.27,,
2025-05-09,15713.2,customer_payment,in,Counterparty_22,25193802.47,,
2025-05-09,764.85,marketing_spend,out,Counterparty_32,25193037.62,2025-04-04,2025-05-03
2025-05-09,1483.2,utilities,out,Counterparty_87,25191554.42,2025-04-10,2025-05-18
2025-05-09,2283.42,T&E,out,Counterparty_85,25189271.0,2025-03-26,2025-04-30
2025-05-09,12475.93,marketing_spend,out,Counterparty_73,25176795.07,2025-04-12,2025-05-19
2025-05-09,7829.85,supplier_payment,out,Counterparty_37,25168965.22,2025-04-14,2025-05-14
2025-05-09,21612.26,loan_repayment,out,Counterparty_56,25147352.96,2025-04-14,2025-05-19
2025-05-09,1915.82,rent,out,Counterparty_91,25145437.14,2025-04-02,2025-05-04
2025-05-09,856.97,utilities,out,Counterparty_23,25144580.17,2025-04-09,2025-05-13
2025-05-09,4159.23,software_subscription,out,Counterparty_11,25140420.94,2025-04-03,2025-05-04
2025-05-09,2952.4,payroll,out,Counterparty_2,25137468.54,2025-04-10,2025-05-07
2025-05-09,5082.2,customer_payment,in,Counterparty_39,25142550.74,,
2025-05-09,2289.86,utilities,out,Counterparty_61,25140260.88,2025-04-20,2025-05-24
2025-05-09,844.23,rent,out,Counterparty_35,25139416.65,2025-04-22,2025-05-18
2025-05-09,2302.41,refund,in,Counterparty_72,25141719.06,,
2025-05-09,2625.37,customer_payment,in,Counterparty_23,25144344.43,,
2025-05-09,5246.66,payroll,out,Counterparty_16,25139097.77,2025-04-23,2025-05-28
2025-05-09,664.47,loan_repayment,out,Counterparty_84,25138433.3,2025-03-28,2025-05-03
2025-05-09,2400.73,refund,in,Counterparty_44,25140834.03,,
2025-05-09,7540.94,asset_sale,in,Counterparty_18,25148374.97,,
2025-05-09,20057.4,asset_sale,in,Counterparty_95,25168432.37,,
2025-05-09,3470.39,rent,out,Counterparty_91,25164961.98,2025-04-14,2025-05-12
2025-05-09,10223.37,payroll,out,Counterparty_58,25154738.61,2025-04-07,2025-05-04
2025-05-09,735.87,tax_payment,out,Counterparty_44,25154002.74,2025-04-22,2025-05-28
2025-05-09,1865.4,asset_sale,in,Counterparty_60,25155868.14,,
2025-05-09,4555.44,refund,in,Counterparty_70,25160423.58,,
2025-05-09,2228.4,software_subscription,out,Counterparty_95,25158195.18,2025-04-18,2025-05-26
2025-05-09,7670.34,T&E,out,Counterparty_7,25150524.84,2025-03-27,2025-04-26
2025-05-09,18847.08,marketing_spend,out,Counterparty_32,25131677.76,2025-04-12,2025-05-12
2025-05-09,1752.93,T&E,out,Counterparty_74,25129924.83,2025-04-18,2025-05-13
2025-05-09,1067.32,investment_income,in,Counterparty_6,25130992.15,,
2025-05-09,8741.01,credit,in,Counterparty_55,25139733.16,,
2025-05-09,3121.51,tax_payment,out,Counterparty_19,25136611.65,2025-04-13,2025-05-08
2025-05-09,546.21,payroll,out,Counterparty_83,25136065.44,2025-03-29,2025-05-04
2025-05-09,2418.62,loan_repayment,out,Counterparty_50,25133646.82,2025-04-16,2025-05-23
2025-05-09,5400.37,tax_payment,out,Counterparty_98,25128246.45,2025-04-10,2025-05-13
2025-05-09,2302.57,investment_income,in,Counterparty_77,25130549.02,,
2025-05-09,404.16,tax_payment,out,Counterparty_91,25130144.86,2025-04-22,2025-05-18
2025-05-09,382.09,marketing_spend,out,Counterparty_27,25129762.77,2025-04-21,2025-05-26
2025-05-09,189.6,supplier_payment,out,Counterparty_5,25129573.17,2025-04-22,2025-05-29
2025-05-09,1048.4,software_subscription,out,Counterparty_99,25128524.77,2025-04-21,2025-05-18
2025-05-09,1168.17,credit,in,Counterparty_7,25129692.94,,
2025-05-09,2155.15,loan_repayment,out,Counterparty_41,25127537.79,2025-04-11,2025-05-13
2025-05-09,12836.57,investment_income,in,Counterparty_96,25140374.36,,
2025-05-09,23316.99,software_subscription,out,Counterparty_73,25117057.37,2025-04-05,2025-05-07
2025-05-09,385.88,rent,out,Counterparty_86,25116671.49,2025-04-05,2025-05-08
2025-05-09,3203.66,tax_payment,out,Counterparty_57,25113467.83,2025-04-05,2025-05-14
2025-05-09,2987.13,rent,out,Counterparty_84,25110480.7,2025-03-29,2025-04-24
2025-05-09,5846.87,tax_payment,out,Counterparty_37,25104633.83,2025-04-15,2025-05-23
2025-05-09,713.75,supplier_payment,out,Counterparty_82,25103920.08,2025-04-11,2025-05-14
2025-05-09,1312.61,marketing_spend,out,Counterparty_92,25102607.47,2025-03-28,2025-05-02
2025-05-09,8645.34,software_subscription,out,Counterparty_31,25093962.13,2025-04-13,2025-05-19
2025-05-09,3610.84,payroll,out,Counterparty_64,25090351.29,2025-04-09,2025-05-16
2025-05-10,279.5,loan_repayment,out,Counterparty_54,25090071.79,2025-04-20,2025-05-29
2025-05-10,1441.06,supplier_payment,out,Counterparty_77,25088630.73,2025-03-29,2025-05-06
2025-05-10,746.7,loan_repayment,out,Counterparty_10,25087884.03,2025-04-25,2025-05-20
2025-05-10,1817.75,supplier_payment,out,Counterparty_30,25086066.28,2025-04-18,2025-05-17
2025-05-10,1445.89,refund,in,Counterparty_95,25087512.17,,
2025-05-10,1732.47,rent,out,Counterparty_86,25085779.7,2025-04-15,2025-05-18
2025-05-10,748.93,payroll,out,Counterparty_50,25085030.77,2025-04-04,2025-05-07
2025-05-10,1559.31,asset_sale,in,Counterparty_42,25086590.08,,
2025-05-10,865.96,tax_payment,out,Counterparty_34,25085724.12,2025-04-20,2025-05-22
2025-05-10,4124.61,asset_sale,in,Counterparty_58,25089848.73,,
2025-05-10,7891.41,software_subscription,out,Counterparty_21,25081957.32,2025-04-23,2025-05-30
2025-05-10,2667.62,T&E,out,Counterparty_40,25079289.7,2025-04-12,2025-05-13
2025-05-10,1202.85,refund,in,Counterparty_6,25080492.55,,
2025-05-10,2547.08,T&E,out,Counterparty_86,25077945.47,2025-04-21,2025-05-22
2025-05-10,1877.74,loan_repayment,out,Counterparty_16,25076067.73,2025-03-31,2025-04-28
2025-05-10,1565.53,investment_income,in,Counterparty_37,25077633.26,,
2025-05-10,1791.58,T&E,out,Counterparty_73,25075841.68,2025-04-21,2025-05-20
2025-05-10,2078.12,payroll,out,Counterparty_89,25073763.56,2025-04-23,2025-05-24
2025-05-10,276.89,customer_payment,in,Counterparty_40,25074040.45,,
2025-05-10,6403.43,asset_sale,in,Counterparty_29,25080443.88,,
2025-05-10,2508.53,software_subscription,out,Counterparty_47,25077935.35,2025-03-28,2025-04-25
2025-05-10,7218.08,T&E,out,Counterparty_77,25070717.27,2025-04-04,2025-05-10
2025-05-10,1839.39,loan_repayment,out,Counterparty_65,25068877.88,2025-04-24,2025-05-24
2025-05-10,7269.13,refund,in,Counterparty_57,25076147.01,,
2025-05-10,1279.49,rent,out,Counterparty_6,25074867.52,2025-04-21,2025-05-30
2025-05-10,11038.88,customer_payment,in,Counterparty_24,25085906.4,,
2025-05-10,3729.83,credit,in,Counterparty_16,25089636.23,,
2025-05-10,2086.71,rent,out,Counterparty_98,25087549.52,2025-04-22,2025-05-19
2025-05-10,200.51,payroll,out,Counterparty_56,25087349.01,2025-04-24,2025-05-28
2025-05-10,5912.14,credit,in,Counterparty_1,25093261.15,,
2025-05-10,11274.47,rent,out,Counterparty_9,25081986.68,2025-04-24,2025-06-02
2025-05-10,4097.0,asset_sale,in,Counterparty_55,25086083.68,,
2025-05-10,422.52,tax_payment,out,Counterparty_87,25085661.16,2025-04-19,2025-05-28
2025-05-10,5903.43,marketing_spend,out,Counterparty_90,25079757.73,2025-04-05,2025-05-14
2025-05-10,247.19,tax_payment,out,Counterparty_84,25079510.54,2025-04-22,2025-05-17
2025-05-10,837.31,customer_payment,in,Counterparty_57,25080347.85,,
2025-05-10,10560.2,asset_sale,in,Counterparty_37,25090908.05,,
2025-05-10,5497.97,asset_sale,in,Counterparty_53,25096406.02,,
2025-05-10,13325.53,tax_payment,out,Counterparty_66,25083080.49,2025-04-15,2025-05-24
2025-05-10,3798.17,asset_sale,in,Counterparty_40,25086878.66,,
2025-05-10,5170.63,refund,in,Counterparty_93,25092049.29,,
2025-05-10,11203.56,credit,in,Counterparty_73,25103252.85,,
2025-05-10,398.25,investment_income,in,Counterparty_3,25103651.1,,
2025-05-10,3570.46,software_subscription,out,Counterparty_11,25100080.64,2025-04-15,2025-05-23
2025-05-10,1843.98,utilities,out,Counterparty_64,25098236.66,2025-04-22,2025-05-26
2025-05-10,756.47,credit,in,Counterparty_29,25098993.13,,
2025-05-10,1503.07,payroll,out,Counterparty_52,25097490.06,2025-03-28,2025-04-24
2025-05-10,4530.28,marketing_spend,out,Counterparty_80,25092959.78,2025-03-29,2025-04-25
2025-05-10,2819.45,T&E,out,Counterparty_42,25090140.33,2025-04-11,2025-05-07
2025-05-10,119.32,software_subscription,out,Counterparty_53,25090021.01,2025-04-15,2025-05-13
2025-05-10,2518.82,rent,out,Counterparty_21,25087502.19,2025-04-06,2025-05-02
2025-05-10,2482.68,customer_payment,in,Counterparty_27,25089984.87,,
2025-05-10,2773.42,software_subscription,out,Counterparty_96,25087211.45,2025-04-03,2025-04-28
2025-05-10,1175.54,credit,in,Counterparty_9,25088386.99,,
2025-05-10,2484.45,credit,in,Counterparty_27,25090871.44,,
2025-05-10,927.35,rent,out,Counterparty_42,25089944.09,2025-04-21,2025-05-30
2025-05-10,1976.54,utilities,out,Counterparty_65,25087967.55,2025-04-21,2025-05-27
2025-05-10,1574.8,investment_income,in,Counterparty_46,25089542.35,,
2025-05-10,4970.51,utilities,out,Counterparty_29,25084571.84,2025-04-18,2025-05-25
2025-05-10,4929.12,refund,in,Counterparty_72,25089500.96,,
2025-05-10,3828.57,asset_sale,in,Counterparty_44,25093329.53,,
2025-05-10,6739.18,investment_income,in,Counterparty_30,25100068.71,,
2025-05-10,1789.07,supplier_payment,out,Counterparty_42,25098279.64,2025-03-31,2025-05-02
2025-05-10,1353.73,supplier_payment,out,Counterparty_53,25096925.91,2025-04-07,2025-05-12
2025-05-10,21871.5,customer_payment,in,Counterparty_3,25118797.41,,
2025-05-10,2206.26,refund,in,Counterparty_78,25121003.67,,
2025-05-11,965.69,rent,out,Counterparty_39,25120037.98,2025-03-28,2025-05-06
2025-05-11,2858.32,asset_sale,in,Counterparty_2,25122896.3,,
2025-05-11,475.44,customer_payment,in,Counterparty_75,25123371.74,,
2025-05-11,10207.43,tax_payment,out,Counterparty_35,25113164.31,2025-03-29,2025-05-02
2025-05-11,3671.1,customer_payment,in,Counterparty_94,25116835.41,,
2025-05-11,1694.6,credit,in,Counterparty_5,25118530.01,,
2025-05-11,9113.61,rent,out,Counterparty_27,25109416.4,2025-04-17,2025-05-22
2025-05-11,1280.32,rent,out,Counterparty_20,25108136.08,2025-04-04,2025-05-03
2025-05-11,4204.97,rent,out,Counterparty_28,25103931.11,2025-04-18,2025-05-16
2025-05-11,2057.56,supplier_payment,out,Counterparty_3,25101873.55,2025-04-25,2025-05-28
2025-05-11,5138.19,investment_income,in,Counterparty_94,25107011.74,,
2025-05-11,20773.66,refund,in,Counterparty_43,25127785.4,,
2025-05-11,5263.13,credit,in,Counterparty_40,25133048.53,,
2025-05-11,755.64,software_subscription,out,Counterparty_70,25132292.89,2025-04-24,2025-05-25
2025-05-11,2320.2,tax_payment,out,Counterparty_43,25129972.69,2025-04-24,2025-05-19
2025-05-11,659.35,credit,in,Counterparty_72,25130632.04,,
2025-05-11,2582.61,utilities,out,Counterparty_78,25128049.43,2025-04-15,2025-05-17
2025-05-11,11240.96,refund,in,Counterparty_24,25139290.39,,
2025-05-11,3982.9,credit,in,Counterparty_87,25143273.29,,
2025-05-11,1757.7,loan_repayment,out,Counterparty_10,25141515.59,2025-04-25,2025-05-24
2025-05-11,5862.23,tax_payment,out,Counterparty_70,25135653.36,2025-04-10,2025-05-07
2025-05-11,1759.42,tax_payment,out,Counterparty_21,25133893.94,2025-04-17,2025-05-18
2025-05-11,2333.36,supplier_payment,out,Counterparty_64,25131560.58,2025-03-31,2025-04-30
2025-05-11,5424.21,tax_payment,out,Counterparty_18,25126136.37,2025-04-02,2025-04-30
2025-05-11,622.23,rent,out,Counterparty_49,25125514.14,2025-03-31,2025-04-26
2025-05-11,4445.77,investment_income,in,Counterparty_78,25129959.91,,
2025-05-11,2569.99,asset_sale,in,Counterparty_43,25132529.9,,
2025-05-11,611.6,marketing_spend,out,Counterparty_73,25131918.3,2025-04-06,2025-05-04
2025-05-11,1377.86,rent,out,Counterparty_11,25130540.44,2025-04-21,2025-05-21
2025-05-11,150.87,rent,out,Counterparty_8,25130389.57,2025-04-07,2025-05-11
2025-05-11,193.24,rent,out,Counterparty_80,25130196.33,2025-04-21,2025-05-18
2025-05-11,892.66,software_subscription,out,Counterparty_58,25129303.67,2025-04-17,2025-05-22
2025-05-11,1890.9,tax_payment,out,Counterparty_53,25127412.77,2025-04-26,2025-06-01
2025-05-11,2524.87,rent,out,Counterparty_94,25124887.9,2025-03-30,2025-04-28
2025-05-11,1772.7,T&E,out,Counterparty_64,25123115.2,2025-03-31,2025-05-01
2025-05-11,1734.48,rent,out,Counterparty_15,25121380.72,2025-04-04,2025-05-09
2025-05-11,2532.81,T&E,out,Counterparty_72,25118847.91,2025-04-04,2025-05-06
2025-05-11,2059.12,rent,out,Counterparty_94,25116788.79,2025-04-19,2025-05-19
2025-05-11,905.81,tax_payment,out,Counterparty_28,25115882.98,2025-04-08,2025-05-17
2025-05-11,4022.86,asset_sale,in,Counterparty_52,25119905.84,,
2025-05-11,7102.54,T&E,out,Counterparty_69,25112803.3,2025-04-18,2025-05-25
2025-05-11,2009.28,asset_sale,in,Counterparty_61,25114812.58,,
2025-05-11,4015.52,refund,in,Counterparty_4,25118828.1,,
2025-05-11,585.38,T&E,out,Counterparty_52,25118242.72,2025-04-19,2025-05-15
2025-05-11,10379.59,asset_sale,in,Counterparty_38,25128622.31,,
2025-05-11,1929.24,software_subscription,out,Counterparty_32,25126693.07,2025-04-20,2025-05-22
2025-05-11,4232.66,tax_payment,out,Counterparty_32,25122460.41,2025-04-03,2025-05-01
2025-05-12,1543.19,refund,in,Counterparty_8,25124003.6,,
2025-05-12,4957.78,investment_income,in,Counterparty_23,25128961.38,,
2025-05-12,7.72,refund,in,Counterparty_86,25128969.1,,
2025-05-12,4880.91,payroll,out,Counterparty_34,25124088.19,2025-04-01,2025-04-30
2025-05-12,502.65,supplier_payment,out,Counterparty_71,25123585.54,2025-04-16,2025-05-21
2025-05-12,29352.41,credit,in,Counterparty_68,25152937.95,,
2025-05-12,23322.25,customer_payment,in,Counterparty_99,25176260.2,,
2025-05-12,458.89,refund,in,Counterparty_34,25176719.09,,
2025-05-12,1110.29,utilities,out,Counterparty_95,25175608.8,2025-04-11,2025-05-19
2025-05-12,4302.83,tax_payment,out,Counterparty_67,25171305.97,2025-04-07,2025-05-02
2025-05-12,1062.8,rent,out,Counterparty_26,25170243.17,2025-04-07,2025-05-09
2025-05-12,3282.39,marketing_spend,out,Counterparty_38,25166960.78,2025-04-05,2025-05-07
2025-05-12,224.11,loan_repayment,out,Counterparty_65,25166736.67,2025-04-18,2025-05-22
2025-05-12,96.48,payroll,out,Counterparty_10,25166640.19,2025-04-19,2025-05-15
2025-05-12,6472.61,marketing_spend,out,Counterparty_44,25160167.58,2025-04-20,2025-05-25
2025-05-12,4643.16,payroll,out,Counterparty_13,25155524.42,2025-04-19,2025-05-16
2025-05-12,3246.99,T&E,out,Counterparty_48,25152277.43,2025-04-19,2025-05-25
2025-05-12,1924.14,credit,in,Counterparty_4,25154201.57,,
2025-05-12,9191.02,asset_sale,in,Counterparty_63,25163392.59,,
2025-05-12,1632.19,utilities,out,Counterparty_73,25161760.4,2025-04-08,2025-05-05
2025-05-12,2558.39,investment_income,in,Counterparty_69,25164318.79,,
2025-05-12,2784.69,marketing_spend,out,Counterparty_43,25161534.1,2025-04-09,2025-05-04
2025-05-12,533.87,asset_sale,in,Counterparty_99,25162067.97,,
2025-05-12,3807.64,rent,out,Counterparty_34,25158260.33,2025-04-22,2025-05-29
2025-05-12,2804.59,asset_sale,in,Counterparty_38,25161064.92,,
2025-05-12,825.55,payroll,out,Counterparty_91,25160239.37,2025-04-06,2025-05-12
2025-05-12,10646.55,asset_sale,in,Counterparty_13,25170885.92,,
2025-05-12,2108.23,asset_sale,in,Counterparty_7,25172994.15,,
2025-05-12,4392.6,rent,out,Counterparty_48,25168601.55,2025-04-12,2025-05-15
2025-05-12,3019.07,rent,out,Counterparty_87,25165582.48,2025-04-06,2025-05-05
2025-05-12,130.73,T&E,out,Counterparty_12,25165451.75,2025-03-29,2025-05-01
2025-05-12,342.11,T&E,out,Counterparty_86,25165109.64,2025-04-17,2025-05-17
2025-05-12,164.04,tax_payment,out,Counterparty_87,25164945.6,2025-04-08,2025-05-05
2025-05-12,18755.7,asset_sale,in,Counterparty_56,25183701.3,,
2025-05-12,1518.81,payroll,out,Counterparty_94,25182182.49,2025-03-29,2025-05-06
2025-05-12,2681.04,software_subscription,out,Counterparty_43,25179501.45,2025-04-11,2025-05-09
2025-05-12,9840.81,credit,in,Counterparty_48,25189342.26,,
2025-05-12,164.63,customer_payment,in,Counterparty_15,25189506.89,,
2025-05-12,5948.06,rent,out,Counterparty_99,25183558.83,2025-04-13,2025-05-16
2025-05-12,1890.22,payroll,out,Counterparty_48,25181668.61,2025-03-31,2025-05-05
2025-05-12,1228.5,payroll,out,Counterparty_2,25180440.11,2025-04-06,2025-05-15
2025-05-12,805.26,marketing_spend,out,Counterparty_21,25179634.85,2025-04-12,2025-05-12
2025-05-12,1498.02,tax_payment,out,Counterparty_72,25178136.83,2025-04-08,2025-05-10
2025-05-12,703.42,software_subscription,out,Counterparty_12,25177433.41,2025-04-03,2025-05-10
2025-05-12,3283.1,payroll,out,Counterparty_47,25174150.31,2025-04-11,2025-05-17
2025-05-12,24847.04,payroll,out,Counterparty_70,25149303.27,2025-04-02,2025-05-06
2025-05-12,12.31,loan_repayment,out,Counterparty_86,25149290.96,2025-04-06,2025-05-09
2025-05-12,16794.23,supplier_payment,out,Counterparty_2,25132496.73,2025-04-02,2025-04-29
2025-05-12,7616.99,customer_payment,in,Counterparty_57,25140113.72,,
2025-05-12,20526.23,investment_income,in,Counterparty_79,25160639.95,,
2025-05-12,98.25,investment_income,in,Counterparty_76,25160738.2,,
2025-05-12,1967.03,refund,in,Counterparty_42,25162705.23,,
2025-05-12,3551.04,credit,in,Counterparty_83,25166256.27,,
2025-05-12,771.7,investment_income,in,Counterparty_67,25167027.97,,
2025-05-12,14794.05,investment_income,in,Counterparty_39,25181822.02,,
2025-05-12,3035.22,credit,in,Counterparty_18,25184857.24,,
2025-05-12,12583.03,refund,in,Counterparty_89,25197440.27,,
2025-05-12,16508.01,asset_sale,in,Counterparty_51,25213948.28,,
2025-05-12,4996.38,investment_income,in,Counterparty_19,25218944.66,,
2025-05-12,9007.61,refund,in,Counterparty_86,25227952.27,,
2025-05-12,1846.57,supplier_payment,out,Counterparty_90,25226105.7,2025-03-29,2025-05-03
2025-05-12,4167.01,investment_income,in,Counterparty_18,25230272.71,,
2025-05-12,1957.71,software_subscription,out,Counterparty_5,25228315.0,2025-04-01,2025-05-07
2025-05-13,615.67,tax_payment,out,Counterparty_79,25227699.33,2025-04-04,2025-05-02
2025-05-13,1485.92,software_subscription,out,Counterparty_74,25226213.41,2025-04-09,2025-05-13
2025-05-13,3227.87,software_subscription,out,Counterparty_7,25222985.54,2025-04-20,2025-05-28
2025-05-13,2348.54,rent,out,Counterparty_89,25220637.0,2025-04-20,2025-05-25
2025-05-13,232.59,tax_payment,out,Counterparty_99,25220404.41,2025-04-24,2025-05-23
2025-05-13,1106.12,marketing_spend,out,Counterparty_40,25219298.29,2025-04-23,2025-05-30
2025-05-13,3463.31,investment_income,in,Counterparty_77,25222761.6,,
2025-05-13,3712.79,software_subscription,out,Counterparty_62,25219048.81,2025-04-15,2025-05-23
2025-05-13,4949.5,supplier_payment,out,Counterparty_74,25214099.31,2025-04-28,2025-06-02
2025-05-13,9431.3,marketing_spend,out,Counterparty_55,25204668.01,2025-03-31,2025-05-09
2025-05-13,2851.4,supplier_payment,out,Counterparty_84,25201816.61,2025-04-27,2025-06-03
2025-05-13,3384.9,utilities,out,Counterparty_57,25198431.71,2025-04-09,2025-05-10
2025-05-13,231.39,supplier_payment,out,Counterparty_18,25198200.32,2025-04-07,2025-05-11
2025-05-13,152.25,software_subscription,out,Counterparty_74,25198048.07,2025-04-09,2025-05-12
2025-05-13,3149.25,rent,out,Counterparty_67,25194898.82,2025-04-16,2025-05-15
2025-05-13,2168.43,tax_payment,out,Counterparty_37,25192730.39,2025-04-21,2025-05-27
2025-05-13,521.34,investment_income,in,Counterparty_49,25193251.73,,
2025-05-13,126.03,utilities,out,Counterparty_82,25193125.7,2025-04-14,2025-05-22
2025-05-13,1729.61,supplier_payment,out,Counterparty_2,25191396.09,2025-04-23,2025-05-22
2025-05-13,9313.54,asset_sale,in,Counterparty_67,25200709.63,,
2025-05-13,1778.57,investment_income,in,Counterparty_74,25202488.2,,
2025-05-13,9962.7,investment_income,in,Counterparty_49,25212450.9,,
2025-05-13,2342.52,marketing_spend,out,Counterparty_81,25210108.38,2025-04-04,2025-05-03
2025-05-13,7573.97,software_subscription,out,Counterparty_33,25202534.41,2025-04-05,2025-05-03
2025-05-13,620.25,refund,in,Counterparty_56,25203154.66,,
2025-05-13,2670.0,loan_repayment,out,Counterparty_2,25200484.66,2025-04-26,2025-06-03
2025-05-13,1841.03,marketing_spend,out,Counterparty_78,25198643.63,2025-04-28,2025-06-02
2025-05-13,2413.35,investment_income,in,Counterparty_6,25201056.98,,
2025-05-13,69.63,customer_payment,in,Counterparty_65,25201126.61,,
2025-05-13,1443.3,marketing_spend,out,Counterparty_50,25199683.31,2025-04-09,2025-05-05
2025-05-13,2286.48,supplier_payment,out,Counterparty_96,25197396.83,2025-04-14,2025-05-23
2025-05-13,789.43,loan_repayment,out,Counterparty_62,25196607.4,2025-04-04,2025-05-02
2025-05-13,1608.46,utilities,out,Counterparty_39,25194998.94,2025-04-14,2025-05-21
2025-05-13,3506.01,rent,out,Counterparty_45,25191492.93,2025-04-24,2025-05-19
2025-05-13,13484.16,investment_income,in,Counterparty_87,25204977.09,,
2025-05-13,2883.36,refund,in,Counterparty_94,25207860.45,,
2025-05-13,1211.86,customer_payment,in,Counterparty_38,25209072.31,,
2025-05-13,6250.24,supplier_payment,out,Counterparty_76,25202822.07,2025-04-10,2025-05-12
2025-05-13,1985.49,tax_payment,out,Counterparty_94,25200836.58,2025-04-14,2025-05-15
2025-05-13,2524.0,customer_payment,in,Counterparty_12,25203360.58,,
2025-05-13,5873.41,marketing_spend,out,Counterparty_36,25197487.17,2025-04-09,2025-05-11
2025-05-13,3912.26,customer_payment,in,Counterparty_95,25201399.43,,
2025-05-13,4389.0,investment_income,in,Counterparty_37,25205788.43,,
2025-05-13,334.41,tax_payment,out,Counterparty_92,25205454.02,2025-04-21,2025-05-21
2025-05-13,6791.58,marketing_spend,out,Counterparty_80,25198662.44,2025-04-19,2025-05-14
2025-05-13,823.3,software_subscription,out,Counterparty_85,25197839.14,2025-04-17,2025-05-12
2025-05-13,11410.76,payroll,out,Counterparty_66,25186428.38,2025-04-08,2025-05-16
2025-05-13,6124.22,credit,in,Counterparty_89,25192552.6,,
2025-05-13,472.05,utilities,out,Counterparty_68,25192080.55,2025-04-25,2025-06-01
2025-05-13,841.2,T&E,out,Counterparty_87,25191239.35,2025-04-01,2025-05-06
2025-05-13,579.03,investment_income,in,Counterparty_65,25191818.38,,
2025-05-13,3965.85,tax_payment,out,Counterparty_6,25187852.53,2025-04-24,2025-05-20
2025-05-13,7840.46,loan_repayment,out,Counterparty_15,25180012.07,2025-03-30,2025-05-06
2025-05-13,1656.23,credit,in,Counterparty_77,25181668.3,,
2025-05-13,2270.05,loan_repayment,out,Counterparty_13,25179398.25,2025-04-19,2025-05-21
2025-05-13,393.9,software_subscription,out,Counterparty_74,25179004.35,2025-04-14,2025-05-12
2025-05-13,5599.98,customer_payment,in,Counterparty_98,25184604.33,,
2025-05-13,3296.13,refund,in,Counterparty_20,25187900.46,,
2025-05-13,3628.31,refund,in,Counterparty_91,25191528.77,,
2025-05-13,3192.17,investment_income,in,Counterparty_15,25194720.94,,
2025-05-13,6241.17,refund,in,Counterparty_30,25200962.11,,
2025-05-14,3291.24,credit,in,Counterparty_87,25204253.35,,
2025-05-14,279.35,refund,in,Counterparty_34,25204532.7,,
2025-05-14,9829.05,credit,in,Counterparty_27,25214361.75,,
2025-05-14,3075.15,investment_income,in,Counterparty_61,25217436.9,,
2025-05-14,2605.54,customer_payment,in,Counterparty_58,25220042.44,,
2025-05-14,1989.08,rent,out,Counterparty_85,25218053.36,2025-04-19,2025-05-20
2025-05-14,7265.14,supplier_payment,out,Counterparty_71,25210788.22,2025-04-08,2025-05-14
2025-05-14,5639.16,asset_sale,in,Counterparty_40,25216427.38,,
2025-05-14,2336.25,payroll,out,Counterparty_28,25214091.13,2025-04-01,2025-05-01
2025-05-14,5300.22,refund,in,Counterparty_48,25219391.35,,
2025-05-14,2977.27,customer_payment,in,Counterparty_11,25222368.62,,
2025-05-14,4977.76,marketing_spend,out,Counterparty_11,25217390.86,2025-04-27,2025-05-22
2025-05-14,3297.71,utilities,out,Counterparty_4,25214093.15,2025-04-21,2025-05-27
2025-05-14,2015.96,utilities,out,Counterparty_33,25212077.19,2025-04-12,2025-05-12
2025-05-14,5908.76,payroll,out,Counterparty_40,25206168.43,2025-04-26,2025-06-01
2025-05-14,2784.38,payroll,out,Counterparty_23,25203384.05,2025-04-18,2025-05-23
2025-05-14,3583.24,loan_repayment,out,Counterparty_30,25199800.81,2025-04-17,2025-05-14
2025-05-14,28013.51,customer_payment,in,Counterparty_69,25227814.32,,
2025-05-14,3687.84,rent,out,Counterparty_76,25224126.48,2025-04-17,2025-05-25
2025-05-14,5808.82,customer_payment,in,Counterparty_43,25229935.3,,
2025-05-14,3257.08,refund,in,Counterparty_7,25233192.38,,
2025-05-14,1883.74,asset_sale,in,Counterparty_79,25235076.12,,
2025-05-14,2397.81,software_subscription,out,Counterparty_83,25232678.31,2025-04-16,2025-05-15
2025-05-14,7783.44,asset_sale,in,Counterparty_16,25240461.75,,
2025-05-14,8300.08,tax_payment,out,Counterparty_29,25232161.67,2025-04-19,2025-05-17
2025-05-14,16035.36,asset_sale,in,Counterparty_92,25248197.03,,
2025-05-14,1230.25,asset_sale,in,Counterparty_89,25249427.28,,
2025-05-14,6908.3,credit,in,Counterparty_57,25256335.58,,
2025-05-14,447.35,credit,in,Counterparty_54,25256782.93,,
2025-05-14,1329.98,credit,in,Counterparty_64,25258112.91,,
2025-05-14,7953.43,asset_sale,in,Counterparty_97,25266066.34,,
2025-05-14,698.31,customer_payment,in,Counterparty_81,25266764.65,,
2025-05-14,4737.12,asset_sale,in,Counterparty_48,25271501.77,,
2025-05-14,2809.68,credit,in,Counterparty_87,25274311.45,,
2025-05-14,4040.65,rent,out,Counterparty_88,25270270.8,2025-04-03,2025-05-10
2025-05-14,944.7,T&E,out,Counterparty_59,25269326.1,2025-04-07,2025-05-08
2025-05-14,2374.59,credit,in,Counterparty_50,25271700.69,,
2025-05-14,2441.0,supplier_payment,out,Counterparty_3,25269259.69,2025-04-04,2025-05-05
2025-05-14,7336.87,asset_sale,in,Counterparty_89,25276596.56,,
2025-05-14,1443.95,utilities,out,Counterparty_30,25275152.61,2025-04-28,2025-05-28
2025-05-14,5310.91,loan_repayment,out,Counterparty_67,25269841.7,2025-04-11,2025-05-16
2025-05-14,12.8,tax_payment,out,Counterparty_71,25269828.9,2025-04-20,2025-05-26
2025-05-14,3655.91,T&E,out,Counterparty_55,25266172.99,2025-04-07,2025-05-13
2025-05-14,4210.3,loan_repayment,out,Counterparty_9,25261962.69,2025-04-09,2025-05-16
2025-05-14,6000.97,investment_income,in,Counterparty_6,25267963.66,,
2025-05-14,20747.84,credit,in,Counterparty_10,25288711.5,,
2025-05-14,3711.51,asset_sale,in,Counterparty_93,25292423.01,,
2025-05-14,15331.13,loan_repayment,out,Counterparty_70,25277091.88,2025-04-21,2025-05-16
2025-05-14,9710.15,asset_sale,in,Counterparty_97,25286802.03,,
2025-05-14,1711.98,software_subscription,out,Counterparty_41,25285090.05,2025-04-29,2025-06-05
2025-05-14,2359.47,marketing_spend,out,Counterparty_65,25282730.58,2025-04-05,2025-05-02
2025-05-14,4574.44,customer_payment,in,Counterparty_43,25287305.02,,
2025-05-14,854.59,loan_repayment,out,Counterparty_31,25286450.43,2025-04-12,2025-05-16
2025-05-14,4475.05,investment_income,in,Counterparty_5,25290925.48,,
2025-05-14,5966.31,supplier_payment,out,Counterparty_73,25284959.17,2025-04-12,2025-05-07
2025-05-14,993.15,customer_payment,in,Counterparty_1,25285952.32,,
2025-05-14,491.12,loan_repayment,out,Counterparty_24,25285461.2,2025-04-07,2025-05-12
2025-05-14,1499.12,utilities,out,Counterparty_60,25283962.08,2025-04-12,2025-05-19
2025-05-14,2944.98,marketing_spend,out,Counterparty_23,25281017.1,2025-04-19,2025-05-18
2025-05-14,271.44,asset_sale,in,Counterparty_81,25281288.54,,
2025-05-14,13020.21,marketing_spend,out,Counterparty_69,25268268.33,2025-04-17,2025-05-19
2025-05-15,1528.27,software_subscription,out,Counterparty_30,25266740.06,2025-04-02,2025-04-30
2025-05-15,3539.82,tax_payment,out,Counterparty_17,25263200.24,2025-04-13,2025-05-22
2025-05-15,5254.27,asset_sale,in,Counterparty_13,25268454.51,,
2025-05-15,3409.78,refund,in,Counterparty_78,25271864.29,,
2025-05-15,5104.42,refund,in,Counterparty_74,25276968.71,,
2025-05-15,8345.46,investment_income,in,Counterparty_39,25285314.17,,
2025-05-15,750.68,tax_payment,out,Counterparty_10,25284563.49,2025-04-10,2025-05-17
2025-05-15,30260.54,credit,in,Counterparty_95,25314824.03,,
2025-05-15,8265.19,asset_sale,in,Counterparty_28,25323089.22,,
2025-05-15,8132.14,customer_payment,in,Counterparty_77,25331221.36,,
2025-05-15,7231.75,rent,out,Counterparty_80,25323989.61,2025-04-12,2025-05-19
2025-05-15,504.76,rent,out,Counterparty_65,25323484.85,2025-04-04,2025-05-09
2025-05-15,602.06,asset_sale,in,Counterparty_96,25324086.91,,
2025-05-15,1688.17,marketing_spend,out,Counterparty_95,25322398.74,2025-04-22,2025-05-30
2025-05-15,2060.62,tax_payment,out,Counterparty_34,25320338.12,2025-04-11,2025-05-10
2025-05-15,1041.48,software_subscription,out,Counterparty_76,25319296.64,2025-04-26,2025-05-30
2025-05-15,227.14,customer_payment,in,Counterparty_24,25319523.78,,
2025-05-15,2449.37,investment_income,in,Counterparty_39,25321973.15,,
2025-05-15,3535.06,investment_income,in,Counterparty_33,25325508.21,,
2025-05-15,825.69,rent,out,Counterparty_83,25324682.52,2025-04-29,2025-05-30
2025-05-15,2258.87,credit,in,Counterparty_49,25326941.39,,
2025-05-15,3653.2,utilities,out,Counterparty_6,25323288.19,2025-04-07,2025-05-07
2025-05-15,1089.3,rent,out,Counterparty_61,25322198.89,2025-04-12,2025-05-14
2025-05-15,8823.9,rent,out,Counterparty_81,25313374.99,2025-04-10,2025-05-18
2025-05-15,1456.03,investment_income,in,Counterparty_56,25314831.02,,
2025-05-15,15872.95,marketing_spend,out,Counterparty_1,25298958.07,2025-04-13,2025-05-19
2025-05-15,4297.64,refund,in,Counterparty_54,25303255.71,,
2025-05-15,5289.25,credit,in,Counterparty_71,25308544.96,,
2025-05-15,5753.38,rent,out,Counterparty_68,25302791.58,2025-04-08,2025-05-15
2025-05-15,976.73,refund,in,Counterparty_85,25303768.31,,
2025-05-15,8541.09,refund,in,Counterparty_7,25312309.4,,
2025-05-15,681.93,rent,out,Counterparty_83,25311627.47,2025-04-13,2025-05-13
2025-05-15,458.7,marketing_spend,out,Counterparty_33,25311168.77,2025-04-05,2025-05-01
2025-05-15,2507.84,T&E,out,Counterparty_95,25308660.93,2025-04-27,2025-05-24
2025-05-15,1909.35,credit,in,Counterparty_4,25310570.28,,
2025-05-15,1805.09,credit,in,Counterparty_78,25312375.37,,
2025-05-15,6187.8,investment_income,in,Counterparty_19,25318563.17,,
2025-05-15,423.64,payroll,out,Counterparty_86,25318139.53,2025-04-19,2025-05-25
2025-05-15,680.18,T&E,out,Counterparty_98,25317459.35,2025-04-07,2025-05-08
2025-05-15,603.38,investment_income,in,Counterparty_52,25318062.73,,
2025-05-15,4956.39,refund,in,Counterparty_39,25323019.12,,
2025-05-15,406.78,supplier_payment,out,Counterparty_95,25322612.34,2025-04-14,2025-05-20
2025-05-15,522.11,payroll,out,Counterparty_99,25322090.23,2025-04-15,2025-05-10
2025-05-15,4537.19,asset_sale,in,Counterparty_93,25326627.42,,
2025-05-15,4245.06,refund,in,Counterparty_40,25330872.48,,
2025-05-15,1673.51,rent,out,Counterparty_93,25329198.97,2025-04-03,2025-05-03
2025-05-15,820.78,credit,in,Counterparty_72,25330019.75,,
2025-05-15,1625.18,supplier_payment,out,Counterparty_51,25328394.57,2025-04-27,2025-06-03
2025-05-15,10360.11,payroll,out,Counterparty_46,25318034.46,2025-04-28,2025-06-01
2025-05-16,10037.07,supplier_payment,out,Counterparty_1,25307997.39,2025-04-09,2025-05-14
2025-05-16,10638.83,asset_sale,in,Counterparty_97,25318636.22,,
2025-05-16,14969.3,investment_income,in,Counterparty_94,25333605.52,,
2025-05-16,56.9,investment_income,in,Counterparty_28,25333662.42,,
2025-05-16,2587.55,payroll,out,Counterparty_65,25331074.87,2025-04-21,2025-05-23
2025-05-16,7097.11,loan_repayment,out,Counterparty_17,25323977.76,2025-04-13,2025-05-11
2025-05-16,29484.13,investment_income,in,Counterparty_41,25353461.89,,
2025-05-16,2833.74,asset_sale,in,Counterparty_58,25356295.63,,
2025-05-16,1086.01,refund,in,Counterparty_77,25357381.64,,
2025-05-16,1325.05,rent,out,Counterparty_20,25356056.59,2025-04-10,2025-05-11
2025-05-16,184.46,tax_payment,out,Counterparty_13,25355872.13,2025-04-13,2025-05-18
2025-05-16,412.9,payroll,out,Counterparty_27,25355459.23,2025-04-24,2025-05-30
2025-05-16,224.98,loan_repayment,out,Counterparty_85,25355234.25,2025-04-25,2025-05-26
2025-05-16,3352.26,loan_repayment,out,Counterparty_74,25351881.99,2025-04-04,2025-05-10
2025-05-16,7357.71,asset_sale,in,Counterparty_15,25359239.7,,
2025-05-16,5938.23,loan_repayment,out,Counterparty_91,25353301.47,2025-04-22,2025-05-26
2025-05-16,2756.04,marketing_spend,out,Counterparty_7,25350545.43,2025-04-24,2025-05-29
2025-05-16,7406.91,utilities,out,Counterparty_60,25343138.52,2025-04-19,2025-05-15
2025-05-16,2137.37,rent,out,Counterparty_95,25341001.15,2025-04-17,2025-05-26
2025-05-16,255.39,marketing_spend,out,Counterparty_99,25340745.76,2025-04-20,2025-05-15
2025-05-16,5498.91,refund,in,Counterparty_91,25346244.67,,
2025-05-16,608.22,utilities,out,Counterparty_43,25345636.45,2025-04-09,2025-05-08
2025-05-16,1087.28,marketing_spend,out,Counterparty_67,25344549.17,2025-04-25,2025-05-20
2025-05-16,1616.5,marketing_spend,out,Counterparty_38,25342932.67,2025-04-10,2025-05-16
2025-05-16,443.13,customer_payment,in,Counterparty_23,25343375.8,,
2025-05-16,2248.8,payroll,out,Counterparty_20,25341127.0,2025-04-22,2025-05-17
2025-05-16,13110.05,refund,in,Counterparty_4,25354237.05,,
2025-05-16,871.7,loan_repayment,out,Counterparty_97,25353365.35,2025-04-05,2025-05-09
2025-05-16,15498.92,refund,in,Counterparty_29,25368864.27,,
2025-05-16,1273.62,refund,in,Counterparty_73,25370137.89,,
2025-05-16,11756.04,customer_payment,in,Counterparty_48,25381893.93,,
2025-05-16,252.99,software_subscription,out,Counterparty_82,25381640.94,2025-05-01,2025-06-05
2025-05-16,5140.86,investment_income,in,Counterparty_94,25386781.8,,
2025-05-16,1554.1,rent,out,Counterparty_82,25385227.7,2025-04-08,2025-05-10
2025-05-16,2939.19,payroll,out,Counterparty_38,25382288.51,2025-04-29,2025-05-27
2025-05-16,4901.41,utilities,out,Counterparty_83,25377387.1,2025-04-09,2025-05-05
2025-05-16,10458.31,credit,in,Counterparty_71,25387845.41,,
2025-05-16,1787.99,payroll,out,Counterparty_10,25386057.42,2025-04-19,2025-05-21
2025-05-16,1965.5,marketing_spend,out,Counterparty_15,25384091.92,2025-04-30,2025-06-02
2025-05-16,1410.24,customer_payment,in,Counterparty_31,25385502.16,,
2025-05-16,12827.77,utilities,out,Counterparty_54,25372674.39,2025-04-30,2025-05-29
2025-05-16,4242.9,payroll,out,Counterparty_58,25368431.49,2025-04-25,2025-06-01
2025-05-16,4483.14,software_subscription,out,Counterparty_64,25363948.35,2025-04-21,2025-05-17
2025-05-16,348.6,utilities,out,Counterparty_75,25363599.75,2025-04-19,2025-05-14
2025-05-16,3111.12,customer_payment,in,Counterparty_38,25366710.87,,
2025-05-16,15492.2,payroll,out,Counterparty_41,25351218.67,2025-04-09,2025-05-13
2025-05-16,54.48,supplier_payment,out,Counterparty_27,25351164.19,2025-04-09,2025-05-08
2025-05-16,913.16,credit,in,Counterparty_52,25352077.35,,
2025-05-17,999.61,payroll,out,Counterparty_55,25351077.74,2025-04-18,2025-05-20
2025-05-17,5390.98,customer_payment,in,Counterparty_18,25356468.72,,
2025-05-17,17781.51,customer_payment,in,Counterparty_14,25374250.23,,
2025-05-17,1594.31,investment_income,in,Counterparty_39,25375844.54,,
2025-05-17,4471.45,marketing_spend,out,Counterparty_39,25371373.09,2025-04-18,2025-05-23
2025-05-17,479.23,refund,in,Counterparty_2,25371852.32,,
2025-05-17,14017.96,refund,in,Counterparty_27,25385870.28,,
2025-05-17,1879.97,credit,in,Counterparty_17,25387750.25,,
2025-05-17,13896.37,customer_payment,in,Counterparty_90,25401646.62,,
2025-05-17,8752.33,software_subscription,out,Counterparty_98,25392894.29,2025-04-19,2025-05-24
2025-05-17,567.9,supplier_payment,out,Counterparty_65,25392326.39,2025-04-09,2025-05-05
2025-05-17,20.44,customer_payment,in,Counterparty_58,25392346.83,,
2025-05-17,10126.69,refund,in,Counterparty_54,25402473.52,,
2025-05-17,3269.3,investment_income,in,Counterparty_87,25405742.82,,
2025-05-17,3466.28,asset_sale,in,Counterparty_57,25409209.1,,
2025-05-17,710.21,T&E,out,Counterparty_22,25408498.89,2025-04-16,2025-05-23
2025-05-17,1281.05,utilities,out,Counterparty_2,25407217.84,2025-04-04,2025-05-12
2025-05-17,4687.57,investment_income,in,Counterparty_71,25411905.41,,
2025-05-17,372.66,payroll,out,Counterparty_51,25411532.75,2025-04-21,2025-05-22
2025-05-17,4997.09,rent,out,Counterparty_73,25406535.66,2025-04-25,2025-05-30
2025-05-17,1445.83,loan_repayment,out,Counterparty_28,25405089.83,2025-04-09,2025-05-15
2025-05-17,1850.56,refund,in,Counterparty_9,25406940.39,,
2025-05-17,2025.75,T&E,out,Counterparty_80,25404914.64,2025-04-10,2025-05-19
2025-05-17,4791.12,refund,in,Counterparty_37,25409705.76,,
2025-05-17,2268.17,payroll,out,Counterparty_19,25407437.59,2025-04-09,2025-05-08
2025-05-17,68.65,rent,out,Counterparty_29,25407368.94,2025-04-18,2025-05-16
2025-05-17,5207.66,rent,out,Counterparty_48,25402161.28,2025-04-25,2025-05-27
2025-05-17,13199.62,refund,in,Counterparty_47,25415360.9,,
2025-05-17,1374.32,utilities,out,Counterparty_33,25413986.58,2025-04-18,2025-05-19
2025-05-17,7317.97,loan_repayment,out,Counterparty_97,25406668.61,2025-04-17,2025-05-13
2025-05-17,227.85,asset_sale,in,Counterparty_89,25406896.46,,
2025-05-17,564.19,asset_sale,in,Counterparty_54,25407460.65,,
2025-05-17,3408.67,credit,in,Counterparty_26,25410869.32,,
2025-05-17,24567.65,asset_sale,in,Counterparty_72,25435436.97,,
2025-05-17,938.11,software_subscription,out,Counterparty_19,25434498.86,2025-04-30,2025-06-07
2025-05-17,782.86,utilities,out,Counterparty_45,25433716.0,2025-05-01,2025-05-28
2025-05-17,7737.55,investment_income,in,Counterparty_73,25441453.55,,
2025-05-17,495.52,supplier_payment,out,Counterparty_34,25440958.03,2025-04-15,2025-05-20
2025-05-17,7330.17,refund,in,Counterparty_84,25448288.2,,
2025-05-17,10795.17,investment_income,in,Counterparty_99,25459083.37,,
2025-05-17,357.04,payroll,out,Counterparty_93,25458726.33,2025-04-16,2025-05-23
2025-05-17,247.27,customer_payment,in,Counterparty_47,25458973.6,,
2025-05-17,26048.52,investment_income,in,Counterparty_77,25485022.12,,
2025-05-17,2277.39,utilities,out,Counterparty_79,25482744.73,2025-04-26,2025-06-03
2025-05-17,1364.03,software_subscription,out,Counterparty_12,25481380.7,2025-04-21,2025-05-16
2025-05-17,8106.02,asset_sale,in,Counterparty_18,25489486.72,,
2025-05-17,16364.13,investment_income,in,Counterparty_39,25505850.85,,
2025-05-17,3508.53,utilities,out,Counterparty_45,25502342.32,2025-04-24,2025-05-23
2025-05-17,8592.46,tax_payment,out,Counterparty_29,25493749.86,2025-04-03,2025-05-07
2025-05-17,3606.89,T&E,out,Counterparty_8,25490142.97,2025-05-02,2025-06-08
2025-05-17,3601.82,tax_payment,out,Counterparty_56,25486541.15,2025-04-24,2025-05-26
2025-05-18,2640.24,asset_sale,in,Counterparty_7,25489181.39,,
2025-05-18,4797.97,customer_payment,in,Counterparty_13,25493979.36,,
2025-05-18,956.66,utilities,out,Counterparty_41,25493022.7,2025-05-03,2025-05-28
2025-05-18,6575.36,asset_sale,in,Counterparty_97,25499598.06,,
2025-05-18,0.01,marketing_spend,out,Counterparty_49,25499598.05,2025-04-15,2025-05-21
2025-05-18,4774.82,customer_payment,in,Counterparty_24,25504372.87,,
2025-05-18,6783.48,refund,in,Counterparty_53,25511156.35,,
2025-05-18,608.38,software_subscription,out,Counterparty_48,25510547.97,2025-04-23,2025-06-01
2025-05-18,12262.89,credit,in,Counterparty_6,25522810.86,,
2025-05-18,893.85,refund,in,Counterparty_8,25523704.71,,
2025-05-18,625.38,investment_income,in,Counterparty_49,25524330.09,,
2025-05-18,10826.41,refund,in,Counterparty_16,25535156.5,,
2025-05-18,1064.65,supplier_payment,out,Counterparty_46,25534091.85,2025-04-17,2025-05-20
2025-05-18,6650.62,loan_repayment,out,Counterparty_41,25527441.23,2025-04-09,2025-05-17
2025-05-18,1528.59,credit,in,Counterparty_60,25528969.82,,
2025-05-18,6360.24,supplier_payment,out,Counterparty_37,25522609.58,2025-04-15,2025-05-14
2025-05-18,11127.09,rent,out,Counterparty_63,25511482.49,2025-04-12,2025-05-11
2025-05-18,2445.49,tax_payment,out,Counterparty_1,25509037.0,2025-04-28,2025-05-30
2025-05-18,2553.79,refund,in,Counterparty_41,25511590.79,,
2025-05-18,1026.42,tax_payment,out,Counterparty_22,25510564.37,2025-04-08,2025-05-07
2025-05-18,6737.09,refund,in,Counterparty_93,25517301.46,,
2025-05-18,1525.18,payroll,out,Counterparty_86,25515776.28,2025-04-10,2025-05-17
2025-05-18,2316.25,marketing_spend,out,Counterparty_91,25513460.03,2025-04-17,2025-05-17
2025-05-18,8963.22,marketing_spend,out,Counterparty_98,25504496.81,2025-04-24,2025-05-22
2025-05-18,5281.75,T&E,out,Counterparty_41,25499215.06,2025-04-04,2025-05-13
2025-05-18,10139.93,credit,in,Counterparty_61,25509354.99,,
2025-05-18,5087.05,utilities,out,Counterparty_63,25504267.94,2025-04-30,2025-06-03
2025-05-18,1899.04,tax_payment,out,Counterparty_46,25502368.9,2025-04-06,2025-05-10
2025-05-18,1314.24,T&E,out,Counterparty_73,25501054.66,2025-05-02,2025-06-07
2025-05-18,5429.8,refund,in,Counterparty_92,25506484.46,,
2025-05-18,3876.46,investment_income,in,Counterparty_20,25510360.92,,
2025-05-18,2310.05,asset_sale,in,Counterparty_23,25512670.97,,
2025-05-18,2421.37,tax_payment,out,Counterparty_28,25510249.6,2025-04-30,2025-06-02
2025-05-18,4934.82,utilities,out,Counterparty_29,25505314.78,2025-04-21,2025-05-29
2025-05-18,9307.84,asset_sale,in,Counterparty_57,25514622.62,,
2025-05-18,9604.72,credit,in,Counterparty_54,25524227.34,,
2025-05-18,466.7,rent,out,Counterparty_95,25523760.64,2025-04-09,2025-05-06
2025-05-18,4762.76,supplier_payment,out,Counterparty_14,25518997.88,2025-04-20,2025-05-23
2025-05-18,1282.36,investment_income,in,Counterparty_36,25520280.24,,
2025-05-18,7106.63,credit,in,Counterparty_13,25527386.87,,
2025-05-18,4900.93,credit,in,Counterparty_15,25532287.8,,
2025-05-18,4964.21,asset_sale,in,Counterparty_62,25537252.01,,
2025-05-18,1155.1,software_subscription,out,Counterparty_78,25536096.91,2025-04-16,2025-05-15
2025-05-18,981.14,utilities,out,Counterparty_72,25535115.77,2025-04-27,2025-06-03
2025-05-18,6077.72,payroll,out,Counterparty_57,25529038.05,2025-04-16,2025-05-22
2025-05-18,10860.52,T&E,out,Counterparty_1,25518177.53,2025-04-11,2025-05-08
2025-05-18,17921.44,customer_payment,in,Counterparty_15,25536098.97,,
2025-05-18,5632.54,payroll,out,Counterparty_4,25530466.43,2025-04-07,2025-05-09
2025-05-18,1688.33,rent,out,Counterparty_15,25528778.1,2025-04-08,2025-05-14
2025-05-18,1560.19,refund,in,Counterparty_81,25530338.29,,
2025-05-18,1311.36,rent,out,Counterparty_62,25529026.93,2025-04-11,2025-05-08
2025-05-18,8180.91,payroll,out,Counterparty_12,25520846.02,2025-04-25,2025-05-31
2025-05-18,10963.97,asset_sale,in,Counterparty_23,25531809.99,,
2025-05-18,4855.44,investment_income,in,Counterparty_39,25536665.43,,
2025-05-18,8330.08,credit,in,Counterparty_84,25544995.51,,
2025-05-18,787.21,rent,out,Counterparty_42,25544208.3,2025-04-13,2025-05-10
2025-05-18,4195.23,supplier_payment,out,Counterparty_53,25540013.07,2025-04-12,2025-05-13
2025-05-18,1390.13,marketing_spend,out,Counterparty_89,25538622.94,2025-04-19,2025-05-14
2025-05-18,1201.08,credit,in,Counterparty_28,25539824.02,,
2025-05-18,14946.06,credit,in,Counterparty_25,25554770.08,,
2025-05-19,1061.17,rent,out,Counterparty_81,25553708.91,2025-04-05,2025-05-14
2025-05-19,2292.5,credit,in,Counterparty_36,25556001.41,,
2025-05-19,1566.44,asset_sale,in,Counterparty_3,25557567.85,,
2025-05-19,6311.76,customer_payment,in,Counterparty_37,25563879.61,,
2025-05-19,2895.81,utilities,out,Counterparty_96,25560983.8,2025-04-08,2025-05-16
2025-05-19,3077.59,supplier_payment,out,Counterparty_60,25557906.21,2025-04-17,2025-05-14
2025-05-19,922.87,marketing_spend,out,Counterparty_57,25556983.34,2025-04-24,2025-05-29
2025-05-19,4954.8,T&E,out,Counterparty_50,25552028.54,2025-04-10,2025-05-14
2025-05-19,120.09,payroll,out,Counterparty_89,25551908.45,2025-04-08,2025-05-16
2025-05-19,3435.08,tax_payment,out,Counterparty_34,25548473.37,2025-04-06,2025-05-11
2025-05-19,843.22,payroll,out,Counterparty_64,25547630.15,2025-04-13,2025-05-10
2025-05-19,1523.26,loan_repayment,out,Counterparty_18,25546106.89,2025-04-11,2025-05-19
2025-05-19,1522.94,marketing_spend,out,Counterparty_58,25544583.95,2025-04-21,2025-05-26
2025-05-19,2731.55,refund,in,Counterparty_57,25547315.5,,
2025-05-19,761.07,customer_payment,in,Counterparty_17,25548076.57,,
2025-05-19,12819.44,marketing_spend,out,Counterparty_69,25535257.13,2025-04-24,2025-05-19
2025-05-19,6310.71,payroll,out,Counterparty_2,25528946.42,2025-04-13,2025-05-20
2025-05-19,3489.45,utilities,out,Counterparty_76,25525456.97,2025-04-23,2025-05-18
2025-05-19,2488.41,customer_payment,in,Counterparty_16,25527945.38,,
2025-05-19,11821.99,credit,in,Counterparty_29,25539767.37,,
2025-05-19,5673.89,software_subscription,out,Counterparty_44,25534093.48,2025-05-01,2025-05-30
2025-05-19,2846.81,investment_income,in,Counterparty_67,25536940.29,,
2025-05-19,6533.76,credit,in,Counterparty_43,25543474.05,,
2025-05-19,14487.83,rent,out,Counterparty_33,25528986.22,2025-04-21,2025-05-18
2025-05-19,451.55,refund,in,Counterparty_35,25529437.77,,
2025-05-19,5328.16,marketing_spend,out,Counterparty_11,25524109.61,2025-04-13,2025-05-18
2025-05-19,1095.18,payroll,out,Counterparty_50,25523014.43,2025-05-04,2025-06-12
2025-05-19,213.82,tax_payment,out,Counterparty_70,25522800.61,2025-04-21,2025-05-22
2025-05-19,13700.52,credit,in,Counterparty_21,25536501.13,,
2025-05-19,1080.66,refund,in,Counterparty_24,25537581.79,,
2025-05-19,1140.92,utilities,out,Counterparty_83,25536440.87,2025-04-25,2025-05-29
2025-05-19,576.49,marketing_spend,out,Counterparty_34,25535864.38,2025-04-07,2025-05-12
2025-05-19,173.83,T&E,out,Counterparty_76,25535690.55,2025-04-26,2025-05-26
2025-05-19,224.6,loan_repayment,out,Counterparty_14,25535465.95,2025-05-03,2025-05-31
2025-05-19,2954.53,customer_payment,in,Counterparty_90,25538420.48,,
2025-05-19,4600.04,customer_payment,in,Counterparty_43,25543020.52,,
2025-05-19,2030.11,utilities,out,Counterparty_89,25540990.41,2025-04-27,2025-05-31
2025-05-19,2004.3,supplier_payment,out,Counterparty_55,25538986.11,2025-04-05,2025-05-09
2025-05-19,1856.01,T&E,out,Counterparty_62,25537130.1,2025-04-14,2025-05-09
2025-05-19,518.06,utilities,out,Counterparty_43,25536612.04,2025-04-15,2025-05-14
2025-05-19,1045.77,investment_income,in,Counterparty_52,25537657.81,,
2025-05-19,11097.59,investment_income,in,Counterparty_47,25548755.4,,
2025-05-19,9618.57,investment_income,in,Counterparty_26,25558373.97,,
2025-05-19,395.97,customer_payment,in,Counterparty_88,25558769.94,,
2025-05-19,4481.06,asset_sale,in,Counterparty_98,25563251.0,,
2025-05-19,8672.63,payroll,out,Counterparty_7,25554578.37,2025-04-16,2025-05-16
2025-05-19,2779.51,refund,in,Counterparty_86,25557357.88,,
2025-05-19,3636.82,customer_payment,in,Counterparty_24,25560994.7,,
2025-05-19,19625.08,asset_sale,in,Counterparty_86,25580619.78,,
2025-05-19,4162.08,supplier_payment,out,Counterparty_13,25576457.7,2025-04-15,2025-05-18
2025-05-19,4461.87,rent,out,Counterparty_30,25571995.83,2025-04-29,2025-05-26
2025-05-19,134.3,loan_repayment,out,Counterparty_5,25571861.53,2025-04-10,2025-05-09
2025-05-19,1825.83,payroll,out,Counterparty_18,25570035.7,2025-04-18,2025-05-13
2025-05-19,1365.8,marketing_spend,out,Counterparty_21,25568669.9,2025-04-28,2025-05-25
2025-05-19,5416.1,tax_payment,out,Counterparty_86,25563253.8,2025-04-18,2025-05-13
2025-05-19,134.12,refund,in,Counterparty_12,25563387.92,,
2025-05-19,3100.1,payroll,out,Counterparty_92,25560287.82,2025-04-18,2025-05-26
2025-05-19,8711.91,software_subscription,out,Counterparty_96,25551575.91,2025-04-14,2025-05-20
2025-05-19,6122.07,refund,in,Counterparty_51,25557697.98,,
2025-05-20,1953.47,utilities,out,Counterparty_16,25555744.51,2025-04-06,2025-05-11
2025-05-20,3622.51,rent,out,Counterparty_32,25552122.0,2025-04-24,2025-05-26
2025-05-20,9683.98,supplier_payment,out,Counterparty_51,25542438.02,2025-05-05,2025-06-09
2025-05-20,15435.92,refund,in,Counterparty_94,25557873.94,,
2025-05-20,5546.26,refund,in,Counterparty_10,25563420.2,,
2025-05-20,3093.9,tax_payment,out,Counterparty_82,25560326.3,2025-04-29,2025-05-25
2025-05-20,1259.44,investment_income,in,Counterparty_95,25561585.74,,
2025-05-20,9450.32,customer_payment,in,Counterparty_83,25571036.06,,
2025-05-20,491.47,refund,in,Counterparty_2,25571527.53,,
2025-05-20,3902.1,marketing_spend,out,Counterparty_73,25567625.43,2025-04-10,2025-05-10
2025-05-20,211.32,rent,out,Counterparty_98,25567414.11,2025-05-01,2025-06-07
2025-05-20,1401.91,asset_sale,in,Counterparty_11,25568816.02,,
2025-05-20,752.92,loan_repayment,out,Counterparty_52,25568063.1,2025-04-18,2025-05-14
2025-05-20,2912.41,marketing_spend,out,Counterparty_72,25565150.69,2025-04-16,2025-05-11
2025-05-20,1086.96,T&E,out,Counterparty_58,25564063.73,2025-04-19,2025-05-18
2025-05-20,1073.88,loan_repayment,out,Counterparty_36,25562989.85,2025-04-19,2025-05-23
2025-05-20,3576.96,payroll,out,Counterparty_13,25559412.89,2025-04-14,2025-05-11
2025-05-20,375.97,loan_repayment,out,Counterparty_91,25559036.92,2025-04-09,2025-05-10
2025-05-20,7.3,credit,in,Counterparty_27,25559044.22,,
2025-05-20,6819.44,investment_income,in,Counterparty_26,25565863.66,,
2025-05-20,8489.71,loan_repayment,out,Counterparty_10,25557373.95,2025-04-20,2025-05-27
2025-05-20,297.04,software_subscription,out,Counterparty_47,25557076.91,2025-04-28,2025-05-30
2025-05-20,1294.92,rent,out,Counterparty_2,25555781.99,2025-04-12,2025-05-11
2025-05-20,5917.9,tax_payment,out,Counterparty_8,25549864.09,2025-04-21,2025-05-18
2025-05-20,1621.85,software_subscription,out,Counterparty_68,25548242.24,2025-05-01,2025-06-06
2025-05-20,24.51,credit,in,Counterparty_13,25548266.75,,
2025-05-20,1343.63,supplier_payment,out,Counterparty_83,25546923.12,2025-04-26,2025-05-23
2025-05-20,5992.22,rent,out,Counterparty_19,25540930.9,2025-04-30,2025-05-31
2025-05-20,9828.72,investment_income,in,Counterparty_58,25550759.62,,
2025-05-20,5624.31,software_subscription,out,Counterparty_34,25545135.31,2025-04-21,2025-05-26
2025-05-20,7279.79,credit,in,Counterparty_80,25552415.1,,
2025-05-20,11801.39,investment_income,in,Counterparty_78,25564216.49,,
2025-05-20,1095.86,asset_sale,in,Counterparty_84,25565312.35,,
2025-05-20,3413.29,customer_payment,in,Counterparty_64,25568725.64,,
2025-05-20,409.06,T&E,out,Counterparty_39,25568316.58,2025-04-27,2025-05-31
2025-05-20,6591.78,investment_income,in,Counterparty_62,25574908.36,,
2025-05-20,4583.47,investment_income,in,Counterparty_62,25579491.83,,
2025-05-20,1502.31,supplier_payment,out,Counterparty_87,25577989.52,2025-04-20,2025-05-25
2025-05-20,480.59,marketing_spend,out,Counterparty_87,25577508.93,2025-04-24,2025-05-21
2025-05-20,4554.06,loan_repayment,out,Counterparty_56,25572954.87,2025-04-26,2025-06-04
2025-05-20,7238.09,customer_payment,in,Counterparty_83,25580192.96,,
2025-05-20,149.86,asset_sale,in,Counterparty_91,25580342.82,,
2025-05-20,4440.62,credit,in,Counterparty_21,25584783.44,,
2025-05-20,481.59,investment_income,in,Counterparty_34,25585265.03,,
2025-05-20,367.95,loan_repayment,out,Counterparty_41,25584897.08,2025-05-01,2025-05-28
2025-05-20,185.61,marketing_spend,out,Counterparty_64,25584711.47,2025-04-28,2025-05-28
2025-05-20,5886.01,asset_sale,in,Counterparty_16,25590597.48,,
2025-05-20,4408.89,tax_payment,out,Counterparty_53,25586188.59,2025-04-06,2025-05-05
2025-05-20,3231.25,asset_sale,in,Counterparty_58,25589419.84,,
2025-05-20,1275.08,tax_payment,out,Counterparty_42,25588144.76,2025-04-27,2025-06-03
2025-05-20,1642.42,customer_payment,in,Counterparty_3,25589787.18,,
2025-05-20,6269.03,payroll,out,Counterparty_88,25583518.15,2025-05-02,2025-06-09
2025-05-21,2043.5,utilities,out,Counterparty_65,25581474.65,2025-04-17,2025-05-26
2025-05-21,228.02,loan_repayment,out,Counterparty_30,25581246.63,2025-04-12,2025-05-14
2025-05-21,8904.37,asset_sale,in,Counterparty_75,25590151.0,,
2025-05-21,3623.12,software_subscription,out,Counterparty_18,25586527.88,2025-05-01,2025-06-03
2025-05-21,2019.72,T&E,out,Counterparty_94,25584508.16,2025-04-29,2025-05-29
2025-05-21,139.43,payroll,out,Counterparty_6,25584368.73,2025-05-03,2025-05-31
2025-05-21,292.29,refund,in,Counterparty_49,25584661.02,,
2025-05-21,165.59,software_subscription,out,Counterparty_2,25584495.43,2025-04-16,2025-05-20
2025-05-21,31380.14,customer_payment,in,Counterparty_27,25615875.57,,
2025-05-21,1668.37,rent,out,Counterparty_49,25614207.2,2025-05-01,2025-06-07
2025-05-21,8858.69,investment_income,in,Counterparty_39,25623065.89,,
2025-05-21,5409.46,supplier_payment,out,Counterparty_75,25617656.43,2025-05-06,2025-06-02
2025-05-21,2512.0,credit,in,Counterparty_33,25620168.43,,
2025-05-21,6525.35,tax_payment,out,Counterparty_4,25613643.08,2025-04-09,2025-05-16
2025-05-21,977.35,loan_repayment,out,Counterparty_58,25612665.73,2025-04-11,2025-05-10
2025-05-21,5376.91,marketing_spend,out,Counterparty_68,25607288.82,2025-04-14,2025-05-22
2025-05-21,8065.05,asset_sale,in,Counterparty_66,25615353.87,,
2025-05-21,5990.68,payroll,out,Counterparty_74,25609363.19,2025-04-25,2025-05-21
2025-05-21,2161.59,investment_income,in,Counterparty_68,25611524.78,,
2025-05-21,241.07,rent,out,Counterparty_93,25611283.71,2025-04-14,2025-05-16
2025-05-21,797.47,payroll,out,Counterparty_18,25610486.24,2025-04-19,2025-05-26
2025-05-21,2815.24,marketing_spend,out,Counterparty_68,25607671.0,2025-05-04,2025-06-11
2025-05-21,10228.26,credit,in,Counterparty_12,25617899.26,,
2025-05-21,259.17,rent,out,Counterparty_59,25617640.09,2025-04-10,2025-05-17
2025-05-21,7857.42,investment_income,in,Counterparty_90,25625497.51,,
2025-05-21,1122.9,rent,out,Counterparty_13,25624374.61,2025-05-02,2025-06-05
2025-05-21,4285.0,tax_payment,out,Counterparty_95,25620089.61,2025-05-03,2025-06-11
2025-05-21,422.15,supplier_payment,out,Counterparty_16,25619667.46,2025-05-01,2025-05-30
2025-05-21,8748.62,credit,in,Counterparty_71,25628416.08,,
2025-05-21,395.59,marketing_spend,out,Counterparty_44,25628020.49,2025-04-27,2025-05-24
2025-05-21,2799.23,loan_repayment,out,Counterparty_73,25625221.26,2025-04-23,2025-05-29
2025-05-21,2400.28,investment_income,in,Counterparty_23,25627621.54,,
2025-05-21,4810.53,customer_payment,in,Counterparty_32,25632432.07,,
2025-05-21,663.86,rent,out,Counterparty_36,25631768.21,2025-04-23,2025-05-27
2025-05-21,2233.51,customer_payment,in,Counterparty_72,25634001.72,,
2025-05-21,3122.63,rent,out,Counterparty_61,25630879.09,2025-05-02,2025-06-01
2025-05-21,13439.49,investment_income,in,Counterparty_64,25644318.58,,
2025-05-21,2922.93,asset_sale,in,Counterparty_85,25647241.51,,
2025-05-21,937.71,payroll,out,Counterparty_98,25646303.8,2025-05-04,2025-06-11
2025-05-21,710.64,marketing_spend,out,Counterparty_11,25645593.16,2025-04-24,2025-05-24
2025-05-21,18117.12,credit,in,Counterparty_55,25663710.28,,
2025-05-21,711.03,loan_repayment,out,Counterparty_96,25662999.25,2025-04-23,2025-05-27
2025-05-21,3526.3,payroll,out,Counterparty_17,25659472.95,2025-04-08,2025-05-05
2025-05-21,9991.28,T&E,out,Counterparty_62,25649481.67,2025-04-11,2025-05-16
2025-05-21,9795.81,refund,in,Counterparty_15,25659277.48,,
2025-05-21,1179.22,rent,out,Counterparty_23,25658098.26,2025-04-16,2025-05-16
2025-05-21,3652.22,software_subscription,out,Counterparty_11,25654446.04,2025-04-14,2025-05-14
2025-05-21,1311.28,rent,out,Counterparty_86,25653134.76,2025-04-13,2025-05-14
2025-05-21,3274.26,marketing_spend,out,Counterparty_48,25649860.5,2025-05-01,2025-06-05
2025-05-22,8629.95,tax_payment,out,Counterparty_98,25641230.55,2025-05-01,2025-06-02
2025-05-22,3603.6,refund,in,Counterparty_40,25644834.15,,
2025-05-22,15105.02,payroll,out,Counterparty_72,25629729.13,2025-04-25,2025-06-02
2025-05-22,60.68,T&E,out,Counterparty_47,25629668.45,2025-04-30,2025-05-27
2025-05-22,4598.07,refund,in,Counterparty_36,25634266.52,,
2025-05-22,3420.63,utilities,out,Counterparty_36,25630845.89,2025-04-26,2025-06-02
2025-05-22,1560.95,credit,in,Counterparty_81,25632406.84,,
2025-05-22,3756.46,refund,in,Counterparty_30,25636163.3,,
2025-05-22,3422.87,utilities,out,Counterparty_19,25632740.43,2025-04-13,2025-05-14
2025-05-22,2548.22,refund,in,Counterparty_48,25635288.65,,
2025-05-22,1536.17,utilities,out,Counterparty_36,25633752.48,2025-04-13,2025-05-13
2025-05-22,8724.13,loan_repayment,out,Counterparty_47,25625028.35,2025-04-10,2025-05-08
2025-05-22,316.04,marketing_spend,out,Counterparty_75,25624712.31,2025-04-23,2025-05-26
2025-05-22,770.55,payroll,out,Counterparty_17,25623941.76,2025-04-30,2025-06-02
2025-05-22,486.19,loan_repayment,out,Counterparty_32,25623455.57,2025-04-09,2025-05-13
2025-05-22,4249.58,asset_sale,in,Counterparty_88,25627705.15,,
2025-05-22,911.9,rent,out,Counterparty_32,25626793.25,2025-05-05,2025-06-04
2025-05-22,6533.74,supplier_payment,out,Counterparty_77,25620259.51,2025-04-29,2025-06-03
2025-05-22,996.18,investment_income,in,Counterparty_63,25621255.69,,
2025-05-22,385.43,tax_payment,out,Counterparty_95,25620870.26,2025-04-21,2025-05-21
2025-05-22,618.47,loan_repayment,out,Counterparty_17,25620251.79,2025-04-12,2025-05-19
2025-05-22,4013.99,customer_payment,in,Counterparty_92,25624265.78,,
2025-05-22,5463.88,customer_payment,in,Counterparty_86,25629729.66,,
2025-05-22,2274.19,refund,in,Counterparty_49,25632003.85,,
2025-05-22,8203.42,software_subscription,out,Counterparty_19,25623800.43,2025-04-13,2025-05-10
2025-05-22,2477.92,investment_income,in,Counterparty_96,25626278.35,,
2025-05-22,541.09,investment_income,in,Counterparty_43,25626819.44,,
2025-05-22,2819.1,asset_sale,in,Counterparty_18,25629638.54,,
2025-05-22,1131.17,credit,in,Counterparty_87,25630769.71,,
2025-05-22,6786.31,investment_income,in,Counterparty_89,25637556.02,,
2025-05-22,4844.82,supplier_payment,out,Counterparty_44,25632711.2,2025-04-17,2025-05-14
2025-05-22,315.73,marketing_spend,out,Counterparty_87,25632395.47,2025-04-29,2025-06-02
2025-05-22,1565.09,investment_income,in,Counterparty_93,25633960.56,,
2025-05-22,961.42,utilities,out,Counterparty_4,25632999.14,2025-04-09,2025-05-08
2025-05-22,3285.5,utilities,out,Counterparty_89,25629713.64,2025-04-13,2025-05-08
2025-05-22,6515.19,tax_payment,out,Counterparty_68,25623198.45,2025-04-22,2025-05-21
2025-05-22,2065.12,investment_income,in,Counterparty_14,25625263.57,,
2025-05-22,6883.96,asset_sale,in,Counterparty_14,25632147.53,,
2025-05-22,496.93,rent,out,Counterparty_95,25631650.6,2025-04-14,2025-05-18
2025-05-22,2091.62,credit,in,Counterparty_22,25633742.22,,
2025-05-22,1907.69,customer_payment,in,Counterparty_19,25635649.91,,
2025-05-22,358.39,asset_sale,in,Counterparty_49,25636008.3,,
2025-05-22,626.18,tax_payment,out,Counterparty_93,25635382.12,2025-04-13,2025-05-17
2025-05-22,7420.15,credit,in,Counterparty_2,25642802.27,,
2025-05-22,1000.31,investment_income,in,Counterparty_31,25643802.58,,
2025-05-22,3857.89,T&E,out,Counterparty_63,25639944.69,2025-04-15,2025-05-22
2025-05-22,7836.16,credit,in,Counterparty_10,25647780.85,,
2025-05-22,1105.66,loan_repayment,out,Counterparty_45,25646675.19,2025-04-17,2025-05-13
2025-05-22,11997.05,asset_sale,in,Counterparty_73,25658672.24,,
2025-05-22,8978.06,marketing_spend,out,Counterparty_88,25649694.18,2025-04-28,2025-05-28
2025-05-22,274.78,tax_payment,out,Counterparty_71,25649419.4,2025-05-03,2025-06-11
2025-05-22,2712.55,asset_sale,in,Counterparty_84,25652131.95,,
2025-05-22,19675.39,asset_sale,in,Counterparty_76,25671807.34,,
2025-05-22,758.35,utilities,out,Counterparty_82,25671048.99,2025-04-30,2025-06-01
2025-05-22,8703.73,utilities,out,Counterparty_33,25662345.26,2025-05-03,2025-06-10
2025-05-22,1856.88,tax_payment,out,Counterparty_79,25660488.38,2025-04-08,2025-05-16
2025-05-22,815.92,payroll,out,Counterparty_16,25659672.46,2025-04-20,2025-05-17
2025-05-22,868.97,T&E,out,Counterparty_39,25658803.49,2025-04-21,2025-05-24
2025-05-22,10434.1,payroll,out,Counterparty_46,25648369.39,2025-05-07,2025-06-03
2025-05-22,5082.22,investment_income,in,Counterparty_90,25653451.61,,
2025-05-22,1082.75,marketing_spend,out,Counterparty_85,25652368.86,2025-04-30,2025-05-29
2025-05-22,17632.56,investment_income,in,Counterparty_16,25670001.42,,
2025-05-22,9992.22,software_subscription,out,Counterparty_96,25660009.2,2025-04-25,2025-05-22
2025-05-23,110.5,loan_repayment,out,Counterparty_27,25659898.7,2025-04-23,2025-05-21
2025-05-23,6047.0,rent,out,Counterparty_68,25653851.7,2025-04-10,2025-05-11
2025-05-23,1154.14,software_subscription,out,Counterparty_86,25652697.56,2025-05-08,2025-06-13
2025-05-23,56.35,utilities,out,Counterparty_83,25652641.21,2025-04-13,2025-05-08
2025-05-23,3989.33,utilities,out,Counterparty_6,25648651.88,2025-04-22,2025-05-21
2025-05-23,1683.77,tax_payment,out,Counterparty_77,25646968.11,2025-04-26,2025-06-04
2025-05-23,108.04,software_subscription,out,Counterparty_89,25646860.07,2025-05-05,2025-06-09
2025-05-23,298.73,supplier_payment,out,Counterparty_67,25646561.34,2025-04-26,2025-06-02
2025-05-23,741.65,investment_income,in,Counterparty_90,25647302.99,,
2025-05-23,494.06,marketing_spend,out,Counterparty_24,25646808.93,2025-05-08,2025-06-14
2025-05-23,3941.94,loan_repayment,out,Counterparty_10,25642866.99,2025-04-24,2025-05-31
2025-05-23,8082.47,credit,in,Counterparty_21,25650949.46,,
2025-05-23,10807.86,asset_sale,in,Counterparty_99,25661757.32,,
2025-05-23,3075.41,T&E,out,Counterparty_63,25658681.91,2025-04-26,2025-06-01
2025-05-23,4115.11,rent,out,Counterparty_92,25654566.8,2025-04-12,2025-05-21
2025-05-23,4684.37,refund,in,Counterparty_38,25659251.17,,
2025-05-23,8752.13,credit,in,Counterparty_95,25668003.3,,
2025-05-23,16032.44,investment_income,in,Counterparty_28,25684035.74,,
2025-05-23,1851.76,supplier_payment,out,Counterparty_29,25682183.98,2025-04-17,2025-05-13
2025-05-23,7749.99,loan_repayment,out,Counterparty_97,25674433.99,2025-05-04,2025-05-29
2025-05-23,229.87,supplier_payment,out,Counterparty_60,25674204.12,2025-04-16,2025-05-20
2025-05-23,10923.85,asset_sale,in,Counterparty_86,25685127.97,,
2025-05-23,4788.42,T&E,out,Counterparty_5,25680339.55,2025-05-05,2025-06-07
2025-05-23,4995.4,rent,out,Counterparty_76,25675344.15,2025-04-14,2025-05-18
2025-05-23,2712.83,payroll,out,Counterparty_19,25672631.32,2025-05-03,2025-05-29
2025-05-23,2662.08,investment_income,in,Counterparty_73,25675293.4,,
2025-05-23,1937.51,payroll,out,Counterparty_46,25673355.89,2025-05-06,2025-05-31
2025-05-23,6806.41,credit,in,Counterparty_49,25680162.3,,
2025-05-23,2576.13,supplier_payment,out,Counterparty_34,25677586.17,2025-05-06,2025-06-08
2025-05-23,1213.17,payroll,out,Counterparty_37,25676373.0,2025-04-16,2025-05-13
2025-05-23,456.35,T&E,out,Counterparty_20,25675916.65,2025-04-15,2025-05-17
2025-05-23,1635.03,marketing_spend,out,Counterparty_26,25674281.62,2025-04-20,2025-05-16
2025-05-23,2630.47,credit,in,Counterparty_95,25676912.09,,
2025-05-23,7370.95,software_subscription,out,Counterparty_12,25669541.14,2025-04-15,2025-05-17
2025-05-23,412.0,investment_income,in,Counterparty_3,25669953.14,,
2025-05-23,1359.52,tax_payment,out,Counterparty_76,25668593.62,2025-05-01,2025-06-08
2025-05-23,7473.14,refund,in,Counterparty_67,25676066.76,,
2025-05-23,1086.73,software_subscription,out,Counterparty_42,25674980.03,2025-04-13,2025-05-20
2025-05-23,4928.43,utilities,out,Counterparty_79,25670051.6,2025-04-11,2025-05-18
2025-05-23,257.75,supplier_payment,out,Counterparty_5,25669793.85,2025-04-20,2025-05-21
2025-05-23,4406.88,supplier_payment,out,Counterparty_31,25665386.97,2025-04-12,2025-05-16
2025-05-23,1132.91,asset_sale,in,Counterparty_98,25666519.88,,
2025-05-23,240.77,tax_payment,out,Counterparty_10,25666279.11,2025-04-11,2025-05-09
2025-05-23,506.36,T&E,out,Counterparty_76,25665772.75,2025-04-28,2025-05-29
2025-05-23,15.38,customer_payment,in,Counterparty_18,25665788.13,,
2025-05-23,8472.15,customer_payment,in,Counterparty_67,25674260.28,,
2025-05-23,4571.61,asset_sale,in,Counterparty_93,25678831.89,,
2025-05-23,1440.95,software_subscription,out,Counterparty_3,25677390.94,2025-04-20,2025-05-20
2025-05-23,847.57,marketing_spend,out,Counterparty_84,25676543.37,2025-05-05,2025-06-01
2025-05-23,4547.8,marketing_spend,out,Counterparty_97,25671995.57,2025-05-08,2025-06-11
2025-05-23,520.1,credit,in,Counterparty_42,25672515.67,,
2025-05-23,1516.91,refund,in,Counterparty_2,25674032.58,,
2025-05-23,24109.58,asset_sale,in,Counterparty_89,25698142.16,,
2025-05-23,5297.09,tax_payment,out,Counterparty_13,25692845.07,2025-04-16,2025-05-14
2025-05-24,2542.11,supplier_payment,out,Counterparty_44,25690302.96,2025-04-19,2025-05-26
2025-05-24,3207.5,marketing_spend,out,Counterparty_34,25687095.46,2025-05-01,2025-05-26
2025-05-24,2467.48,payroll,out,Counterparty_29,25684627.98,2025-05-01,2025-06-03
2025-05-24,6846.1,tax_payment,out,Counterparty_12,25677781.88,2025-04-13,2025-05-12
2025-05-24,169.47,marketing_spend,out,Counterparty_72,25677612.41,2025-05-08,2025-06-16
2025-05-24,9229.59,asset_sale,in,Counterparty_79,25686842.0,,
2025-05-24,15399.6,software_subscription,out,Counterparty_31,25671442.4,2025-04-21,2025-05-24
2025-05-24,2339.14,T&E,out,Counterparty_62,25669103.26,2025-05-02,2025-06-09
2025-05-24,1726.36,T&E,out,Counterparty_50,25667376.9,2025-04-26,2025-06-03
2025-05-24,5708.78,marketing_spend,out,Counterparty_91,25661668.12,2025-04-24,2025-05-25
2025-05-24,3303.53,supplier_payment,out,Counterparty_22,25658364.59,2025-04-19,2025-05-26
2025-05-24,25831.72,refund,in,Counterparty_12,25684196.31,,
2025-05-24,3527.47,refund,in,Counterparty_47,25687723.78,,
2025-05-24,5898.86,investment_income,in,Counterparty_56,25693622.64,,
2025-05-24,4675.33,asset_sale,in,Counterparty_83,25698297.97,,
2025-05-24,2348.2,payroll,out,Counterparty_36,25695949.77,2025-04-30,2025-05-31
2025-05-24,1069.26,supplier_payment,out,Counterparty_12,25694880.51,2025-04-23,2025-05-26
2025-05-24,5798.01,T&E,out,Counterparty_91,25689082.5,2025-05-04,2025-06-10
2025-05-24,1918.56,marketing_spend,out,Counterparty_97,25687163.94,2025-04-24,2025-05-28
2025-05-24,510.69,credit,in,Counterparty_4,25687674.63,,
2025-05-24,6804.62,credit,in,Counterparty_83,25694479.25,,
2025-05-24,5697.79,rent,out,Counterparty_8,25688781.46,2025-04-15,2025-05-24
2025-05-24,5637.01,T&E,out,Counterparty_13,25683144.45,2025-05-02,2025-05-28
2025-05-24,4025.15,payroll,out,Counterparty_61,25679119.3,2025-05-07,2025-06-07
2025-05-24,6764.71,marketing_spend,out,Counterparty_11,25672354.59,2025-04-23,2025-05-26
2025-05-24,609.61,software_subscription,out,Counterparty_88,25671744.98,2025-04-26,2025-05-27
2025-05-24,6352.01,asset_sale,in,Counterparty_51,25678096.99,,
2025-05-24,5848.22,asset_sale,in,Counterparty_17,25683945.21,,
2025-05-24,459.51,rent,out,Counterparty_56,25683485.7,2025-05-06,2025-06-12
2025-05-24,342.41,investment_income,in,Counterparty_29,25683828.11,,
2025-05-24,460.8,rent,out,Counterparty_88,25683367.31,2025-05-03,2025-05-31
2025-05-24,2607.33,loan_repayment,out,Counterparty_50,25680759.98,2025-04-25,2025-05-25
2025-05-24,14466.27,asset_sale,in,Counterparty_48,25695226.25,,
2025-05-24,3645.63,credit,in,Counterparty_68,25698871.88,,
2025-05-24,15465.77,investment_income,in,Counterparty_7,25714337.65,,
2025-05-24,212.91,refund,in,Counterparty_16,25714550.56,,
2025-05-24,55615.43,refund,in,Counterparty_57,25770165.99,,
2025-05-24,3675.67,T&E,out,Counterparty_28,25766490.32,2025-04-30,2025-06-05
2025-05-24,4391.82,asset_sale,in,Counterparty_1,25770882.14,,
2025-05-24,6288.09,utilities,out,Counterparty_8,25764594.05,2025-04-16,2025-05-16
2025-05-24,3513.77,refund,in,Counterparty_78,25768107.82,,
2025-05-24,1840.52,customer_payment,in,Counterparty_10,25769948.34,,
2025-05-24,3555.1,supplier_payment,out,Counterparty_61,25766393.24,2025-05-03,2025-06-08
2025-05-24,6014.7,asset_sale,in,Counterparty_41,25772407.94,,
2025-05-24,14919.59,investment_income,in,Counterparty_11,25787327.53,,
2025-05-24,5018.17,utilities,out,Counterparty_57,25782309.36,2025-04-29,2025-05-26
2025-05-24,2530.17,software_subscription,out,Counterparty_28,25779779.19,2025-04-24,2025-05-22
2025-05-24,2452.06,supplier_payment,out,Counterparty_58,25777327.13,2025-05-09,2025-06-03
2025-05-24,658.48,payroll,out,Counterparty_81,25776668.65,2025-04-22,2025-05-29
2025-05-24,11627.88,utilities,out,Counterparty_29,25765040.77,2025-05-09,2025-06-09
2025-05-24,2146.47,supplier_payment,out,Counterparty_16,25762894.3,2025-04-21,2025-05-27
2025-05-25,1505.65,supplier_payment,out,Counterparty_86,25761388.65,2025-05-03,2025-05-31
2025-05-25,6535.11,software_subscription,out,Counterparty_78,25754853.54,2025-05-08,2025-06-12
2025-05-25,1042.67,utilities,out,Counterparty_41,25753810.87,2025-04-27,2025-05-26
2025-05-25,3464.79,supplier_payment,out,Counterparty_54,25750346.08,2025-05-10,2025-06-06
2025-05-25,678.47,supplier_payment,out,Counterparty_48,25749667.61,2025-04-12,2025-05-08
2025-05-25,12339.81,utilities,out,Counterparty_32,25737327.8,2025-04-30,2025-05-31
2025-05-25,1921.66,refund,in,Counterparty_82,25739249.46,,
2025-05-25,3672.16,credit,in,Counterparty_10,25742921.62,,
2025-05-25,41098.73,customer_payment,in,Counterparty_52,25784020.35,,
2025-05-25,1430.19,investment_income,in,Counterparty_84,25785450.54,,
2025-05-25,2848.18,refund,in,Counterparty_75,25788298.72,,
2025-05-25,4331.97,customer_payment,in,Counterparty_4,25792630.69,,
2025-05-25,5975.34,investment_income,in,Counterparty_58,25798606.03,,
2025-05-25,2726.56,credit,in,Counterparty_35,25801332.59,,
2025-05-25,6643.56,marketing_spend,out,Counterparty_82,25794689.03,2025-05-08,2025-06-08
2025-05-25,26927.04,credit,in,Counterparty_26,25821616.07,,
2025-05-25,1487.84,utilities,out,Counterparty_80,25820128.23,2025-05-01,2025-06-06
2025-05-25,1589.7,payroll,out,Counterparty_31,25818538.53,2025-04-18,2025-05-23
2025-05-25,6332.89,utilities,out,Counterparty_84,25812205.64,2025-04-13,2025-05-16
2025-05-25,3823.82,loan_repayment,out,Counterparty_88,25808381.82,2025-04-21,2025-05-17
2025-05-25,669.51,tax_payment,out,Counterparty_70,25807712.31,2025-04-16,2025-05-19
2025-05-25,1188.48,T&E,out,Counterparty_69,25806523.83,2025-04-27,2025-05-29
2025-05-25,3690.66,refund,in,Counterparty_68,25810214.49,,
2025-05-25,5503.52,asset_sale,in,Counterparty_12,25815718.01,,
2025-05-25,868.01,credit,in,Counterparty_77,25816586.02,,
2025-05-25,3170.13,customer_payment,in,Counterparty_49,25819756.15,,
2025-05-25,393.24,marketing_spend,out,Counterparty_79,25819362.91,2025-04-13,2025-05-14
2025-05-25,485.4,payroll,out,Counterparty_43,25818877.51,2025-05-01,2025-05-30
2025-05-25,10861.59,refund,in,Counterparty_31,25829739.1,,
2025-05-25,5651.19,T&E,out,Counterparty_14,25824087.91,2025-04-11,2025-05-07
2025-05-25,3399.14,utilities,out,Counterparty_23,25820688.77,2025-05-02,2025-06-10
2025-05-25,5215.22,supplier_payment,out,Counterparty_86,25815473.55,2025-05-10,2025-06-08
2025-05-25,164.72,credit,in,Counterparty_44,25815638.27,,
2025-05-25,7109.42,rent,out,Counterparty_13,25808528.85,2025-04-22,2025-05-21
2025-05-25,2422.41,asset_sale,in,Counterparty_98,25810951.26,,
2025-05-25,769.41,tax_payment,out,Counterparty_37,25810181.85,2025-05-01,2025-06-08
2025-05-25,100.98,marketing_spend,out,Counterparty_84,25810080.87,2025-04-30,2025-06-01
2025-05-25,12658.68,refund,in,Counterparty_60,25822739.55,,
2025-05-25,3213.9,asset_sale,in,Counterparty_86,25825953.45,,
2025-05-25,208.75,supplier_payment,out,Counterparty_80,25825744.7,2025-05-02,2025-06-08
2025-05-25,2664.5,tax_payment,out,Counterparty_71,25823080.2,2025-05-09,2025-06-07
2025-05-25,3651.2,tax_payment,out,Counterparty_40,25819429.0,2025-05-02,2025-06-06
2025-05-25,360.78,asset_sale,in,Counterparty_43,25819789.78,,
2025-05-25,3975.59,payroll,out,Counterparty_88,25815814.19,2025-05-08,2025-06-11
2025-05-25,2919.16,marketing_spend,out,Counterparty_53,25812895.03,2025-04-22,2025-05-19
2025-05-25,2735.74,payroll,out,Counterparty_95,25810159.29,2025-04-21,2025-05-27
2025-05-26,970.62,T&E,out,Counterparty_25,25809188.67,2025-04-17,2025-05-16
2025-05-26,1039.36,software_subscription,out,Counterparty_80,25808149.31,2025-04-18,2025-05-20
2025-05-26,1373.48,rent,out,Counterparty_95,25806775.83,2025-04-22,2025-05-28
2025-05-26,463.13,supplier_payment,out,Counterparty_36,25806312.7,2025-04-19,2025-05-17
2025-05-26,2540.04,loan_repayment,out,Counterparty_3,25803772.66,2025-04-29,2025-06-04
2025-05-26,4868.04,loan_repayment,out,Counterparty_3,25798904.62,2025-04-19,2025-05-20
2025-05-26,4570.49,T&E,out,Counterparty_45,25794334.13,2025-05-09,2025-06-05
2025-05-26,704.65,utilities,out,Counterparty_29,25793629.48,2025-05-11,2025-06-19
2025-05-26,18379.1,payroll,out,Counterparty_94,25775250.38,2025-05-04,2025-06-07
2025-05-26,639.22,investment_income,in,Counterparty_20,25775889.6,,
2025-05-26,1004.6,utilities,out,Counterparty_48,25774885.0,2025-05-03,2025-06-11
2025-05-26,1343.02,customer_payment,in,Counterparty_10,25776228.02,,
2025-05-26,5462.9,asset_sale,in,Counterparty_53,25781690.92,,
2025-05-26,697.48,loan_repayment,out,Counterparty_88,25780993.44,2025-05-07,2025-06-06
2025-05-26,15472.09,investment_income,in,Counterparty_37,25796465.53,,
2025-05-26,8787.72,investment_income,in,Counterparty_98,25805253.25,,
2025-05-26,1123.22,utilities,out,Counterparty_86,25804130.03,2025-05-10,2025-06-16
2025-05-26,359.83,marketing_spend,out,Counterparty_90,25803770.2,2025-04-14,2025-05-13
2025-05-26,5134.94,T&E,out,Counterparty_73,25798635.26,2025-05-09,2025-06-05
2025-05-26,12252.58,asset_sale,in,Counterparty_17,25810887.84,,
2025-05-26,26052.48,customer_payment,in,Counterparty_38,25836940.32,,
2025-05-26,3701.02,credit,in,Counterparty_5,25840641.34,,
2025-05-26,1025.9,software_subscription,out,Counterparty_69,25839615.44,2025-05-08,2025-06-08
2025-05-26,301.43,utilities,out,Counterparty_95,25839314.01,2025-04-22,2025-05-31
2025-05-26,1893.13,loan_repayment,out,Counterparty_61,25837420.88,2025-04-27,2025-05-22
2025-05-26,12314.63,investment_income,in,Counterparty_50,25849735.51,,
2025-05-26,149.08,asset_sale,in,Counterparty_35,25849884.59,,
2025-05-26,5334.23,customer_payment,in,Counterparty_89,25855218.82,,
2025-05-26,207.33,marketing_spend,out,Counterparty_92,25855011.49,2025-04-22,2025-05-31
2025-05-26,2382.3,loan_repayment,out,Counterparty_91,25852629.19,2025-04-19,2025-05-16
2025-05-26,275.99,tax_payment,out,Counterparty_51,25852353.2,2025-04-13,2025-05-20
2025-05-26,2141.19,marketing_spend,out,Counterparty_17,25850212.01,2025-05-04,2025-05-29
2025-05-26,184.29,rent,out,Counterparty_92,25850027.72,2025-04-14,2025-05-19
2025-05-26,640.06,marketing_spend,out,Counterparty_59,25849387.66,2025-05-01,2025-06-06
2025-05-26,541.42,T&E,out,Counterparty_28,25848846.24,2025-05-11,2025-06-11
2025-05-26,724.82,loan_repayment,out,Counterparty_71,25848121.42,2025-04-23,2025-05-26
2025-05-26,384.98,loan_repayment,out,Counterparty_87,25847736.44,2025-04-21,2025-05-25
2025-05-26,10173.86,supplier_payment,out,Counterparty_68,25837562.58,2025-05-05,2025-06-09
2025-05-26,8856.66,rent,out,Counterparty_31,25828705.92,2025-04-27,2025-05-31
2025-05-26,12769.0,credit,in,Counterparty_3,25841474.92,,
2025-05-26,2838.95,tax_payment,out,Counterparty_34,25838635.97,2025-04-13,2025-05-12
2025-05-26,6608.17,refund,in,Counterparty_26,25845244.14,,
2025-05-26,571.39,tax_payment,out,Counterparty_83,25844672.75,2025-05-02,2025-06-02
2025-05-26,2042.5,loan_repayment,out,Counterparty_46,25842630.25,2025-04-19,2025-05-14
2025-05-26,10285.24,investment_income,in,Counterparty_24,25852915.49,,
2025-05-26,1338.31,marketing_spend,out,Counterparty_84,25851577.18,2025-04-29,2025-05-31
2025-05-26,16329.16,credit,in,Counterparty_19,25867906.34,,
2025-05-26,3325.05,marketing_spend,out,Counterparty_83,25864581.29,2025-04-17,2025-05-15
2025-05-26,1534.68,loan_repayment,out,Counterparty_2,25863046.61,2025-04-13,2025-05-17
2025-05-26,1719.56,tax_payment,out,Counterparty_99,25861327.05,2025-04-30,2025-06-07
2025-05-26,7106.17,T&E,out,Counterparty_93,25854220.88,2025-04-22,2025-05-28
2025-05-26,15202.2,T&E,out,Counterparty_20,25839018.68,2025-05-08,2025-06-15
2025-05-26,13447.68,customer_payment,in,Counterparty_74,25852466.36,,
2025-05-26,18.95,loan_repayment,out,Counterparty_51,25852447.41,2025-05-03,2025-06-02
2025-05-27,1901.3,tax_payment,out,Counterparty_38,25850546.11,2025-05-12,2025-06-09
2025-05-27,256.76,T&E,out,Counterparty_63,25850289.35,2025-04-14,2025-05-14
2025-05-27,6448.32,investment_income,in,Counterparty_8,25856737.67,,
2025-05-27,1878.1,payroll,out,Counterparty_50,25854859.57,2025-05-06,2025-06-13
2025-05-27,17.65,investment_income,in,Counterparty_19,25854877.22,,
2025-05-27,658.43,customer_payment,in,Counterparty_56,25855535.65,,
2025-05-27,1512.61,tax_payment,out,Counterparty_91,25854023.04,2025-05-01,2025-05-28
2025-05-27,21.01,utilities,out,Counterparty_66,25854002.03,2025-04-16,2025-05-15
2025-05-27,31.93,supplier_payment,out,Counterparty_84,25853970.1,2025-04-13,2025-05-20
2025-05-27,1022.24,refund,in,Counterparty_3,25854992.34,,
2025-05-27,621.05,customer_payment,in,Counterparty_35,25855613.39,,
2025-05-27,1063.28,investment_income,in,Counterparty_90,25856676.67,,
2025-05-27,1697.19,customer_payment,in,Counterparty_40,25858373.86,,
2025-05-27,5520.98,T&E,out,Counterparty_44,25852852.88,2025-04-22,2025-05-23
2025-05-27,1903.04,supplier_payment,out,Counterparty_18,25850949.84,2025-05-07,2025-06-09
2025-05-27,22368.15,asset_sale,in,Counterparty_52,25873317.99,,
2025-05-27,753.45,rent,out,Counterparty_36,25872564.54,2025-04-20,2025-05-25
2025-05-27,1631.73,refund,in,Counterparty_39,25874196.27,,
2025-05-27,852.49,rent,out,Counterparty_94,25873343.78,2025-05-09,2025-06-11
2025-05-27,6231.83,investment_income,in,Counterparty_21,25879575.61,,
2025-05-27,752.47,T&E,out,Counterparty_59,25878823.14,2025-05-02,2025-06-10
2025-05-27,1956.05,utilities,out,Counterparty_42,25876867.09,2025-04-23,2025-06-01
2025-05-27,15043.0,investment_income,in,Counterparty_1,25891910.09,,
2025-05-27,2912.72,customer_payment,in,Counterparty_23,25894822.81,,
2025-05-27,2949.69,credit,in,Counterparty_44,25897772.5,,
2025-05-27,936.04,software_subscription,out,Counterparty_28,25896836.46,2025-04-21,2025-05-18
2025-05-27,10624.23,investment_income,in,Counterparty_63,25907460.69,,
2025-05-27,4282.33,investment_income,in,Counterparty_44,25911743.02,,
2025-05-27,14766.64,refund,in,Counterparty_11,25926509.66,,
2025-05-27,14586.46,rent,out,Counterparty_49,25911923.2,2025-04-21,2025-05-20
2025-05-27,2395.02,tax_payment,out,Counterparty_42,25909528.18,2025-04-28,2025-05-31
2025-05-27,9659.6,customer_payment,in,Counterparty_28,25919187.78,,
2025-05-27,2344.08,asset_sale,in,Counterparty_1,25921531.86,,
2025-05-27,1456.14,credit,in,Counterparty_28,25922988.0,,
2025-05-27,7681.6,supplier_payment,out,Counterparty_86,25915306.4,2025-05-11,2025-06-07
2025-05-27,59717.5,asset_sale,in,Counterparty_52,25975023.9,,
2025-05-27,625.97,credit,in,Counterparty_88,25975649.87,,
2025-05-27,382.35,supplier_payment,out,Counterparty_68,25975267.52,2025-04-24,2025-06-02
2025-05-27,1516.66,rent,out,Counterparty_53,25973750.86,2025-05-10,2025-06-11
2025-05-27,1630.63,T&E,out,Counterparty_36,25972120.23,2025-05-05,2025-06-03
2025-05-27,2547.04,loan_repayment,out,Counterparty_43,25969573.19,2025-04-29,2025-06-03
2025-05-27,1712.38,refund,in,Counterparty_19,25971285.57,,
2025-05-27,14642.73,credit,in,Counterparty_97,25985928.3,,
2025-05-27,821.6,marketing_spend,out,Counterparty_53,25985106.7,2025-05-03,2025-06-04
2025-05-27,5058.11,asset_sale,in,Counterparty_34,25990164.81,,
2025-05-27,5032.96,marketing_spend,out,Counterparty_6,25985131.85,2025-04-15,2025-05-24
2025-05-27,7207.03,credit,in,Counterparty_14,25992338.88,,
2025-05-27,3037.75,utilities,out,Counterparty_16,25989301.13,2025-05-05,2025-06-06
2025-05-27,3956.59,asset_sale,in,Counterparty_58,25993257.72,,
2025-05-27,277.01,refund,in,Counterparty_38,25993534.73,,
2025-05-27,795.66,loan_repayment,out,Counterparty_75,25992739.07,2025-04-27,2025-05-23
2025-05-27,875.47,loan_repayment,out,Counterparty_18,25991863.6,2025-05-09,2025-06-13
2025-05-27,4971.11,T&E,out,Counterparty_79,25986892.49,2025-05-01,2025-05-31
2025-05-27,884.37,loan_repayment,out,Counterparty_44,25986008.12,2025-04-21,2025-05-22
2025-05-28,6394.7,utilities,out,Counterparty_30,25979613.42,2025-05-13,2025-06-15
2025-05-28,4239.13,software_subscription,out,Counterparty_68,25975374.29,2025-04-26,2025-05-24
2025-05-28,1473.15,T&E,out,Counterparty_65,25973901.14,2025-04-24,2025-05-24
2025-05-28,8647.33,tax_payment,out,Counterparty_48,25965253.81,2025-04-17,2025-05-17
2025-05-28,2387.08,refund,in,Counterparty_11,25967640.89,,
2025-05-28,11316.11,utilities,out,Counterparty_20,25956324.78,2025-05-13,2025-06-19
2025-05-28,13025.34,credit,in,Counterparty_12,25969350.12,,
2025-05-28,556.84,customer_payment,in,Counterparty_83,25969906.96,,
2025-05-28,1975.34,rent,out,Counterparty_20,25967931.62,2025-04-23,2025-05-24
2025-05-28,519.19,tax_payment,out,Counterparty_5,25967412.43,2025-04-25,2025-05-28
2025-05-28,214.35,supplier_payment,out,Counterparty_75,25967198.08,2025-05-10,2025-06-04
2025-05-28,9721.49,asset_sale,in,Counterparty_33,25976919.57,,
2025-05-28,113.73,payroll,out,Counterparty_44,25976805.84,2025-04-19,2025-05-21
2025-05-28,3318.76,tax_payment,out,Counterparty_86,25973487.08,2025-05-12,2025-06-10
2025-05-28,1468.74,payroll,out,Counterparty_27,25972018.34,2025-04-22,2025-05-21
2025-05-28,2310.93,software_subscription,out,Counterparty_86,25969707.41,2025-04-26,2025-05-23
2025-05-28,3546.09,supplier_payment,out,Counterparty_74,25966161.32,2025-05-09,2025-06-03
2025-05-28,4700.02,customer_payment,in,Counterparty_32,25970861.34,,
2025-05-28,311.26,software_subscription,out,Counterparty_4,25970550.08,2025-05-07,2025-06-15
2025-05-28,1708.17,T&E,out,Counterparty_32,25968841.91,2025-04-18,2025-05-24
2025-05-28,6073.58,T&E,out,Counterparty_17,25962768.33,2025-05-13,2025-06-21
2025-05-28,3944.52,credit,in,Counterparty_73,25966712.85,,
2025-05-28,14940.14,credit,in,Counterparty_98,25981652.99,,
2025-05-28,3999.99,payroll,out,Counterparty_10,25977653.0,2025-05-02,2025-06-07
2025-05-28,4997.11,T&E,out,Counterparty_79,25972655.89,2025-05-01,2025-05-26
2025-05-28,169.57,tax_payment,out,Counterparty_52,25972486.32,2025-05-10,2025-06-09
2025-05-28,3344.52,customer_payment,in,Counterparty_99,25975830.84,,
2025-05-28,1424.11,supplier_payment,out,Counterparty_26,25974406.73,2025-05-08,2025-06-04
2025-05-28,6525.1,investment_income,in,Counterparty_33,25980931.83,,
2025-05-28,6072.15,supplier_payment,out,Counterparty_58,25974859.68,2025-04-25,2025-05-30
2025-05-28,12308.03,investment_income,in,Counterparty_17,25987167.71,,
2025-05-28,5186.31,refund,in,Counterparty_57,25992354.02,,
2025-05-28,10173.01,customer_payment,in,Counterparty_73,26002527.03,,
2025-05-28,2823.13,marketing_spend,out,Counterparty_1,25999703.9,2025-04-20,2025-05-22
2025-05-28,1812.65,loan_repayment,out,Counterparty_54,25997891.25,2025-04-27,2025-06-02
2025-05-28,771.53,refund,in,Counterparty_52,25998662.78,,
2025-05-28,10.83,payroll,out,Counterparty_27,25998651.95,2025-05-02,2025-06-01
2025-05-28,4894.76,payroll,out,Counterparty_18,25993757.19,2025-04-29,2025-06-02
2025-05-28,56.22,marketing_spend,out,Counterparty_53,25993700.97,2025-05-02,2025-06-05
2025-05-28,1217.8,tax_payment,out,Counterparty_73,25992483.17,2025-04-17,2025-05-24
2025-05-28,720.06,marketing_spend,out,Counterparty_43,25991763.11,2025-05-02,2025-06-09
2025-05-28,14441.91,T&E,out,Counterparty_92,25977321.2,2025-05-11,2025-06-10
2025-05-28,1539.58,payroll,out,Counterparty_76,25975781.62,2025-05-08,2025-06-05
2025-05-28,6906.01,supplier_payment,out,Counterparty_15,25968875.61,2025-04-17,2025-05-17
2025-05-28,1368.06,utilities,out,Counterparty_88,25967507.55,2025-05-07,2025-06-05
2025-05-28,5106.52,rent,out,Counterparty_12,25962401.03,2025-04-15,2025-05-13
2025-05-28,5888.2,refund,in,Counterparty_53,25968289.23,,
2025-05-28,4577.94,utilities,out,Counterparty_85,25963711.29,2025-04-21,2025-05-23
2025-05-28,3605.56,utilities,out,Counterparty_93,25960105.73,2025-04-30,2025-05-31
2025-05-28,875.78,utilities,out,Counterparty_17,25959229.95,2025-05-02,2025-06-07
2025-05-28,893.71,T&E,out,Counterparty_73,25958336.24,2025-04-14,2025-05-10
2025-05-28,18420.11,refund,in,Counterparty_9,25976756.35,,
2025-05-28,3379.79,payroll,out,Counterparty_34,25973376.56,2025-05-06,2025-06-04
2025-05-28,1624.17,loan_repayment,out,Counterparty_3,25971752.39,2025-05-12,2025-06-08
2025-05-29,4428.73,rent,out,Counterparty_82,25967323.66,2025-04-23,2025-05-19
2025-05-29,1022.84,utilities,out,Counterparty_40,25966300.82,2025-04-29,2025-05-25
2025-05-29,16327.32,asset_sale,in,Counterparty_33,25982628.14,,
2025-05-29,3334.66,T&E,out,Counterparty_52,25979293.48,2025-05-11,2025-06-10
2025-05-29,5025.55,rent,out,Counterparty_65,25974267.93,2025-05-08,2025-06-11
2025-05-29,584.47,software_subscription,out,Counterparty_4,25973683.46,2025-05-02,2025-05-27
2025-05-29,5097.91,tax_payment,out,Counterparty_84,25968585.55,2025-05-11,2025-06-17
2025-05-29,3674.27,software_subscription,out,Counterparty_95,25964911.28,2025-04-15,2025-05-24
2025-05-29,2212.15,marketing_spend,out,Counterparty_5,25962699.13,2025-04-17,2025-05-20
2025-05-29,3455.45,credit,in,Counterparty_72,25966154.58,,
2025-05-29,2832.1,T&E,out,Counterparty_47,25963322.48,2025-05-13,2025-06-08
2025-05-29,2612.77,rent,out,Counterparty_87,25960709.71,2025-05-05,2025-05-30
2025-05-29,3405.93,customer_payment,in,Counterparty_46,25964115.64,,
2025-05-29,566.37,payroll,out,Counterparty_47,25963549.27,2025-04-15,2025-05-17
2025-05-29,3188.17,T&E,out,Counterparty_3,25960361.1,2025-05-10,2025-06-10
2025-05-29,539.23,payroll,out,Counterparty_86,25959821.87,2025-04-16,2025-05-19
2025-05-29,6486.35,asset_sale,in,Counterparty_85,25966308.22,,
2025-05-29,5118.82,credit,in,Counterparty_39,25971427.04,,
2025-05-29,3262.91,tax_payment,out,Counterparty_7,25968164.13,2025-04-23,2025-05-23
2025-05-29,4485.43,asset_sale,in,Counterparty_38,25972649.56,,
2025-05-29,12849.61,asset_sale,in,Counterparty_45,25985499.17,,
2025-05-29,3079.03,customer_payment,in,Counterparty_44,25988578.2,,
2025-05-29,3516.25,marketing_spend,out,Counterparty_87,25985061.95,2025-04-20,2025-05-22
2025-05-29,18461.81,marketing_spend,out,Counterparty_95,25966600.14,2025-05-10,2025-06-07
2025-05-29,1918.46,credit,in,Counterparty_69,25968518.6,,
2025-05-29,2358.44,credit,in,Counterparty_74,25970877.04,,
2025-05-29,10204.41,asset_sale,in,Counterparty_56,25981081.45,,
2025-05-29,1846.56,supplier_payment,out,Counterparty_30,25979234.89,2025-05-05,2025-06-04
2025-05-29,17515.28,loan_repayment,out,Counterparty_54,25961719.61,2025-05-05,2025-05-31
2025-05-29,240.16,software_subscription,out,Counterparty_33,25961479.45,2025-05-03,2025-06-11
2025-05-29,724.97,refund,in,Counterparty_77,25962204.42,,
2025-05-29,5524.9,software_subscription,out,Counterparty_27,25956679.52,2025-04-16,2025-05-17
2025-05-29,1595.65,software_subscription,out,Counterparty_56,25955083.87,2025-05-01,2025-06-06
2025-05-29,14076.08,refund,in,Counterparty_92,25969159.95,,
2025-05-29,876.24,investment_income,in,Counterparty_99,25970036.19,,
2025-05-29,10066.61,credit,in,Counterparty_58,25980102.8,,
2025-05-29,5172.39,customer_payment,in,Counterparty_75,25985275.19,,
2025-05-29,2303.33,customer_payment,in,Counterparty_37,25987578.52,,
2025-05-29,121.17,utilities,out,Counterparty_79,25987457.35,2025-05-09,2025-06-16
2025-05-29,1819.28,loan_repayment,out,Counterparty_17,25985638.07,2025-05-13,2025-06-17
2025-05-29,1362.13,asset_sale,in,Counterparty_73,25987000.2,,
2025-05-29,876.16,marketing_spend,out,Counterparty_39,25986124.04,2025-04-24,2025-05-21
2025-05-29,3809.38,marketing_spend,out,Counterparty_24,25982314.66,2025-05-10,2025-06-17
2025-05-29,3667.58,rent,out,Counterparty_29,25978647.08,2025-05-07,2025-06-09
2025-05-29,5777.36,software_subscription,out,Counterparty_91,25972869.72,2025-05-05,2025-05-31
2025-05-29,7402.82,rent,out,Counterparty_54,25965466.9,2025-04-20,2025-05-20
2025-05-29,2301.38,rent,out,Counterparty_51,25963165.52,2025-05-10,2025-06-09
2025-05-29,7368.97,utilities,out,Counterparty_3,25955796.55,2025-05-01,2025-06-03
2025-05-29,1783.06,investment_income,in,Counterparty_71,25957579.61,,
2025-05-29,1171.1,marketing_spend,out,Counterparty_49,25956408.51,2025-04-20,2025-05-24
2025-05-29,1364.8,utilities,out,Counterparty_24,25955043.71,2025-04-25,2025-06-01
2025-05-29,4318.92,utilities,out,Counterparty_75,25950724.79,2025-04-21,2025-05-26
2025-05-30,2588.44,supplier_payment,out,Counterparty_42,25948136.35,2025-04-29,2025-05-26
2025-05-30,803.48,asset_sale,in,Counterparty_80,25948939.83,,
2025-05-30,1056.04,supplier_payment,out,Counterparty_50,25947883.79,2025-04-27,2025-05-26
2025-05-30,384.04,software_subscription,out,Counterparty_64,25947499.75,2025-04-16,2025-05-13
2025-05-30,817.89,loan_repayment,out,Counterparty_19,25946681.86,2025-04-19,2025-05-17
2025-05-30,2932.61,software_subscription,out,Counterparty_14,25943749.25,2025-05-08,2025-06-15
2025-05-30,1061.69,T&E,out,Counterparty_81,25942687.56,2025-05-15,2025-06-20
2025-05-30,13943.96,refund,in,Counterparty_56,25956631.52,,
2025-05-30,3980.98,T&E,out,Counterparty_73,25952650.54,2025-04-24,2025-05-27
2025-05-30,2391.19,T&E,out,Counterparty_51,25950259.35,2025-05-12,2025-06-07
2025-05-30,7259.57,software_subscription,out,Counterparty_68,25942999.78,2025-04-30,2025-05-31
2025-05-30,3066.21,tax_payment,out,Counterparty_48,25939933.57,2025-05-11,2025-06-05
2025-05-30,3525.37,customer_payment,in,Counterparty_25,25943458.94,,
2025-05-30,14334.08,customer_payment,in,Counterparty_47,25957793.02,,
2025-05-30,186.29,marketing_spend,out,Counterparty_8,25957606.73,2025-05-04,2025-05-31
2025-05-30,2402.67,tax_payment,out,Counterparty_28,25955204.06,2025-04-24,2025-05-26
2025-05-30,1243.9,investment_income,in,Counterparty_10,25956447.96,,
2025-05-30,17001.45,asset_sale,in,Counterparty_49,25973449.41,,
2025-05-30,2505.4,loan_repayment,out,Counterparty_25,25970944.01,2025-04-27,2025-05-29
2025-05-30,3864.72,customer_payment,in,Counterparty_32,25974808.73,,
2025-05-30,9581.14,software_subscription,out,Counterparty_66,25965227.59,2025-04-26,2025-05-26
2025-05-30,1302.77,utilities,out,Counterparty_68,25963924.82,2025-05-09,2025-06-05
2025-05-30,1790.81,loan_repayment,out,Counterparty_19,25962134.01,2025-05-04,2025-06-04
2025-05-30,1608.45,investment_income,in,Counterparty_20,25963742.46,,
2025-05-30,1250.85,supplier_payment,out,Counterparty_76,25962491.61,2025-04-30,2025-05-28
2025-05-30,2652.66,refund,in,Counterparty_4,25965144.27,,
2025-05-30,27451.39,refund,in,Counterparty_55,25992595.66,,
2025-05-30,8555.65,refund,in,Counterparty_34,26001151.31,,
2025-05-30,46.03,supplier_payment,out,Counterparty_44,26001105.28,2025-04-24,2025-05-19
2025-05-30,6351.61,asset_sale,in,Counterparty_80,26007456.89,,
2025-05-30,536.1,customer_payment,in,Counterparty_96,26007992.99,,
2025-05-30,14056.53,investment_income,in,Counterparty_64,26022049.52,,
2025-05-30,14209.52,payroll,out,Counterparty_35,26007840.0,2025-05-07,2025-06-11
2025-05-30,4422.11,tax_payment,out,Counterparty_35,26003417.89,2025-05-09,2025-06-03
2025-05-30,3563.19,investment_income,in,Counterparty_43,26006981.08,,
2025-05-30,2013.3,marketing_spend,out,Counterparty_93,26004967.78,2025-04-17,2025-05-16
2025-05-30,2710.81,marketing_spend,out,Counterparty_22,26002256.97,2025-04-18,2025-05-16
2025-05-30,635.76,marketing_spend,out,Counterparty_29,26001621.21,2025-04-22,2025-05-23
2025-05-30,46.41,tax_payment,out,Counterparty_21,26001574.8,2025-04-17,2025-05-23
2025-05-30,1504.6,tax_payment,out,Counterparty_22,26000070.2,2025-04-17,2025-05-21
2025-05-30,1772.72,loan_repayment,out,Counterparty_30,25998297.48,2025-04-29,2025-05-28
2025-05-30,1901.39,supplier_payment,out,Counterparty_56,25996396.09,2025-04-22,2025-05-28
2025-05-30,4925.28,supplier_payment,out,Counterparty_13,25991470.81,2025-04-20,2025-05-24
2025-05-30,5693.13,payroll,out,Counterparty_53,25985777.68,2025-05-02,2025-05-28
2025-05-30,1704.71,refund,in,Counterparty_55,25987482.39,,
2025-05-30,5352.03,utilities,out,Counterparty_32,25982130.36,2025-05-04,2025-06-09
2025-05-30,120.26,refund,in,Counterparty_91,25982250.62,,
2025-05-30,929.24,investment_income,in,Counterparty_98,25983179.86,,
2025-05-30,2592.41,refund,in,Counterparty_23,25985772.27,,
2025-05-31,6059.29,refund,in,Counterparty_94,25991831.56,,
2025-05-31,8053.17,investment_income,in,Counterparty_25,25999884.73,,
2025-05-31,2939.92,investment_income,in,Counterparty_39,26002824.65,,
2025-05-31,1139.77,refund,in,Counterparty_85,26003964.42,,
2025-05-31,2025.12,investment_income,in,Counterparty_74,26005989.54,,
2025-05-31,5718.96,credit,in,Counterparty_75,26011708.5,,
2025-05-31,21898.53,asset_sale,in,Counterparty_3,26033607.03,,
2025-05-31,30149.6,asset_sale,in,Counterparty_52,26063756.63,,
2025-05-31,656.2,credit,in,Counterparty_2,26064412.83,,
2025-05-31,3190.27,asset_sale,in,Counterparty_80,26067603.1,,
2025-05-31,1921.16,T&E,out,Counterparty_76,26065681.94,2025-05-09,2025-06-12
2025-05-31,10629.33,investment_income,in,Counterparty_83,26076311.27,,
2025-05-31,2030.57,asset_sale,in,Counterparty_17,26078341.84,,
2025-05-31,6352.09,customer_payment,in,Counterparty_72,26084693.93,,
2025-05-31,806.1,asset_sale,in,Counterparty_61,26085500.03,,
2025-05-31,6379.09,investment_income,in,Counterparty_68,26091879.12,,
2025-05-31,456.23,asset_sale,in,Counterparty_92,26092335.35,,
2025-05-31,19557.35,investment_income,in,Counterparty_84,26111892.7,,
2025-05-31,7308.13,tax_payment,out,Counterparty_27,26104584.57,2025-05-11,2025-06-06
2025-05-31,2400.2,marketing_spend,out,Counterparty_53,26102184.37,2025-05-10,2025-06-05
2025-05-31,32641.08,investment_income,in,Counterparty_69,26134825.45,,
2025-05-31,4850.39,T&E,out,Counterparty_54,26129975.06,2025-05-05,2025-06-12
2025-05-31,1571.28,marketing_spend,out,Counterparty_12,26128403.78,2025-04-23,2025-06-01
2025-05-31,2214.19,utilities,out,Counterparty_45,26126189.59,2025-05-05,2025-06-11
2025-05-31,14845.95,rent,out,Counterparty_1,26111343.64,2025-04-18,2025-05-22
2025-05-31,3011.45,utilities,out,Counterparty_17,26108332.19,2025-04-22,2025-05-26
2025-05-31,228.71,utilities,out,Counterparty_10,26108103.48,2025-05-05,2025-06-02
2025-05-31,10973.37,investment_income,in,Counterparty_15,26119076.85,,
2025-05-31,891.98,payroll,out,Counterparty_62,26118184.87,2025-04-20,2025-05-28
2025-05-31,1932.55,investment_income,in,Counterparty_22,26120117.42,,
2025-05-31,1355.96,T&E,out,Counterparty_1,26118761.46,2025-04-28,2025-06-04
2025-05-31,10773.37,rent,out,Counterparty_36,26107988.09,2025-05-09,2025-06-08
2025-05-31,231.03,rent,out,Counterparty_32,26107757.06,2025-05-07,2025-06-08
2025-05-31,7461.02,investment_income,in,Counterparty_92,26115218.08,,
2025-05-31,2842.22,refund,in,Counterparty_41,26118060.3,,
2025-05-31,655.33,loan_repayment,out,Counterparty_41,26117404.97,2025-05-08,2025-06-07
2025-05-31,212.9,tax_payment,out,Counterparty_70,26117192.07,2025-04-27,2025-05-27
2025-05-31,9875.73,rent,out,Counterparty_77,26107316.34,2025-05-09,2025-06-03
2025-05-31,3274.0,asset_sale,in,Counterparty_58,26110590.34,,
2025-05-31,1593.18,T&E,out,Counterparty_18,26108997.16,2025-05-14,2025-06-19
2025-05-31,538.07,credit,in,Counterparty_49,26109535.23,,
2025-05-31,8297.82,rent,out,Counterparty_63,26101237.41,2025-04-30,2025-06-03
2025-05-31,1405.07,supplier_payment,out,Counterparty_94,26099832.34,2025-04-17,2025-05-24
2025-05-31,2230.76,loan_repayment,out,Counterparty_42,26097601.58,2025-05-10,2025-06-14
2025-05-31,311.28,utilities,out,Counterparty_5,26097290.3,2025-04-24,2025-05-27
2025-05-31,2651.88,refund,in,Counterparty_71,26099942.18,,
2025-05-31,3442.72,software_subscription,out,Counterparty_14,26096499.46,2025-04-24,2025-05-22
2025-05-31,7965.66,rent,out,Counterparty_96,26088533.8,2025-04-17,2025-05-23
2025-05-31,2326.06,T&E,out,Counterparty_40,26086207.74,2025-05-16,2025-06-24
2025-05-31,1867.87,T&E,out,Counterparty_69,26084339.87,2025-04-18,2025-05-25
2025-05-31,357.48,T&E,out,Counterparty_94,26083982.39,2025-05-10,2025-06-13
2025-05-31,12380.86,refund,in,Counterparty_97,26096363.25,,
2025-05-31,1718.49,loan_repayment,out,Counterparty_95,26094644.76,2025-04-28,2025-06-03
2025-05-31,23212.1,credit,in,Counterparty_10,26117856.86,,
2025-06-01,10160.02,T&E,out,Counterparty_67,26107696.84,2025-04-30,2025-05-31
2025-06-01,958.88,utilities,out,Counterparty_49,26106737.96,2025-05-04,2025-06-08
2025-06-01,10794.1,asset_sale,in,Counterparty_51,26117532.06,,
2025-06-01,207.15,loan_repayment,out,Counterparty_38,26117324.91,2025-05-11,2025-06-13
2025-06-01,388.12,asset_sale,in,Counterparty_43,26117713.03,,
2025-06-01,7554.22,customer_payment,in,Counterparty_72,26125267.25,,
2025-06-01,8101.02,asset_sale,in,Counterparty_70,26133368.27,,
2025-06-01,3897.25,credit,in,Counterparty_15,26137265.52,,
2025-06-01,12390.41,payroll,out,Counterparty_16,26124875.11,2025-04-21,2025-05-28
2025-06-01,4389.47,payroll,out,Counterparty_13,26120485.64,2025-05-06,2025-06-05
2025-06-01,10243.52,investment_income,in,Counterparty_92,26130729.16,,
2025-06-01,1736.43,tax_payment,out,Counterparty_56,26128992.73,2025-05-14,2025-06-20
2025-06-01,763.4,marketing_spend,out,Counterparty_83,26128229.33,2025-05-10,2025-06-15
2025-06-01,251.63,T&E,out,Counterparty_43,26127977.7,2025-04-23,2025-05-21
2025-06-01,6479.54,T&E,out,Counterparty_79,26121498.16,2025-05-01,2025-05-26
2025-06-01,9476.99,marketing_spend,out,Counterparty_27,26112021.17,2025-05-01,2025-05-29
2025-06-01,47.72,T&E,out,Counterparty_48,26111973.45,2025-04-30,2025-05-26
2025-06-01,254.93,customer_payment,in,Counterparty_89,26112228.38,,
2025-06-01,3488.24,loan_repayment,out,Counterparty_4,26108740.14,2025-04-22,2025-05-20
2025-06-01,11200.32,refund,in,Counterparty_56,26119940.46,,
2025-06-01,4584.9,refund,in,Counterparty_17,26124525.36,,
2025-06-01,379.76,software_subscription,out,Counterparty_87,26124145.6,2025-05-01,2025-06-05
2025-06-01,607.1,utilities,out,Counterparty_91,26123538.5,2025-04-23,2025-05-22
2025-06-01,8534.51,customer_payment,in,Counterparty_95,26132073.01,,
2025-06-01,14370.98,credit,in,Counterparty_31,26146443.99,,
2025-06-01,2113.47,supplier_payment,out,Counterparty_26,26144330.52,2025-04-18,2025-05-15
2025-06-01,2505.93,refund,in,Counterparty_50,26146836.45,,
2025-06-01,632.58,supplier_payment,out,Counterparty_72,26146203.87,2025-04-19,2025-05-17
2025-06-01,4290.96,tax_payment,out,Counterparty_31,26141912.91,2025-05-13,2025-06-15
2025-06-01,3348.03,tax_payment,out,Counterparty_71,26138564.88,2025-05-06,2025-06-10
2025-06-01,1107.53,software_subscription,out,Counterparty_91,26137457.35,2025-05-04,2025-05-29
2025-06-01,8824.99,refund,in,Counterparty_94,26146282.34,,
2025-06-01,2126.29,refund,in,Counterparty_10,26148408.63,,
2025-06-01,681.74,loan_repayment,out,Counterparty_97,26147726.89,2025-04-21,2025-05-27
2025-06-01,3416.95,T&E,out,Counterparty_73,26144309.94,2025-04-23,2025-05-24
2025-06-01,399.3,T&E,out,Counterparty_70,26143910.64,2025-04-20,2025-05-15
2025-06-01,5662.59,refund,in,Counterparty_30,26149573.23,,
2025-06-01,8025.52,refund,in,Counterparty_21,26157598.75,,
2025-06-01,4048.72,T&E,out,Counterparty_97,26153550.03,2025-05-04,2025-06-04
2025-06-01,2977.39,utilities,out,Counterparty_88,26150572.64,2025-05-09,2025-06-06
2025-06-01,836.92,loan_repayment,out,Counterparty_71,26149735.72,2025-05-09,2025-06-11
2025-06-01,3915.54,customer_payment,in,Counterparty_40,26153651.26,,
2025-06-01,2979.02,loan_repayment,out,Counterparty_96,26150672.24,2025-04-26,2025-05-22
2025-06-01,4836.76,investment_income,in,Counterparty_33,26155509.0,,
2025-06-01,7714.01,investment_income,in,Counterparty_11,26163223.01,,
2025-06-01,840.36,T&E,out,Counterparty_99,26162382.65,2025-05-17,2025-06-18
2025-06-01,2371.65,credit,in,Counterparty_44,26164754.3,,
2025-06-01,206.17,payroll,out,Counterparty_2,26164548.13,2025-05-05,2025-06-12
2025-06-01,170.6,investment_income,in,Counterparty_87,26164718.73,,
2025-06-01,1563.7,utilities,out,Counterparty_52,26163155.03,2025-05-17,2025-06-14
2025-06-01,974.65,loan_repayment,out,Counterparty_93,26162180.38,2025-05-13,2025-06-07
2025-06-01,3543.5,asset_sale,in,Counterparty_83,26165723.88,,
2025-06-01,7109.84,tax_payment,out,Counterparty_58,26158614.04,2025-05-15,2025-06-16
2025-06-01,394.48,rent,out,Counterparty_99,26158219.56,2025-04-20,2025-05-17
2025-06-01,1057.39,investment_income,in,Counterparty_4,26159276.95,,
2025-06-01,1723.35,marketing_spend,out,Counterparty_49,26157553.6,2025-05-07,2025-06-04
2025-06-01,142.71,refund,in,Counterparty_50,26157696.31,,
2025-06-01,181.93,credit,in,Counterparty_27,26157878.24,,
2025-06-01,9038.01,asset_sale,in,Counterparty_74,26166916.25,,
2025-06-01,8652.89,asset_sale,in,Counterparty_92,26175569.14,,
2025-06-01,3241.7,refund,in,Counterparty_99,26178810.84,,
2025-06-01,725.72,rent,out,Counterparty_2,26178085.12,2025-04-26,2025-05-30
2025-06-01,6611.7,investment_income,in,Counterparty_7,26184696.82,,
2025-06-01,6711.43,T&E,out,Counterparty_92,26177985.39,2025-04-28,2025-05-28
2025-06-02,3406.09,loan_repayment,out,Counterparty_42,26174579.3,2025-05-15,2025-06-17
2025-06-02,1355.01,utilities,out,Counterparty_65,26173224.29,2025-05-05,2025-05-30
2025-06-02,13982.37,customer_payment,in,Counterparty_33,26187206.66,,
2025-06-02,5749.19,rent,out,Counterparty_37,26181457.47,2025-05-10,2025-06-12
2025-06-02,6860.71,T&E,out,Counterparty_43,26174596.76,2025-04-21,2025-05-17
2025-06-02,1311.02,payroll,out,Counterparty_58,26173285.74,2025-04-28,2025-06-01
2025-06-02,2111.47,payroll,out,Counterparty_41,26171174.27,2025-04-28,2025-06-05
2025-06-02,7411.43,asset_sale,in,Counterparty_19,26178585.7,,
2025-06-02,11253.09,asset_sale,in,Counterparty_31,26189838.79,,
2025-06-02,95.47,payroll,out,Counterparty_79,26189743.32,2025-04-25,2025-06-01
2025-06-02,533.14,supplier_payment,out,Counterparty_80,26189210.18,2025-04-21,2025-05-23
2025-06-02,2213.16,payroll,out,Counterparty_25,26186997.02,2025-04-29,2025-06-03
2025-06-02,15316.64,customer_payment,in,Counterparty_7,26202313.66,,
2025-06-02,11525.81,asset_sale,in,Counterparty_6,26213839.47,,
2025-06-02,1673.25,refund,in,Counterparty_46,26215512.72,,
2025-06-02,848.14,loan_repayment,out,Counterparty_65,26214664.58,2025-05-01,2025-06-01
2025-06-02,1393.7,customer_payment,in,Counterparty_57,26216058.28,,
2025-06-02,6104.37,customer_payment,in,Counterparty_17,26222162.65,,
2025-06-02,8162.99,T&E,out,Counterparty_85,26213999.66,2025-04-28,2025-05-27
2025-06-02,7260.68,asset_sale,in,Counterparty_36,26221260.34,,
2025-06-02,5907.91,tax_payment,out,Counterparty_47,26215352.43,2025-05-06,2025-06-07
2025-06-02,4012.61,payroll,out,Counterparty_41,26211339.82,2025-04-26,2025-05-25
2025-06-02,10816.12,payroll,out,Counterparty_93,26200523.7,2025-05-11,2025-06-17
2025-06-02,1756.79,payroll,out,Counterparty_19,26198766.91,2025-04-25,2025-05-20
2025-06-02,6539.9,marketing_spend,out,Counterparty_17,26192227.01,2025-05-10,2025-06-14
2025-06-02,1109.82,rent,out,Counterparty_39,26191117.19,2025-04-20,2025-05-19
2025-06-02,1450.96,refund,in,Counterparty_66,26192568.15,,
2025-06-02,316.77,software_subscription,out,Counterparty_96,26192251.38,2025-04-25,2025-05-24
2025-06-02,2288.62,supplier_payment,out,Counterparty_89,26189962.76,2025-05-14,2025-06-08
2025-06-02,5675.7,asset_sale,in,Counterparty_86,26195638.46,,
2025-06-02,14361.91,software_subscription,out,Counterparty_15,26181276.55,2025-05-12,2025-06-12
2025-06-02,674.57,utilities,out,Counterparty_11,26180601.98,2025-05-11,2025-06-18
2025-06-02,2415.43,refund,in,Counterparty_79,26183017.41,,
2025-06-02,6787.8,rent,out,Counterparty_80,26176229.61,2025-05-08,2025-06-09
2025-06-02,5940.8,investment_income,in,Counterparty_56,26182170.41,,
2025-06-02,1798.46,payroll,out,Counterparty_84,26180371.95,2025-04-29,2025-06-05
2025-06-02,2132.58,rent,out,Counterparty_29,26178239.37,2025-05-11,2025-06-09
2025-06-02,2809.78,asset_sale,in,Counterparty_39,26181049.15,,
2025-06-02,12579.76,credit,in,Counterparty_64,26193628.91,,
2025-06-02,1280.51,credit,in,Counterparty_34,26194909.42,,
2025-06-02,1583.23,rent,out,Counterparty_15,26193326.19,2025-04-23,2025-05-26
2025-06-02,4329.3,customer_payment,in,Counterparty_96,26197655.49,,
2025-06-02,9609.45,loan_repayment,out,Counterparty_79,26188046.04,2025-04-20,2025-05-27
2025-06-02,3083.3,T&E,out,Counterparty_89,26184962.74,2025-05-13,2025-06-11
2025-06-02,2939.28,customer_payment,in,Counterparty_23,26187902.02,,
2025-06-02,2400.64,customer_payment,in,Counterparty_39,26190302.66,,
2025-06-02,297.5,investment_income,in,Counterparty_19,26190600.16,,
2025-06-02,579.02,T&E,out,Counterparty_32,26190021.14,2025-05-16,2025-06-23
2025-06-02,217.82,supplier_payment,out,Counterparty_19,26189803.32,2025-04-25,2025-05-29
2025-06-02,15195.05,asset_sale,in,Counterparty_17,26204998.37,,
2025-06-02,5212.29,customer_payment,in,Counterparty_80,26210210.66,,
2025-06-02,380.85,rent,out,Counterparty_4,26209829.81,2025-04-21,2025-05-25
2025-06-02,8525.34,loan_repayment,out,Counterparty_78,26201304.47,2025-04-29,2025-05-26
2025-06-03,2426.74,loan_repayment,out,Counterparty_19,26198877.73,2025-05-05,2025-06-12
2025-06-03,25289.45,asset_sale,in,Counterparty_34,26224167.18,,
2025-06-03,3453.76,supplier_payment,out,Counterparty_46,26220713.42,2025-05-10,2025-06-05
2025-06-03,1683.51,rent,out,Counterparty_84,26219029.91,2025-04-23,2025-05-21
2025-06-03,1662.42,supplier_payment,out,Counterparty_95,26217367.49,2025-05-06,2025-05-31
2025-06-03,1979.68,tax_payment,out,Counterparty_98,26215387.81,2025-05-02,2025-06-05
2025-06-03,9883.5,payroll,out,Counterparty_76,26205504.31,2025-04-27,2025-06-05
2025-06-03,1751.68,credit,in,Counterparty_37,26207255.99,,
2025-06-03,3265.24,refund,in,Counterparty_32,26210521.23,,
2025-06-03,9712.79,credit,in,Counterparty_62,26220234.02,,
2025-06-03,1735.93,rent,out,Counterparty_80,26218498.09,2025-04-25,2025-05-28
2025-06-03,8062.67,customer_payment,in,Counterparty_38,26226560.76,,
2025-06-03,27253.99,credit,in,Counterparty_86,26253814.75,,
2025-06-03,7128.89,marketing_spend,out,Counterparty_84,26246685.86,2025-05-07,2025-06-15
2025-06-03,1701.81,loan_repayment,out,Counterparty_92,26244984.05,2025-04-22,2025-05-19
2025-06-03,1623.81,payroll,out,Counterparty_32,26243360.24,2025-05-15,2025-06-20
2025-06-03,3400.66,marketing_spend,out,Counterparty_28,26239959.58,2025-04-20,2025-05-21
2025-06-03,9930.6,utilities,out,Counterparty_24,26230028.98,2025-05-03,2025-06-07
2025-06-03,61.88,utilities,out,Counterparty_95,26229967.1,2025-05-19,2025-06-20
2025-06-03,1986.78,software_subscription,out,Counterparty_19,26227980.32,2025-04-23,2025-05-31
2025-06-03,1809.07,asset_sale,in,Counterparty_43,26229789.39,,
2025-06-03,1708.57,loan_repayment,out,Counterparty_2,26228080.82,2025-05-19,2025-06-22
2025-06-03,837.45,rent,out,Counterparty_23,26227243.37,2025-04-25,2025-05-27
2025-06-03,2213.51,rent,out,Counterparty_53,26225029.86,2025-05-02,2025-05-27
2025-06-03,24757.04,refund,in,Counterparty_60,26249786.9,,
2025-06-03,37.82,rent,out,Counterparty_68,26249749.08,2025-05-10,2025-06-06
2025-06-03,921.52,rent,out,Counterparty_11,26248827.56,2025-04-29,2025-05-24
2025-06-03,2903.63,marketing_spend,out,Counterparty_57,26245923.93,2025-04-27,2025-06-04
2025-06-03,2078.48,marketing_spend,out,Counterparty_62,26243845.45,2025-05-03,2025-06-11
2025-06-03,941.76,tax_payment,out,Counterparty_46,26242903.69,2025-05-05,2025-06-07
2025-06-03,1138.94,refund,in,Counterparty_30,26244042.63,,
2025-06-03,723.13,tax_payment,out,Counterparty_52,26243319.5,2025-05-19,2025-06-19
2025-06-03,16024.68,credit,in,Counterparty_42,26259344.18,,
2025-06-03,753.38,T&E,out,Counterparty_38,26258590.8,2025-04-30,2025-06-08
2025-06-03,2853.73,supplier_payment,out,Counterparty_7,26255737.07,2025-04-20,2025-05-18
2025-06-03,3580.01,payroll,out,Counterparty_80,26252157.06,2025-05-15,2025-06-16
2025-06-03,2675.95,payroll,out,Counterparty_71,26249481.11,2025-04-23,2025-05-25
2025-06-03,2266.29,supplier_payment,out,Counterparty_44,26247214.82,2025-04-24,2025-05-26
2025-06-03,5159.57,rent,out,Counterparty_96,26242055.25,2025-04-21,2025-05-21
2025-06-03,2921.49,tax_payment,out,Counterparty_87,26239133.76,2025-04-29,2025-05-27
2025-06-03,2643.99,marketing_spend,out,Counterparty_24,26236489.77,2025-05-19,2025-06-21
2025-06-03,425.06,loan_repayment,out,Counterparty_19,26236064.71,2025-04-21,2025-05-20
2025-06-03,914.18,supplier_payment,out,Counterparty_49,26235150.53,2025-05-07,2025-06-12
2025-06-03,10570.98,investment_income,in,Counterparty_52,26245721.51,,
2025-06-03,3883.22,customer_payment,in,Counterparty_18,26249604.73,,
2025-06-03,21996.36,refund,in,Counterparty_2,26271601.09,,
2025-06-03,2025.23,payroll,out,Counterparty_72,26269575.86,2025-05-08,2025-06-16
2025-06-03,7544.47,utilities,out,Counterparty_94,26262031.39,2025-05-07,2025-06-09
2025-06-03,12956.46,customer_payment,in,Counterparty_35,26274987.85,,
2025-06-03,13084.3,credit,in,Counterparty_19,26288072.15,,
2025-06-03,5922.2,software_subscription,out,Counterparty_42,26282149.95,2025-05-14,2025-06-11
2025-06-03,307.58,T&E,out,Counterparty_78,26281842.37,2025-05-07,2025-06-01
2025-06-03,2195.31,supplier_payment,out,Counterparty_36,26279647.06,2025-05-10,2025-06-08
2025-06-03,2100.74,rent,out,Counterparty_52,26277546.32,2025-05-08,2025-06-11
2025-06-03,3807.36,rent,out,Counterparty_11,26273738.96,2025-05-15,2025-06-17
2025-06-03,1601.43,payroll,out,Counterparty_3,26272137.53,2025-04-22,2025-05-24
2025-06-03,3365.73,asset_sale,in,Counterparty_71,26275503.26,,
2025-06-03,20977.22,customer_payment,in,Counterparty_99,26296480.48,,
2025-06-03,180.99,marketing_spend,out,Counterparty_94,26296299.49,2025-05-06,2025-06-05
2025-06-03,8063.53,credit,in,Counterparty_86,26304363.02,,
2025-06-03,2299.14,tax_payment,out,Counterparty_74,26302063.88,2025-05-02,2025-06-02
2025-06-03,2109.48,investment_income,in,Counterparty_91,26304173.36,,
2025-06-03,4743.33,supplier_payment,out,Counterparty_47,26299430.03,2025-04-28,2025-05-29
2025-06-03,3.47,payroll,out,Counterparty_68,26299426.56,2025-04-27,2025-05-22
2025-06-03,974.87,loan_repayment,out,Counterparty_54,26298451.69,2025-04-20,2025-05-28
2025-06-03,1278.46,marketing_spend,out,Counterparty_96,26297173.23,2025-05-06,2025-06-04
2025-06-03,506.85,software_subscription,out,Counterparty_59,26296666.38,2025-05-18,2025-06-13
2025-06-03,6371.06,payroll,out,Counterparty_24,26290295.32,2025-04-30,2025-05-31
2025-06-03,1565.47,marketing_spend,out,Counterparty_4,26288729.85,2025-05-11,2025-06-16
2025-06-03,709.14,supplier_payment,out,Counterparty_73,26288020.71,2025-04-22,2025-05-26
2025-06-04,901.18,utilities,out,Counterparty_4,26287119.53,2025-05-10,2025-06-11
2025-06-04,2328.81,customer_payment,in,Counterparty_23,26289448.34,,
2025-06-04,6454.92,refund,in,Counterparty_93,26295903.26,,
2025-06-04,8107.82,refund,in,Counterparty_24,26304011.08,,
2025-06-04,7309.77,payroll,out,Counterparty_1,26296701.31,2025-04-24,2025-05-28
2025-06-04,2968.78,marketing_spend,out,Counterparty_24,26293732.53,2025-05-18,2025-06-15
2025-06-04,1946.87,investment_income,in,Counterparty_62,26295679.4,,
2025-06-04,12692.6,refund,in,Counterparty_8,26308372.0,,
2025-06-04,4522.3,customer_payment,in,Counterparty_5,26312894.3,,
2025-06-04,18483.77,refund,in,Counterparty_96,26331378.07,,
2025-06-04,3832.61,payroll,out,Counterparty_30,26327545.46,2025-05-03,2025-06-05
2025-06-04,3644.71,customer_payment,in,Counterparty_30,26331190.17,,
2025-06-04,544.56,investment_income,in,Counterparty_8,26331734.73,,
2025-06-04,4642.35,customer_payment,in,Counterparty_15,26336377.08,,
2025-06-04,1110.66,credit,in,Counterparty_67,26337487.74,,
2025-06-04,5085.68,credit,in,Counterparty_86,26342573.42,,
2025-06-04,1414.5,asset_sale,in,Counterparty_39,26343987.92,,
2025-06-04,1260.07,rent,out,Counterparty_24,26342727.85,2025-05-17,2025-06-16
2025-06-04,2575.83,credit,in,Counterparty_22,26345303.68,,
2025-06-04,8271.45,asset_sale,in,Counterparty_52,26353575.13,,
2025-06-04,22494.5,investment_income,in,Counterparty_79,26376069.63,,
2025-06-04,3918.5,rent,out,Counterparty_2,26372151.13,2025-05-04,2025-06-04
2025-06-04,349.38,loan_repayment,out,Counterparty_54,26371801.75,2025-05-15,2025-06-16
2025-06-04,10462.07,investment_income,in,Counterparty_99,26382263.82,,
2025-06-04,2732.96,T&E,out,Counterparty_17,26379530.86,2025-05-03,2025-06-11
2025-06-04,17604.59,customer_payment,in,Counterparty_84,26397135.45,,
2025-06-04,1161.93,credit,in,Counterparty_19,26398297.38,,
2025-06-04,4168.69,supplier_payment,out,Counterparty_9,26394128.69,2025-05-08,2025-06-06
2025-06-04,9374.84,investment_income,in,Counterparty_7,26403503.53,,
2025-06-04,1342.95,rent,out,Counterparty_96,26402160.58,2025-04-23,2025-06-01
2025-06-04,1590.01,T&E,out,Counterparty_71,26400570.57,2025-05-07,2025-06-02
2025-06-04,601.1,payroll,out,Counterparty_55,26399969.47,2025-05-14,2025-06-16
2025-06-04,6619.23,T&E,out,Counterparty_57,26393350.24,2025-05-19,2025-06-19
2025-06-04,3077.24,customer_payment,in,Counterparty_47,26396427.48,,
2025-06-04,2994.37,supplier_payment,out,Counterparty_7,26393433.11,2025-05-17,2025-06-11
2025-06-04,1246.94,asset_sale,in,Counterparty_47,26394680.05,,
2025-06-04,1855.69,rent,out,Counterparty_3,26392824.36,2025-05-12,2025-06-17
2025-06-04,871.19,payroll,out,Counterparty_97,26391953.17,2025-05-11,2025-06-12
2025-06-04,4154.09,utilities,out,Counterparty_65,26387799.08,2025-05-10,2025-06-10
2025-06-04,5151.84,software_subscription,out,Counterparty_57,26382647.24,2025-05-15,2025-06-18
2025-06-04,4060.16,payroll,out,Counterparty_15,26378587.08,2025-05-13,2025-06-09
2025-06-04,455.94,supplier_payment,out,Counterparty_14,26378131.14,2025-04-27,2025-05-31
2025-06-04,14714.97,refund,in,Counterparty_47,26392846.11,,
2025-06-04,2279.78,software_subscription,out,Counterparty_9,26390566.33,2025-05-17,2025-06-23
2025-06-04,569.21,refund,in,Counterparty_52,26391135.54,,
2025-06-04,8330.58,tax_payment,out,Counterparty_95,26382804.96,2025-05-13,2025-06-07
2025-06-04,775.14,software_subscription,out,Counterparty_73,26382029.82,2025-05-13,2025-06-20
2025-06-04,1291.88,software_subscription,out,Counterparty_57,26380737.94,2025-04-24,2025-05-21
2025-06-04,37.07,refund,in,Counterparty_21,26380775.01,,
2025-06-04,1392.91,software_subscription,out,Counterparty_54,26379382.1,2025-04-22,2025-05-31
2025-06-04,8293.48,tax_payment,out,Counterparty_84,26371088.62,2025-05-16,2025-06-10
2025-06-04,189.74,marketing_spend,out,Counterparty_40,26370898.88,2025-05-20,2025-06-18
2025-06-04,896.8,marketing_spend,out,Counterparty_77,26370002.08,2025-05-04,2025-06-07
2025-06-04,11328.63,utilities,out,Counterparty_32,26358673.45,2025-05-08,2025-06-15
2025-06-04,3324.78,supplier_payment,out,Counterparty_31,26355348.67,2025-04-22,2025-05-26
2025-06-04,6165.95,software_subscription,out,Counterparty_27,26349182.72,2025-04-27,2025-06-02
2025-06-04,5447.1,T&E,out,Counterparty_35,26343735.62,2025-04-23,2025-05-19
2025-06-04,1091.97,software_subscription,out,Counterparty_69,26342643.65,2025-05-05,2025-05-30
2025-06-04,6542.67,refund,in,Counterparty_36,26349186.32,,
2025-06-04,2742.0,marketing_spend,out,Counterparty_1,26346444.32,2025-05-16,2025-06-19
2025-06-04,1924.15,marketing_spend,out,Counterparty_94,26344520.17,2025-05-15,2025-06-17
2025-06-04,2402.44,software_subscription,out,Counterparty_24,26342117.73,2025-05-07,2025-06-12
2025-06-05,6538.48,software_subscription,out,Counterparty_8,26335579.25,2025-04-29,2025-06-03
2025-06-05,1692.98,asset_sale,in,Counterparty_72,26337272.23,,
2025-06-05,2407.08,asset_sale,in,Counterparty_89,26339679.31,,
2025-06-05,4426.11,customer_payment,in,Counterparty_62,26344105.42,,
2025-06-05,4831.76,loan_repayment,out,Counterparty_32,26339273.66,2025-05-08,2025-06-12
2025-06-05,1370.77,supplier_payment,out,Counterparty_78,26337902.89,2025-04-30,2025-05-26
2025-06-05,4067.68,investment_income,in,Counterparty_10,26341970.57,,
2025-06-05,4839.73,rent,out,Counterparty_82,26337130.84,2025-05-09,2025-06-14
2025-06-05,54918.92,asset_sale,in,Counterparty_36,26392049.76,,
2025-06-05,42.35,T&E,out,Counterparty_15,26392007.41,2025-05-08,2025-06-15
2025-06-05,5128.89,supplier_payment,out,Counterparty_40,26386878.52,2025-04-24,2025-06-02
2025-06-05,5956.41,loan_repayment,out,Counterparty_96,26380922.11,2025-04-24,2025-06-02
2025-06-05,10785.01,tax_payment,out,Counterparty_14,26370137.1,2025-04-29,2025-06-01
2025-06-05,4555.26,payroll,out,Counterparty_9,26365581.84,2025-05-16,2025-06-24
2025-06-05,1695.32,refund,in,Counterparty_19,26367277.16,,
2025-06-05,24104.42,refund,in,Counterparty_88,26391381.58,,
2025-06-05,6387.95,tax_payment,out,Counterparty_9,26384993.63,2025-05-14,2025-06-12
2025-06-05,10883.32,utilities,out,Counterparty_15,26374110.31,2025-04-28,2025-05-23
2025-06-05,6995.35,credit,in,Counterparty_82,26381105.66,,
2025-06-05,8780.57,customer_payment,in,Counterparty_7,26389886.23,,
2025-06-05,3927.32,investment_income,in,Counterparty_29,26393813.55,,
2025-06-05,5606.57,credit,in,Counterparty_77,26399420.12,,
2025-06-05,2321.08,utilities,out,Counterparty_86,26397099.04,2025-05-14,2025-06-11
2025-06-05,4757.12,T&E,out,Counterparty_41,26392341.92,2025-05-20,2025-06-18
2025-06-05,5633.53,utilities,out,Counterparty_19,26386708.39,2025-05-12,2025-06-14
2025-06-05,100.33,tax_payment,out,Counterparty_1,26386608.06,2025-05-01,2025-05-28
2025-06-05,6666.13,tax_payment,out,Counterparty_47,26379941.93,2025-05-02,2025-06-09
2025-06-05,1384.95,investment_income,in,Counterparty_67,26381326.88,,
2025-06-05,8829.46,marketing_spend,out,Counterparty_99,26372497.42,2025-05-06,2025-06-03
2025-06-05,3727.26,tax_payment,out,Counterparty_88,26368770.16,2025-05-12,2025-06-08
2025-06-05,533.1,refund,in,Counterparty_75,26369303.26,,
2025-06-05,9812.25,tax_payment,out,Counterparty_85,26359491.01,2025-05-04,2025-06-11
2025-06-05,2120.96,customer_payment,in,Counterparty_22,26361611.97,,
2025-06-05,351.62,rent,out,Counterparty_64,26361260.35,2025-05-07,2025-06-09
2025-06-05,10094.2,T&E,out,Counterparty_84,26351166.15,2025-05-14,2025-06-14
2025-06-05,21434.46,investment_income,in,Counterparty_53,26372600.61,,
2025-06-05,5930.83,loan_repayment,out,Counterparty_93,26366669.78,2025-05-02,2025-06-09
2025-06-05,805.82,payroll,out,Counterparty_75,26365863.96,2025-05-01,2025-05-30
2025-06-05,1504.45,supplier_payment,out,Counterparty_88,26364359.51,2025-05-08,2025-06-09
2025-06-05,10898.75,credit,in,Counterparty_80,26375258.26,,
2025-06-05,31.5,payroll,out,Counterparty_61,26375226.76,2025-04-24,2025-05-25
2025-06-05,370.17,marketing_spend,out,Counterparty_9,26374856.59,2025-04-27,2025-05-30
2025-06-05,3886.59,refund,in,Counterparty_48,26378743.18,,
2025-06-05,11977.8,asset_sale,in,Counterparty_20,26390720.98,,
2025-06-05,10936.7,refund,in,Counterparty_2,26401657.68,,
2025-06-05,319.41,T&E,out,Counterparty_60,26401338.27,2025-05-02,2025-06-09
2025-06-05,1186.38,software_subscription,out,Counterparty_91,26400151.89,2025-05-13,2025-06-17
2025-06-05,2429.65,utilities,out,Counterparty_20,26397722.24,2025-04-29,2025-06-01
2025-06-05,6737.13,payroll,out,Counterparty_71,26390985.11,2025-05-10,2025-06-18
2025-06-05,12150.84,asset_sale,in,Counterparty_62,26403135.95,,
2025-06-05,505.92,credit,in,Counterparty_35,26403641.87,,
2025-06-05,190.08,investment_income,in,Counterparty_75,26403831.95,,
2025-06-05,3026.35,marketing_spend,out,Counterparty_59,26400805.6,2025-05-02,2025-05-28
2025-06-05,8412.39,tax_payment,out,Counterparty_8,26392393.21,2025-05-11,2025-06-18
2025-06-05,13330.8,asset_sale,in,Counterparty_40,26405724.01,,
2025-06-05,5391.64,rent,out,Counterparty_78,26400332.37,2025-05-03,2025-06-04
2025-06-05,2093.4,investment_income,in,Counterparty_24,26402425.77,,
2025-06-05,312.3,rent,out,Counterparty_16,26402113.47,2025-05-03,2025-06-11
2025-06-05,224.07,supplier_payment,out,Counterparty_42,26401889.4,2025-05-02,2025-06-02
2025-06-05,4622.7,utilities,out,Counterparty_57,26397266.7,2025-05-07,2025-06-02
2025-06-05,4451.95,T&E,out,Counterparty_94,26392814.75,2025-04-27,2025-06-01
2025-06-05,780.51,payroll,out,Counterparty_3,26392034.24,2025-04-23,2025-05-21
2025-06-05,369.47,loan_repayment,out,Counterparty_97,26391664.77,2025-04-30,2025-06-06
2025-06-05,2184.47,payroll,out,Counterparty_45,26389480.3,2025-05-16,2025-06-23
2025-06-05,30113.33,refund,in,Counterparty_18,26419593.63,,
2025-06-05,4418.96,supplier_payment,out,Counterparty_31,26415174.67,2025-05-18,2025-06-12
2025-06-05,4719.97,marketing_spend,out,Counterparty_23,26410454.7,2025-04-25,2025-06-01
2025-06-06,408.74,T&E,out,Counterparty_77,26410045.96,2025-05-08,2025-06-08
2025-06-06,849.89,supplier_payment,out,Counterparty_16,26409196.07,2025-05-09,2025-06-15
2025-06-06,2019.56,payroll,out,Counterparty_46,26407176.51,2025-05-07,2025-06-03
2025-06-06,6402.31,credit,in,Counterparty_86,26413578.82,,
2025-06-06,1072.41,supplier_payment,out,Counterparty_19,26412506.41,2025-05-06,2025-06-04
2025-06-06,8566.27,software_subscription,out,Counterparty_87,26403940.14,2025-05-16,2025-06-20
2025-06-06,449.52,marketing_spend,out,Counterparty_40,26403490.62,2025-05-17,2025-06-25
2025-06-06,2605.19,rent,out,Counterparty_51,26400885.43,2025-04-24,2025-05-28
2025-06-06,4691.31,loan_repayment,out,Counterparty_51,26396194.12,2025-05-07,2025-06-08
2025-06-06,1890.09,supplier_payment,out,Counterparty_2,26394304.03,2025-04-26,2025-05-30
2025-06-06,2698.91,tax_payment,out,Counterparty_14,26391605.12,2025-04-26,2025-06-01
2025-06-06,3447.5,T&E,out,Counterparty_33,26388157.62,2025-05-01,2025-06-04
2025-06-06,2958.96,asset_sale,in,Counterparty_75,26391116.58,,
2025-06-06,2330.44,tax_payment,out,Counterparty_58,26388786.14,2025-05-04,2025-06-08
2025-06-06,1005.14,loan_repayment,out,Counterparty_29,26387781.0,2025-04-29,2025-05-24
2025-06-06,571.93,loan_repayment,out,Counterparty_92,26387209.07,2025-05-22,2025-06-17
2025-06-06,2059.14,tax_payment,out,Counterparty_30,26385149.93,2025-04-26,2025-05-26
2025-06-06,199.78,T&E,out,Counterparty_94,26384950.15,2025-04-29,2025-06-07
2025-06-06,80.12,utilities,out,Counterparty_20,26384870.03,2025-05-07,2025-06-07
2025-06-06,999.27,marketing_spend,out,Counterparty_65,26383870.76,2025-05-02,2025-06-08
2025-06-06,3981.94,T&E,out,Counterparty_8,26379888.82,2025-04-23,2025-06-01
2025-06-06,705.53,marketing_spend,out,Counterparty_46,26379183.29,2025-05-19,2025-06-23
2025-06-06,4129.64,T&E,out,Counterparty_3,26375053.65,2025-05-22,2025-06-23
2025-06-06,709.13,software_subscription,out,Counterparty_35,26374344.52,2025-05-14,2025-06-09
2025-06-06,2392.99,tax_payment,out,Counterparty_15,26371951.53,2025-05-14,2025-06-13
2025-06-06,516.7,utilities,out,Counterparty_19,26371434.83,2025-05-20,2025-06-17
2025-06-06,3797.35,payroll,out,Counterparty_48,26367637.48,2025-05-10,2025-06-07
2025-06-06,277.65,software_subscription,out,Counterparty_92,26367359.83,2025-05-09,2025-06-13
2025-06-06,2971.69,asset_sale,in,Counterparty_80,26370331.52,,
2025-06-06,4112.78,payroll,out,Counterparty_65,26366218.74,2025-05-16,2025-06-13
2025-06-06,1766.33,payroll,out,Counterparty_80,26364452.41,2025-05-01,2025-06-03
2025-06-06,1338.31,payroll,out,Counterparty_6,26363114.1,2025-05-10,2025-06-17
2025-06-06,2003.21,refund,in,Counterparty_84,26365117.31,,
2025-06-06,1098.26,customer_payment,in,Counterparty_95,26366215.57,,
2025-06-06,2078.26,marketing_spend,out,Counterparty_70,26364137.31,2025-04-27,2025-06-04
2025-06-06,5112.51,utilities,out,Counterparty_80,26359024.8,2025-05-01,2025-06-04
2025-06-06,4734.56,asset_sale,in,Counterparty_40,26363759.36,,
2025-06-06,3026.93,payroll,out,Counterparty_46,26360732.43,2025-05-10,2025-06-18
2025-06-06,2223.84,investment_income,in,Counterparty_80,26362956.27,,
2025-06-06,364.74,marketing_spend,out,Counterparty_72,26362591.53,2025-05-04,2025-06-01
2025-06-06,4451.91,software_subscription,out,Counterparty_77,26358139.62,2025-05-21,2025-06-17
2025-06-06,846.23,loan_repayment,out,Counterparty_82,26357293.39,2025-04-29,2025-05-27
2025-06-06,2163.5,tax_payment,out,Counterparty_44,26355129.89,2025-05-06,2025-06-08
2025-06-06,5525.16,asset_sale,in,Counterparty_66,26360655.05,,
2025-06-06,132.51,rent,out,Counterparty_22,26360522.54,2025-05-13,2025-06-08
2025-06-06,5003.94,loan_repayment,out,Counterparty_80,26355518.6,2025-05-10,2025-06-12
2025-06-06,4896.58,investment_income,in,Counterparty_72,26360415.18,,
2025-06-06,15377.88,customer_payment,in,Counterparty_63,26375793.06,,
2025-06-06,1982.28,supplier_payment,out,Counterparty_70,26373810.78,2025-05-14,2025-06-11
2025-06-06,7485.62,credit,in,Counterparty_82,26381296.4,,
2025-06-06,5377.45,refund,in,Counterparty_62,26386673.85,,
2025-06-06,3002.84,T&E,out,Counterparty_41,26383671.01,2025-05-14,2025-06-14
2025-06-06,116.14,credit,in,Counterparty_44,26383787.15,,
2025-06-06,494.65,customer_payment,in,Counterparty_26,26384281.8,,
2025-06-06,125.57,credit,in,Counterparty_94,26384407.37,,
2025-06-06,18001.58,customer_payment,in,Counterparty_84,26402408.95,,
2025-06-06,8716.88,credit,in,Counterparty_79,26411125.83,,
2025-06-06,15341.03,refund,in,Counterparty_16,26426466.86,,
2025-06-06,8772.24,supplier_payment,out,Counterparty_93,26417694.62,2025-05-05,2025-06-12
2025-06-06,60.73,rent,out,Counterparty_40,26417633.89,2025-05-09,2025-06-03
2025-06-06,933.62,refund,in,Counterparty_45,26418567.51,,
2025-06-06,9302.12,asset_sale,in,Counterparty_28,26427869.63,,
2025-06-06,2966.18,investment_income,in,Counterparty_42,26430835.81,,
2025-06-07,2063.08,tax_payment,out,Counterparty_30,26428772.73,2025-05-14,2025-06-19
2025-06-07,7249.89,customer_payment,in,Counterparty_46,26436022.62,,
2025-06-07,3678.81,T&E,out,Counterparty_78,26432343.81,2025-05-14,2025-06-17
2025-06-07,4349.91,asset_sale,in,Counterparty_90,26436693.72,,
2025-06-07,2644.9,marketing_spend,out,Counterparty_64,26434048.82,2025-05-16,2025-06-17
2025-06-07,1857.86,rent,out,Counterparty_67,26432190.96,2025-05-05,2025-06-10
2025-06-07,6153.93,utilities,out,Counterparty_23,26426037.03,2025-05-21,2025-06-29
2025-06-07,9817.06,customer_payment,in,Counterparty_90,26435854.09,,
2025-06-07,3890.29,marketing_spend,out,Counterparty_85,26431963.8,2025-05-22,2025-06-24
2025-06-07,13388.78,investment_income,in,Counterparty_39,26445352.58,,
2025-06-07,9316.87,asset_sale,in,Counterparty_88,26454669.45,,
2025-06-07,19312.95,customer_payment,in,Counterparty_17,26473982.4,,
2025-06-07,1124.34,tax_payment,out,Counterparty_26,26472858.06,2025-04-24,2025-06-02
2025-06-07,21198.07,credit,in,Counterparty_10,26494056.13,,
2025-06-07,2034.23,supplier_payment,out,Counterparty_54,26492021.9,2025-05-05,2025-05-31
2025-06-07,880.35,rent,out,Counterparty_86,26491141.55,2025-05-20,2025-06-19
2025-06-07,7888.17,supplier_payment,out,Counterparty_55,26483253.38,2025-05-15,2025-06-19
2025-06-07,2124.55,investment_income,in,Counterparty_90,26485377.93,,
2025-06-07,12601.68,investment_income,in,Counterparty_14,26497979.61,,
2025-06-07,1410.18,tax_payment,out,Counterparty_23,26496569.43,2025-05-19,2025-06-25
2025-06-07,660.39,software_subscription,out,Counterparty_24,26495909.04,2025-05-03,2025-06-04
2025-06-07,3105.18,payroll,out,Counterparty_43,26492803.86,2025-05-07,2025-06-06
2025-06-07,8739.57,customer_payment,in,Counterparty_95,26501543.43,,
2025-06-07,837.7,utilities,out,Counterparty_3,26500705.73,2025-05-05,2025-06-11
2025-06-07,5899.86,loan_repayment,out,Counterparty_91,26494805.87,2025-05-03,2025-06-05
2025-06-07,687.7,loan_repayment,out,Counterparty_9,26494118.17,2025-04-25,2025-05-20
2025-06-07,10687.85,customer_payment,in,Counterparty_53,26504806.02,,
2025-06-07,2363.79,payroll,out,Counterparty_13,26502442.23,2025-05-14,2025-06-08
2025-06-07,1972.65,payroll,out,Counterparty_98,26500469.58,2025-05-01,2025-05-28
2025-06-07,3506.61,rent,out,Counterparty_81,26496962.97,2025-05-07,2025-06-13
2025-06-07,8976.1,tax_payment,out,Counterparty_95,26487986.87,2025-05-20,2025-06-19
2025-06-07,558.57,loan_repayment,out,Counterparty_72,26487428.3,2025-05-04,2025-05-30
2025-06-07,2594.94,refund,in,Counterparty_69,26490023.24,,
2025-06-07,6886.85,customer_payment,in,Counterparty_73,26496910.09,,
2025-06-07,7506.05,utilities,out,Counterparty_84,26489404.04,2025-05-12,2025-06-19
2025-06-07,5356.7,refund,in,Counterparty_77,26494760.74,,
2025-06-07,3575.18,payroll,out,Counterparty_83,26491185.56,2025-05-22,2025-06-20
2025-06-07,705.83,supplier_payment,out,Counterparty_99,26490479.73,2025-05-08,2025-06-09
2025-06-07,532.4,software_subscription,out,Counterparty_15,26489947.33,2025-04-26,2025-06-04
2025-06-07,6005.34,utilities,out,Counterparty_37,26483941.99,2025-04-28,2025-05-29
2025-06-07,3785.08,marketing_spend,out,Counterparty_32,26480156.91,2025-05-16,2025-06-20
2025-06-07,4726.27,software_subscription,out,Counterparty_69,26475430.64,2025-05-19,2025-06-19
2025-06-07,1368.6,software_subscription,out,Counterparty_84,26474062.04,2025-05-01,2025-06-04
2025-06-07,619.03,utilities,out,Counterparty_73,26473443.01,2025-05-12,2025-06-09
2025-06-07,9938.2,customer_payment,in,Counterparty_25,26483381.21,,
2025-06-07,3986.83,tax_payment,out,Counterparty_73,26479394.38,2025-05-13,2025-06-16
2025-06-07,1228.39,customer_payment,in,Counterparty_32,26480622.77,,
2025-06-07,234.78,utilities,out,Counterparty_83,26480387.99,2025-05-19,2025-06-23
2025-06-07,4481.78,asset_sale,in,Counterparty_50,26484869.77,,
2025-06-07,1851.37,rent,out,Counterparty_75,26483018.4,2025-05-01,2025-06-01
2025-06-07,564.09,investment_income,in,Counterparty_56,26483582.49,,
2025-06-07,13905.2,tax_payment,out,Counterparty_59,26469677.29,2025-05-17,2025-06-22
2025-06-07,2711.6,software_subscription,out,Counterparty_92,26466965.69,2025-05-21,2025-06-21
2025-06-07,96.34,software_subscription,out,Counterparty_7,26466869.35,2025-05-23,2025-06-26
2025-06-07,1519.06,T&E,out,Counterparty_72,26465350.29,2025-05-03,2025-06-06
2025-06-07,662.69,utilities,out,Counterparty_29,26464687.6,2025-05-01,2025-06-08
2025-06-07,17144.54,investment_income,in,Counterparty_16,26481832.14,,
2025-06-07,3768.11,credit,in,Counterparty_40,26485600.25,,
2025-06-07,3835.51,tax_payment,out,Counterparty_66,26481764.74,2025-05-23,2025-06-20
2025-06-07,1227.92,utilities,out,Counterparty_19,26480536.82,2025-04-27,2025-05-25
2025-06-07,439.65,loan_repayment,out,Counterparty_48,26480097.17,2025-05-08,2025-06-02
2025-06-08,3538.4,asset_sale,in,Counterparty_67,26483635.57,,
2025-06-08,794.42,rent,out,Counterparty_53,26482841.15,2025-05-23,2025-06-18
2025-06-08,3103.43,tax_payment,out,Counterparty_49,26479737.72,2025-05-12,2025-06-06
2025-06-08,22.49,supplier_payment,out,Counterparty_75,26479715.23,2025-05-07,2025-06-07
2025-06-08,119.79,T&E,out,Counterparty_29,26479595.44,2025-05-21,2025-06-20
2025-06-08,4696.84,marketing_spend,out,Counterparty_64,26474898.6,2025-05-10,2025-06-18
2025-06-08,3642.22,rent,out,Counterparty_92,26471256.38,2025-04-26,2025-06-04
2025-06-08,11531.28,refund,in,Counterparty_79,26482787.66,,
2025-06-08,1528.51,marketing_spend,out,Counterparty_53,26481259.15,2025-05-21,2025-06-29
2025-06-08,2423.8,T&E,out,Counterparty_31,26478835.35,2025-05-20,2025-06-22
2025-06-08,6417.33,software_subscription,out,Counterparty_53,26472418.02,2025-04-30,2025-05-31
2025-06-08,25702.17,investment_income,in,Counterparty_95,26498120.19,,
2025-06-08,2264.87,credit,in,Counterparty_18,26500385.06,,
2025-06-08,5019.75,marketing_spend,out,Counterparty_34,26495365.31,2025-05-22,2025-06-18
2025-06-08,2309.55,asset_sale,in,Counterparty_63,26497674.86,,
2025-06-08,4157.77,T&E,out,Counterparty_69,26493517.09,2025-05-04,2025-06-09
2025-06-08,1280.65,credit,in,Counterparty_68,26494797.74,,
2025-06-08,585.69,tax_payment,out,Counterparty_27,26494212.05,2025-04-26,2025-05-29
2025-06-08,3174.92,customer_payment,in,Counterparty_46,26497386.97,,
2025-06-08,1115.83,supplier_payment,out,Counterparty_75,26496271.14,2025-05-15,2025-06-20
2025-06-08,3826.95,utilities,out,Counterparty_53,26492444.19,2025-05-12,2025-06-15
2025-06-08,5706.06,loan_repayment,out,Counterparty_58,26486738.13,2025-05-06,2025-06-12
2025-06-08,164.48,software_subscription,out,Counterparty_89,26486573.65,2025-05-12,2025-06-06
2025-06-08,424.25,payroll,out,Counterparty_51,26486149.4,2025-05-19,2025-06-23
2025-06-08,10757.91,marketing_spend,out,Counterparty_17,26475391.49,2025-05-19,2025-06-18
2025-06-08,4544.91,refund,in,Counterparty_68,26479936.4,,
2025-06-08,3621.35,loan_repayment,out,Counterparty_16,26476315.05,2025-05-07,2025-06-09
2025-06-08,7212.36,software_subscription,out,Counterparty_60,26469102.69,2025-05-22,2025-06-26
2025-06-08,1494.14,payroll,out,Counterparty_62,26467608.55,2025-04-25,2025-05-20
2025-06-08,554.74,customer_payment,in,Counterparty_12,26468163.29,,
2025-06-08,6434.47,T&E,out,Counterparty_58,26461728.82,2025-05-12,2025-06-10
2025-06-08,7385.77,T&E,out,Counterparty_43,26454343.05,2025-05-01,2025-05-26
2025-06-08,1444.41,T&E,out,Counterparty_79,26452898.64,2025-05-10,2025-06-11
2025-06-08,2066.9,supplier_payment,out,Counterparty_80,26450831.74,2025-04-27,2025-05-30
2025-06-08,4313.63,T&E,out,Counterparty_8,26446518.11,2025-05-07,2025-06-09
2025-06-08,3649.14,supplier_payment,out,Counterparty_72,26442868.97,2025-05-02,2025-06-07
2025-06-08,580.38,tax_payment,out,Counterparty_80,26442288.59,2025-04-30,2025-06-03
2025-06-08,1848.94,investment_income,in,Counterparty_37,26444137.53,,
2025-06-08,695.77,rent,out,Counterparty_12,26443441.76,2025-05-16,2025-06-17
2025-06-08,14280.99,investment_income,in,Counterparty_90,26457722.75,,
2025-06-08,16521.23,customer_payment,in,Counterparty_84,26474243.98,,
2025-06-08,4073.55,credit,in,Counterparty_44,26478317.53,,
2025-06-08,8257.47,tax_payment,out,Counterparty_4,26470060.06,2025-05-16,2025-06-10
2025-06-08,17608.46,asset_sale,in,Counterparty_57,26487668.52,,
2025-06-08,972.86,credit,in,Counterparty_66,26488641.38,,
2025-06-08,17173.78,refund,in,Counterparty_58,26505815.16,,
2025-06-08,2932.78,supplier_payment,out,Counterparty_20,26502882.38,2025-05-10,2025-06-11
2025-06-08,2464.74,software_subscription,out,Counterparty_41,26500417.64,2025-05-17,2025-06-21
2025-06-08,3721.19,credit,in,Counterparty_40,26504138.83,,
2025-06-08,134.31,payroll,out,Counterparty_67,26504004.52,2025-05-21,2025-06-23
2025-06-08,2547.44,rent,out,Counterparty_73,26501457.08,2025-05-12,2025-06-10
2025-06-08,1084.08,software_subscription,out,Counterparty_8,26500373.0,2025-05-11,2025-06-14
2025-06-08,3329.34,rent,out,Counterparty_14,26497043.66,2025-05-01,2025-06-03
2025-06-08,9097.99,asset_sale,in,Counterparty_49,26506141.65,,
2025-06-08,1150.06,software_subscription,out,Counterparty_26,26504991.59,2025-05-09,2025-06-05
2025-06-08,5026.66,tax_payment,out,Counterparty_82,26499964.93,2025-04-27,2025-05-24
2025-06-08,1023.73,rent,out,Counterparty_78,26498941.2,2025-05-21,2025-06-22
2025-06-08,169.02,rent,out,Counterparty_10,26498772.18,2025-05-17,2025-06-23
2025-06-08,83.53,loan_repayment,out,Counterparty_32,26498688.65,2025-05-13,2025-06-13
2025-06-08,1182.75,customer_payment,in,Counterparty_79,26499871.4,,
2025-06-08,16205.5,asset_sale,in,Counterparty_48,26516076.9,,
2025-06-08,4274.59,credit,in,Counterparty_34,26520351.49,,
2025-06-08,1815.96,rent,out,Counterparty_86,26518535.53,2025-04-26,2025-05-22
2025-06-09,6257.62,investment_income,in,Counterparty_34,26524793.15,,
2025-06-09,40867.62,refund,in,Counterparty_13,26565660.77,,
2025-06-09,9200.73,investment_income,in,Counterparty_61,26574861.5,,
2025-06-09,1587.06,rent,out,Counterparty_56,26573274.44,2025-05-02,2025-05-29
2025-06-09,2473.64,supplier_payment,out,Counterparty_72,26570800.8,2025-04-28,2025-05-31
2025-06-09,491.03,utilities,out,Counterparty_29,26570309.77,2025-05-15,2025-06-17
2025-06-09,14084.34,utilities,out,Counterparty_60,26556225.43,2025-04-28,2025-05-26
2025-06-09,3449.62,customer_payment,in,Counterparty_53,26559675.05,,
2025-06-09,4140.36,refund,in,Counterparty_49,26563815.41,,
2025-06-09,18299.37,customer_payment,in,Counterparty_15,26582114.78,,
2025-06-09,7364.1,payroll,out,Counterparty_61,26574750.68,2025-04-27,2025-05-25
2025-06-09,1939.24,loan_repayment,out,Counterparty_58,26572811.44,2025-05-25,2025-06-24
2025-06-09,2194.8,T&E,out,Counterparty_2,26570616.64,2025-05-23,2025-06-23
2025-06-09,2001.33,payroll,out,Counterparty_26,26568615.31,2025-05-24,2025-07-01
2025-06-09,4201.17,customer_payment,in,Counterparty_3,26572816.48,,
2025-06-09,1238.89,rent,out,Counterparty_1,26571577.59,2025-05-23,2025-06-29
2025-06-09,6485.95,rent,out,Counterparty_42,26565091.64,2025-05-02,2025-05-31
2025-06-09,11352.19,credit,in,Counterparty_66,26576443.83,,
2025-06-09,27165.63,refund,in,Counterparty_42,26603609.46,,
2025-06-09,301.65,tax_payment,out,Counterparty_41,26603307.81,2025-05-04,2025-06-02
2025-06-09,3041.69,T&E,out,Counterparty_50,26600266.12,2025-05-07,2025-06-10
2025-06-09,2272.17,loan_repayment,out,Counterparty_80,26597993.95,2025-05-08,2025-06-12
2025-06-09,3942.73,asset_sale,in,Counterparty_21,26601936.68,,
2025-06-09,3496.93,tax_payment,out,Counterparty_7,26598439.75,2025-04-27,2025-06-05
2025-06-09,11218.12,investment_income,in,Counterparty_40,26609657.87,,
2025-06-09,3926.26,loan_repayment,out,Counterparty_10,26605731.61,2025-05-08,2025-06-05
2025-06-09,5804.08,T&E,out,Counterparty_94,26599927.53,2025-04-30,2025-05-30
2025-06-09,2808.61,investment_income,in,Counterparty_43,26602736.14,,
2025-06-09,13792.22,asset_sale,in,Counterparty_12,26616528.36,,
2025-06-09,1372.7,credit,in,Counterparty_77,26617901.06,,
2025-06-09,3686.41,utilities,out,Counterparty_59,26614214.65,2025-05-09,2025-06-11
2025-06-09,2327.37,credit,in,Counterparty_31,26616542.02,,
2025-06-09,570.87,utilities,out,Counterparty_75,26615971.15,2025-05-23,2025-06-18
2025-06-09,2462.15,tax_payment,out,Counterparty_95,26613509.0,2025-05-09,2025-06-11
2025-06-09,669.37,utilities,out,Counterparty_27,26612839.63,2025-05-01,2025-06-03
2025-06-09,10285.18,supplier_payment,out,Counterparty_48,26602554.45,2025-05-24,2025-07-02
2025-06-09,2408.49,rent,out,Counterparty_43,26600145.96,2025-05-15,2025-06-12
2025-06-09,466.05,payroll,out,Counterparty_8,26599679.91,2025-05-05,2025-06-06
2025-06-09,3355.35,supplier_payment,out,Counterparty_83,26596324.56,2025-05-01,2025-05-26
2025-06-09,1814.1,marketing_spend,out,Counterparty_65,26594510.46,2025-05-15,2025-06-19
2025-06-09,1253.35,payroll,out,Counterparty_9,26593257.11,2025-05-02,2025-06-05
2025-06-09,407.3,investment_income,in,Counterparty_1,26593664.41,,
2025-06-09,4979.09,rent,out,Counterparty_75,26588685.32,2025-05-21,2025-06-24
2025-06-09,17716.7,refund,in,Counterparty_54,26606402.02,,
2025-06-09,943.27,asset_sale,in,Counterparty_74,26607345.29,,
2025-06-09,3329.59,asset_sale,in,Counterparty_46,26610674.88,,
2025-06-09,5909.64,refund,in,Counterparty_23,26616584.52,,
2025-06-09,3278.74,asset_sale,in,Counterparty_85,26619863.26,,
2025-06-09,930.66,investment_income,in,Counterparty_63,26620793.92,,
2025-06-09,4060.98,rent,out,Counterparty_25,26616732.94,2025-05-24,2025-06-25
2025-06-09,8282.33,investment_income,in,Counterparty_11,26625015.27,,
2025-06-09,426.81,supplier_payment,out,Counterparty_1,26624588.46,2025-05-01,2025-05-27
2025-06-09,89.79,payroll,out,Counterparty_93,26624498.67,2025-05-14,2025-06-13
2025-06-09,4455.51,marketing_spend,out,Counterparty_56,26620043.16,2025-05-22,2025-06-23
2025-06-09,811.27,utilities,out,Counterparty_6,26619231.89,2025-05-25,2025-06-26
2025-06-09,12757.16,investment_income,in,Counterparty_12,26631989.05,,
2025-06-10,9457.19,software_subscription,out,Counterparty_54,26622531.86,2025-05-23,2025-06-26
2025-06-10,1975.73,tax_payment,out,Counterparty_54,26620556.13,2025-05-25,2025-06-19
2025-06-10,2759.92,T&E,out,Counterparty_2,26617796.21,2025-05-13,2025-06-13
2025-06-10,2091.26,rent,out,Counterparty_62,26615704.95,2025-05-11,2025-06-16
2025-06-10,7856.5,refund,in,Counterparty_32,26623561.45,,
2025-06-10,2171.84,customer_payment,in,Counterparty_53,26625733.29,,
2025-06-10,4698.07,loan_repayment,out,Counterparty_8,26621035.22,2025-04-27,2025-06-04
2025-06-10,746.58,tax_payment,out,Counterparty_96,26620288.64,2025-05-11,2025-06-19
2025-06-10,58.24,investment_income,in,Counterparty_4,26620346.88,,
2025-06-10,14798.73,investment_income,in,Counterparty_2,26635145.61,,
2025-06-10,4754.58,software_subscription,out,Counterparty_68,26630391.03,2025-05-20,2025-06-25
2025-06-10,142.51,loan_repayment,out,Counterparty_32,26630248.52,2025-05-24,2025-07-01
2025-06-10,5977.93,software_subscription,out,Counterparty_32,26624270.59,2025-05-19,2025-06-20
2025-06-10,1608.69,utilities,out,Counterparty_41,26622661.9,2025-05-25,2025-06-26
2025-06-10,753.33,customer_payment,in,Counterparty_25,26623415.23,,
2025-06-10,396.31,tax_payment,out,Counterparty_2,26623018.92,2025-05-24,2025-06-19
2025-06-10,3446.43,software_subscription,out,Counterparty_61,26619572.49,2025-05-24,2025-06-24
2025-06-10,14876.02,supplier_payment,out,Counterparty_5,26604696.47,2025-05-05,2025-06-04
2025-06-10,6616.58,asset_sale,in,Counterparty_50,26611313.05,,
2025-06-10,7488.09,investment_income,in,Counterparty_57,26618801.14,,
2025-06-10,4616.62,utilities,out,Counterparty_88,26614184.52,2025-04-30,2025-05-29
2025-06-10,1007.24,payroll,out,Counterparty_64,26613177.28,2025-05-19,2025-06-13
2025-06-10,2851.86,utilities,out,Counterparty_3,26610325.42,2025-05-14,2025-06-08
2025-06-10,1006.49,T&E,out,Counterparty_47,26609318.93,2025-05-21,2025-06-26
2025-06-10,16965.21,investment_income,in,Counterparty_2,26626284.14,,
2025-06-10,10211.01,investment_income,in,Counterparty_8,26636495.15,,
2025-06-10,5628.98,marketing_spend,out,Counterparty_25,26630866.17,2025-05-06,2025-06-03
2025-06-10,2165.3,payroll,out,Counterparty_78,26628700.87,2025-05-21,2025-06-18
2025-06-10,9354.95,asset_sale,in,Counterparty_79,26638055.82,,
2025-06-10,648.44,loan_repayment,out,Counterparty_22,26637407.38,2025-05-18,2025-06-21
2025-06-10,2323.41,payroll,out,Counterparty_89,26635083.97,2025-05-18,2025-06-20
2025-06-10,1180.06,software_subscription,out,Counterparty_24,26633903.91,2025-05-08,2025-06-04
2025-06-10,740.48,loan_repayment,out,Counterparty_91,26633163.43,2025-05-05,2025-06-03
2025-06-10,76.82,software_subscription,out,Counterparty_17,26633086.61,2025-05-07,2025-06-01
2025-06-10,4649.83,loan_repayment,out,Counterparty_82,26628436.78,2025-05-21,2025-06-19
2025-06-10,7960.21,supplier_payment,out,Counterparty_68,26620476.57,2025-05-06,2025-06-10
2025-06-10,145.57,credit,in,Counterparty_61,26620622.14,,
2025-06-10,761.23,rent,out,Counterparty_28,26619860.91,2025-05-17,2025-06-21
2025-06-10,2371.37,loan_repayment,out,Counterparty_88,26617489.54,2025-04-27,2025-05-25
2025-06-10,2151.9,payroll,out,Counterparty_62,26615337.64,2025-05-13,2025-06-18
2025-06-10,189.55,utilities,out,Counterparty_70,26615148.09,2025-04-29,2025-05-24
2025-06-10,1048.96,T&E,out,Counterparty_88,26614099.13,2025-05-20,2025-06-23
2025-06-10,1804.53,utilities,out,Counterparty_32,26612294.6,2025-05-08,2025-06-13
2025-06-10,17437.8,payroll,out,Counterparty_49,26594856.8,2025-05-17,2025-06-15
2025-06-10,52.04,utilities,out,Counterparty_94,26594804.76,2025-05-26,2025-07-03
2025-06-10,142.63,T&E,out,Counterparty_69,26594662.13,2025-05-25,2025-06-24
2025-06-10,2125.85,investment_income,in,Counterparty_1,26596787.98,,
2025-06-10,843.9,rent,out,Counterparty_14,26595944.08,2025-05-16,2025-06-16
2025-06-10,7872.91,refund,in,Counterparty_83,26603816.99,,
2025-06-10,5295.57,refund,in,Counterparty_45,26609112.56,,
2025-06-10,2714.64,payroll,out,Counterparty_11,26606397.92,2025-05-07,2025-06-04
2025-06-10,49.85,payroll,out,Counterparty_41,26606348.07,2025-05-24,2025-06-26
2025-06-10,7487.97,customer_payment,in,Counterparty_38,26613836.04,,
2025-06-10,5829.06,customer_payment,in,Counterparty_89,26619665.1,,
2025-06-10,14182.59,asset_sale,in,Counterparty_42,26633847.69,,
2025-06-10,2130.08,software_subscription,out,Counterparty_65,26631717.61,2025-05-02,2025-06-07
2025-06-10,7111.14,refund,in,Counterparty_42,26638828.75,,
2025-06-10,22545.67,customer_payment,in,Counterparty_43,26661374.42,,
2025-06-10,46.91,supplier_payment,out,Counterparty_48,26661327.51,2025-04-28,2025-05-28
2025-06-11,18126.77,credit,in,Counterparty_6,26679454.28,,
2025-06-11,4640.96,credit,in,Counterparty_71,26684095.24,,
2025-06-11,257.89,payroll,out,Counterparty_8,26683837.35,2025-05-15,2025-06-14
2025-06-11,3611.36,rent,out,Counterparty_61,26680225.99,2025-05-07,2025-06-04
2025-06-11,8995.89,supplier_payment,out,Counterparty_11,26671230.1,2025-05-10,2025-06-17
2025-06-11,447.34,credit,in,Counterparty_24,26671677.44,,
2025-06-11,2488.04,utilities,out,Counterparty_2,26669189.4,2025-05-12,2025-06-16
2025-06-11,4424.26,customer_payment,in,Counterparty_95,26673613.66,,
2025-06-11,6619.43,credit,in,Counterparty_54,26680233.09,,
2025-06-11,6647.01,investment_income,in,Counterparty_92,26686880.1,,
2025-06-11,434.42,tax_payment,out,Counterparty_92,26686445.68,2025-05-23,2025-06-21
2025-06-11,1793.91,payroll,out,Counterparty_76,26684651.77,2025-05-18,2025-06-24
2025-06-11,4062.9,utilities,out,Counterparty_91,26680588.87,2025-05-03,2025-06-09
2025-06-11,4925.5,payroll,out,Counterparty_70,26675663.37,2025-05-21,2025-06-25
2025-06-11,543.93,supplier_payment,out,Counterparty_78,26675119.44,2025-05-05,2025-05-31
2025-06-11,3662.66,software_subscription,out,Counterparty_81,26671456.78,2025-05-09,2025-06-14
2025-06-11,1779.03,asset_sale,in,Counterparty_44,26673235.81,,
2025-06-11,658.82,asset_sale,in,Counterparty_42,26673894.63,,
2025-06-11,1187.63,utilities,out,Counterparty_35,26672707.0,2025-05-23,2025-06-29
2025-06-11,636.62,tax_payment,out,Counterparty_69,26672070.38,2025-04-30,2025-06-08
2025-06-11,3543.76,loan_repayment,out,Counterparty_31,26668526.62,2025-05-05,2025-06-06
2025-06-11,19582.74,investment_income,in,Counterparty_59,26688109.36,,
2025-06-11,964.49,marketing_spend,out,Counterparty_42,26687144.87,2025-05-02,2025-06-04
2025-06-11,9186.04,utilities,out,Counterparty_25,26677958.83,2025-05-22,2025-06-27
2025-06-11,4995.53,investment_income,in,Counterparty_20,26682954.36,,
2025-06-11,2046.87,software_subscription,out,Counterparty_48,26680907.49,2025-04-28,2025-06-04
2025-06-11,278.56,T&E,out,Counterparty_35,26680628.93,2025-05-17,2025-06-11
2025-06-11,13563.07,payroll,out,Counterparty_76,26667065.86,2025-05-05,2025-06-05
2025-06-11,16972.64,credit,in,Counterparty_92,26684038.5,,
2025-06-11,8082.75,T&E,out,Counterparty_63,26675955.75,2025-05-23,2025-06-26
2025-06-11,1883.46,marketing_spend,out,Counterparty_95,26674072.29,2025-05-21,2025-06-15
2025-06-11,625.99,payroll,out,Counterparty_25,26673446.3,2025-05-23,2025-06-17
2025-06-11,5333.79,marketing_spend,out,Counterparty_22,26668112.51,2025-05-08,2025-06-08
2025-06-11,9066.83,asset_sale,in,Counterparty_34,26677179.34,,
2025-06-11,12542.53,rent,out,Counterparty_45,26664636.81,2025-05-03,2025-06-05
2025-06-11,5391.74,rent,out,Counterparty_48,26659245.07,2025-05-01,2025-06-03
2025-06-11,1943.3,supplier_payment,out,Counterparty_52,26657301.77,2025-05-12,2025-06-13
2025-06-11,4173.63,supplier_payment,out,Counterparty_78,26653128.14,2025-05-13,2025-06-09
2025-06-11,3407.71,marketing_spend,out,Counterparty_15,26649720.43,2025-05-21,2025-06-18
2025-06-11,2708.25,payroll,out,Counterparty_27,26647012.18,2025-05-04,2025-06-01
2025-06-11,1385.16,rent,out,Counterparty_22,26645627.02,2025-05-15,2025-06-12
2025-06-11,11904.42,payroll,out,Counterparty_21,26633722.6,2025-05-21,2025-06-15
2025-06-11,1574.78,loan_repayment,out,Counterparty_62,26632147.82,2025-05-23,2025-06-18
2025-06-11,2745.56,asset_sale,in,Counterparty_85,26634893.38,,
2025-06-11,2773.58,investment_income,in,Counterparty_3,26637666.96,,
2025-06-11,2614.43,supplier_payment,out,Counterparty_15,26635052.53,2025-05-21,2025-06-15
2025-06-11,1930.22,credit,in,Counterparty_49,26636982.75,,
2025-06-11,11551.59,asset_sale,in,Counterparty_60,26648534.34,,
2025-06-11,1569.23,utilities,out,Counterparty_48,26646965.11,2025-05-17,2025-06-12
2025-06-11,6455.44,T&E,out,Counterparty_83,26640509.67,2025-05-22,2025-06-26
2025-06-11,2708.89,marketing_spend,out,Counterparty_55,26637800.78,2025-05-21,2025-06-22
2025-06-11,29880.89,customer_payment,in,Counterparty_80,26667681.67,,
2025-06-11,5103.45,tax_payment,out,Counterparty_36,26662578.22,2025-04-29,2025-05-27
2025-06-11,2086.71,payroll,out,Counterparty_59,26660491.51,2025-05-15,2025-06-23
2025-06-11,3097.98,credit,in,Counterparty_39,26663589.49,,
2025-06-11,1443.44,software_subscription,out,Counterparty_21,26662146.05,2025-04-29,2025-06-07
2025-06-11,3289.47,marketing_spend,out,Counterparty_45,26658856.58,2025-05-01,2025-05-31
2025-06-11,469.71,rent,out,Counterparty_92,26658386.87,2025-05-27,2025-06-21
2025-06-11,6542.05,supplier_payment,out,Counterparty_95,26651844.82,2025-05-05,2025-06-01
2025-06-11,1543.75,rent,out,Counterparty_17,26650301.07,2025-05-20,2025-06-26
2025-06-11,5276.84,payroll,out,Counterparty_55,26645024.23,2025-05-02,2025-05-29
2025-06-11,3813.62,tax_payment,out,Counterparty_64,26641210.61,2025-05-08,2025-06-11
2025-06-11,2140.19,utilities,out,Counterparty_94,26639070.42,2025-05-11,2025-06-13
2025-06-12,9403.26,customer_payment,in,Counterparty_82,26648473.68,,
2025-06-12,6530.95,investment_income,in,Counterparty_11,26655004.63,,
2025-06-12,2131.81,marketing_spend,out,Counterparty_75,26652872.82,2025-05-15,2025-06-13
2025-06-12,2709.85,software_subscription,out,Counterparty_41,26650162.97,2025-05-19,2025-06-20
2025-06-12,21995.01,investment_income,in,Counterparty_25,26672157.98,,
2025-06-12,2740.26,T&E,out,Counterparty_74,26669417.72,2025-05-12,2025-06-07
2025-06-12,513.26,rent,out,Counterparty_51,26668904.46,2025-05-04,2025-05-31
2025-06-12,3162.81,marketing_spend,out,Counterparty_43,26665741.65,2025-05-01,2025-06-04
2025-06-12,3871.7,T&E,out,Counterparty_69,26661869.95,2025-05-08,2025-06-13
2025-06-12,5296.04,marketing_spend,out,Counterparty_32,26656573.91,2025-05-17,2025-06-20
2025-06-12,1604.71,tax_payment,out,Counterparty_15,26654969.2,2025-05-21,2025-06-15
2025-06-12,6020.11,loan_repayment,out,Counterparty_37,26648949.09,2025-05-26,2025-07-04
2025-06-12,3380.73,payroll,out,Counterparty_48,26645568.36,2025-04-30,2025-05-27
2025-06-12,6056.01,investment_income,in,Counterparty_80,26651624.37,,
2025-06-12,1610.11,marketing_spend,out,Counterparty_90,26650014.26,2025-05-08,2025-06-09
2025-06-12,1833.01,supplier_payment,out,Counterparty_69,26648181.25,2025-05-12,2025-06-11
2025-06-12,7020.24,investment_income,in,Counterparty_87,26655201.49,,
2025-06-12,2309.34,credit,in,Counterparty_90,26657510.83,,
2025-06-12,3245.43,marketing_spend,out,Counterparty_43,26654265.4,2025-05-09,2025-06-16
2025-06-12,872.58,tax_payment,out,Counterparty_9,26653392.82,2025-05-24,2025-06-28
2025-06-12,17112.71,asset_sale,in,Counterparty_60,26670505.53,,
2025-06-12,1206.53,utilities,out,Counterparty_16,26669299.0,2025-05-24,2025-06-24
2025-06-12,1037.28,tax_payment,out,Counterparty_78,26668261.72,2025-05-12,2025-06-19
2025-06-12,3961.85,investment_income,in,Counterparty_53,26672223.57,,
2025-06-12,3205.99,utilities,out,Counterparty_20,26669017.58,2025-05-17,2025-06-16
2025-06-12,1991.19,software_subscription,out,Counterparty_48,26667026.39,2025-05-26,2025-07-04
2025-06-12,4.22,rent,out,Counterparty_33,26667022.17,2025-05-15,2025-06-20
2025-06-12,3831.86,asset_sale,in,Counterparty_90,26670854.03,,
2025-06-12,4373.19,utilities,out,Counterparty_95,26666480.84,2025-05-25,2025-06-21
2025-06-12,4151.4,tax_payment,out,Counterparty_60,26662329.44,2025-05-02,2025-05-30
2025-06-12,848.43,payroll,out,Counterparty_7,26661481.01,2025-05-13,2025-06-18
2025-06-12,928.09,loan_repayment,out,Counterparty_85,26660552.92,2025-05-21,2025-06-23
2025-06-12,2333.83,utilities,out,Counterparty_40,26658219.09,2025-05-10,2025-06-10
2025-06-12,4455.24,payroll,out,Counterparty_4,26653763.85,2025-05-16,2025-06-21
2025-06-12,13985.92,credit,in,Counterparty_77,26667749.77,,
2025-06-12,5297.47,loan_repayment,out,Counterparty_54,26662452.3,2025-05-22,2025-06-25
2025-06-12,3280.08,T&E,out,Counterparty_30,26659172.22,2025-05-24,2025-06-26
2025-06-12,507.9,credit,in,Counterparty_87,26659680.12,,
2025-06-12,4083.2,asset_sale,in,Counterparty_61,26663763.32,,
2025-06-12,4685.99,refund,in,Counterparty_71,26668449.31,,
2025-06-12,379.42,utilities,out,Counterparty_1,26668069.89,2025-04-29,2025-06-05
2025-06-12,1280.29,supplier_payment,out,Counterparty_10,26666789.6,2025-05-21,2025-06-28
2025-06-12,7943.56,supplier_payment,out,Counterparty_38,26658846.04,2025-04-29,2025-06-04
2025-06-12,4071.43,payroll,out,Counterparty_81,26654774.61,2025-05-28,2025-07-05
2025-06-12,4016.43,T&E,out,Counterparty_39,26650758.18,2025-05-06,2025-06-04
2025-06-12,7786.76,rent,out,Counterparty_93,26642971.42,2025-05-06,2025-06-07
2025-06-12,1798.63,credit,in,Counterparty_29,26644770.05,,
2025-06-12,4365.65,rent,out,Counterparty_62,26640404.4,2025-05-09,2025-06-15
2025-06-12,4485.85,payroll,out,Counterparty_5,26635918.55,2025-05-04,2025-05-30
2025-06-12,984.71,payroll,out,Counterparty_11,26634933.84,2025-04-30,2025-06-01
2025-06-12,10350.44,customer_payment,in,Counterparty_24,26645284.28,,
2025-06-12,2013.53,customer_payment,in,Counterparty_76,26647297.81,,
2025-06-12,1113.9,T&E,out,Counterparty_55,26646183.91,2025-05-28,2025-07-06
2025-06-12,27031.65,refund,in,Counterparty_31,26673215.56,,
2025-06-12,6340.33,utilities,out,Counterparty_27,26666875.23,2025-05-05,2025-06-02
2025-06-12,1242.16,rent,out,Counterparty_29,26665633.07,2025-05-07,2025-06-10
2025-06-12,988.66,asset_sale,in,Counterparty_68,26666621.73,,
2025-06-12,9872.92,asset_sale,in,Counterparty_1,26676494.65,,
2025-06-12,378.47,payroll,out,Counterparty_40,26676116.18,2025-05-16,2025-06-21
2025-06-12,5430.85,investment_income,in,Counterparty_40,26681547.03,,
2025-06-12,6465.36,asset_sale,in,Counterparty_58,26688012.39,,
2025-06-12,285.54,rent,out,Counterparty_57,26687726.85,2025-05-12,2025-06-20
2025-06-12,6960.12,marketing_spend,out,Counterparty_74,26680766.73,2025-05-04,2025-06-06
2025-06-12,1919.15,loan_repayment,out,Counterparty_40,26678847.58,2025-05-26,2025-06-25
2025-06-12,249.21,T&E,out,Counterparty_82,26678598.37,2025-05-04,2025-06-04
2025-06-12,4984.82,asset_sale,in,Counterparty_81,26683583.19,,
2025-06-12,2071.52,T&E,out,Counterparty_21,26681511.67,2025-05-18,2025-06-20
2025-06-12,233.06,payroll,out,Counterparty_28,26681278.61,2025-05-15,2025-06-17
2025-06-12,1267.76,T&E,out,Counterparty_65,26680010.85,2025-05-22,2025-06-28
2025-06-12,1003.4,loan_repayment,out,Counterparty_16,26679007.45,2025-05-05,2025-06-09
2025-06-12,1369.26,marketing_spend,out,Counterparty_34,26677638.19,2025-04-30,2025-05-27
2025-06-12,12421.6,customer_payment,in,Counterparty_18,26690059.79,,
2025-06-13,966.93,T&E,out,Counterparty_17,26689092.86,2025-05-09,2025-06-04
2025-06-13,25552.26,customer_payment,in,Counterparty_42,26714645.12,,
2025-06-13,2059.89,payroll,out,Counterparty_84,26712585.23,2025-05-23,2025-06-23
2025-06-13,2237.94,investment_income,in,Counterparty_81,26714823.17,,
2025-06-13,446.06,tax_payment,out,Counterparty_33,26714377.11,2025-05-18,2025-06-15
2025-06-13,457.28,loan_repayment,out,Counterparty_76,26713919.83,2025-05-18,2025-06-12
2025-06-13,23120.7,credit,in,Counterparty_32,26737040.53,,
2025-06-13,2971.65,payroll,out,Counterparty_94,26734068.88,2025-05-18,2025-06-23
2025-06-13,4094.97,loan_repayment,out,Counterparty_10,26729973.91,2025-05-05,2025-06-07
2025-06-13,3341.29,software_subscription,out,Counterparty_86,26726632.62,2025-05-18,2025-06-13
2025-06-13,181.91,marketing_spend,out,Counterparty_95,26726450.71,2025-05-15,2025-06-09
2025-06-13,647.88,tax_payment,out,Counterparty_85,26725802.83,2025-05-20,2025-06-24
2025-06-13,2735.45,investment_income,in,Counterparty_73,26728538.28,,
2025-06-13,540.91,software_subscription,out,Counterparty_85,26727997.37,2025-05-01,2025-06-08
2025-06-13,16153.19,customer_payment,in,Counterparty_2,26744150.56,,
2025-06-13,921.57,marketing_spend,out,Counterparty_99,26743228.99,2025-05-20,2025-06-26
2025-06-13,3783.38,utilities,out,Counterparty_96,26739445.61,2025-05-02,2025-06-10
2025-06-13,2195.26,loan_repayment,out,Counterparty_51,26737250.35,2025-05-13,2025-06-12
2025-06-13,708.94,payroll,out,Counterparty_89,26736541.41,2025-05-18,2025-06-15
2025-06-13,1204.46,asset_sale,in,Counterparty_72,26737745.87,,
2025-06-13,14566.24,loan_repayment,out,Counterparty_59,26723179.63,2025-05-24,2025-06-21
2025-06-13,7561.95,loan_repayment,out,Counterparty_31,26715617.68,2025-05-04,2025-06-02
2025-06-13,27056.14,refund,in,Counterparty_64,26742673.82,,
2025-06-13,98.35,investment_income,in,Counterparty_50,26742772.17,,
2025-06-13,12274.75,credit,in,Counterparty_95,26755046.92,,
2025-06-13,3746.53,payroll,out,Counterparty_58,26751300.39,2025-05-22,2025-06-17
2025-06-13,8980.27,utilities,out,Counterparty_11,26742320.12,2025-05-02,2025-06-07
2025-06-13,12394.54,credit,in,Counterparty_26,26754714.66,,
2025-06-13,1072.87,T&E,out,Counterparty_91,26753641.79,2025-05-16,2025-06-15
2025-06-13,6075.12,customer_payment,in,Counterparty_92,26759716.91,,
2025-06-13,4210.05,credit,in,Counterparty_98,26763926.96,,
2025-06-13,385.67,loan_repayment,out,Counterparty_5,26763541.29,2025-04-30,2025-06-05
2025-06-13,2984.26,payroll,out,Counterparty_53,26760557.03,2025-05-16,2025-06-11
2025-06-13,1559.87,supplier_payment,out,Counterparty_80,26758997.16,2025-05-19,2025-06-26
2025-06-13,1566.33,loan_repayment,out,Counterparty_21,26757430.83,2025-05-21,2025-06-23
2025-06-13,2320.32,asset_sale,in,Counterparty_21,26759751.15,,
2025-06-13,2817.42,tax_payment,out,Counterparty_94,26756933.73,2025-05-08,2025-06-13
2025-06-13,1526.01,loan_repayment,out,Counterparty_79,26755407.72,2025-05-04,2025-06-03
2025-06-13,9263.44,loan_repayment,out,Counterparty_11,26746144.28,2025-04-30,2025-06-05
2025-06-13,1890.82,credit,in,Counterparty_56,26748035.1,,
2025-06-13,9614.61,credit,in,Counterparty_13,26757649.71,,
2025-06-13,7926.18,credit,in,Counterparty_39,26765575.89,,
2025-06-13,2731.98,T&E,out,Counterparty_74,26762843.91,2025-05-07,2025-06-05
2025-06-13,963.59,T&E,out,Counterparty_77,26761880.32,2025-05-10,2025-06-04
2025-06-13,950.56,investment_income,in,Counterparty_74,26762830.88,,
2025-06-13,259.49,software_subscription,out,Counterparty_87,26762571.39,2025-05-25,2025-07-02
2025-06-13,302.04,rent,out,Counterparty_56,26762269.35,2025-05-08,2025-06-14
2025-06-13,10136.03,tax_payment,out,Counterparty_70,26752133.32,2025-05-10,2025-06-07
2025-06-13,487.1,rent,out,Counterparty_72,26751646.22,2025-05-13,2025-06-09
2025-06-13,11329.68,customer_payment,in,Counterparty_82,26762975.9,,
2025-06-13,753.83,utilities,out,Counterparty_28,26762222.07,2025-05-21,2025-06-20
2025-06-13,11101.36,utilities,out,Counterparty_2,26751120.71,2025-05-10,2025-06-16
2025-06-13,1608.1,customer_payment,in,Counterparty_61,26752728.81,,
2025-06-13,7206.14,utilities,out,Counterparty_12,26745522.67,2025-05-25,2025-06-19
2025-06-13,2076.88,refund,in,Counterparty_91,26747599.55,,
2025-06-13,1347.78,marketing_spend,out,Counterparty_17,26746251.77,2025-05-22,2025-06-27
2025-06-13,2015.57,credit,in,Counterparty_13,26748267.34,,
2025-06-13,2156.63,rent,out,Counterparty_22,26746110.71,2025-05-29,2025-06-23
2025-06-13,6808.48,tax_payment,out,Counterparty_3,26739302.23,2025-05-08,2025-06-10
2025-06-13,12707.55,asset_sale,in,Counterparty_10,26752009.78,,
2025-06-13,1945.4,marketing_spend,out,Counterparty_7,26750064.38,2025-05-06,2025-06-03
2025-06-13,13099.16,customer_payment,in,Counterparty_30,26763163.54,,
2025-06-13,485.21,utilities,out,Counterparty_93,26762678.33,2025-05-07,2025-06-06
2025-06-13,6040.66,credit,in,Counterparty_35,26768718.99,,
2025-06-14,3847.71,software_subscription,out,Counterparty_66,26764871.28,2025-05-17,2025-06-21
2025-06-14,1984.56,supplier_payment,out,Counterparty_63,26762886.72,2025-05-09,2025-06-14
2025-06-14,2963.02,refund,in,Counterparty_61,26765849.74,,
2025-06-14,1839.05,rent,out,Counterparty_15,26764010.69,2025-05-05,2025-06-06
2025-06-14,3100.29,asset_sale,in,Counterparty_2,26767110.98,,
2025-06-14,15525.77,supplier_payment,out,Counterparty_99,26751585.21,2025-05-06,2025-06-08
2025-06-14,1732.28,payroll,out,Counterparty_96,26749852.93,2025-05-24,2025-06-20
2025-06-14,13662.83,customer_payment,in,Counterparty_56,26763515.76,,
2025-06-14,1045.54,credit,in,Counterparty_32,26764561.3,,
2025-06-14,274.97,loan_repayment,out,Counterparty_34,26764286.33,2025-05-07,2025-06-14
2025-06-14,9231.83,refund,in,Counterparty_53,26773518.16,,
2025-06-14,14620.39,investment_income,in,Counterparty_90,26788138.55,,
2025-06-14,658.17,tax_payment,out,Counterparty_3,26787480.38,2025-05-18,2025-06-22
2025-06-14,2430.93,rent,out,Counterparty_37,26785049.45,2025-05-19,2025-06-20
2025-06-14,2749.5,supplier_payment,out,Counterparty_61,26782299.95,2025-05-11,2025-06-15
2025-06-14,5651.88,utilities,out,Counterparty_22,26776648.07,2025-05-23,2025-06-26
2025-06-14,2075.34,payroll,out,Counterparty_11,26774572.73,2025-05-19,2025-06-26
2025-06-14,5937.72,software_subscription,out,Counterparty_20,26768635.01,2025-05-09,2025-06-11
2025-06-14,1476.42,customer_payment,in,Counterparty_14,26770111.43,,
2025-06-14,4557.67,rent,out,Counterparty_69,26765553.76,2025-05-06,2025-06-13
2025-06-14,4631.56,software_subscription,out,Counterparty_59,26760922.2,2025-05-19,2025-06-19
2025-06-14,10410.72,customer_payment,in,Counterparty_25,26771332.92,,
2025-06-14,17036.6,asset_sale,in,Counterparty_69,26788369.52,,
2025-06-14,8591.58,credit,in,Counterparty_52,26796961.1,,
2025-06-14,21658.49,investment_income,in,Counterparty_80,26818619.59,,
2025-06-14,51.74,T&E,out,Counterparty_35,26818567.85,2025-05-01,2025-06-09
2025-06-14,4645.98,loan_repayment,out,Counterparty_94,26813921.87,2025-05-18,2025-06-23
2025-06-14,4395.44,T&E,out,Counterparty_66,26809526.43,2025-05-16,2025-06-10
2025-06-14,471.03,investment_income,in,Counterparty_51,26809997.46,,
2025-06-14,342.78,credit,in,Counterparty_93,26810340.24,,
2025-06-14,3797.26,marketing_spend,out,Counterparty_2,26806542.98,2025-05-21,2025-06-26
2025-06-14,744.89,T&E,out,Counterparty_23,26805798.09,2025-05-04,2025-06-03
2025-06-14,969.7,marketing_spend,out,Counterparty_65,26804828.39,2025-05-02,2025-06-10
2025-06-14,7577.78,refund,in,Counterparty_43,26812406.17,,
2025-06-14,5288.69,software_subscription,out,Counterparty_5,26807117.48,2025-05-28,2025-06-29
2025-06-14,5280.21,rent,out,Counterparty_45,26801837.27,2025-05-02,2025-05-27
2025-06-14,733.75,tax_payment,out,Counterparty_13,26801103.52,2025-05-02,2025-05-31
2025-06-14,1615.36,T&E,out,Counterparty_7,26799488.16,2025-05-30,2025-07-07
2025-06-14,3892.09,payroll,out,Counterparty_76,26795596.07,2025-05-16,2025-06-12
2025-06-14,1359.77,T&E,out,Counterparty_81,26794236.3,2025-05-09,2025-06-08
2025-06-14,7741.41,tax_payment,out,Counterparty_59,26786494.89,2025-05-17,2025-06-11
2025-06-14,24120.04,credit,in,Counterparty_22,26810614.93,,
2025-06-14,1755.94,utilities,out,Counterparty_56,26808858.99,2025-05-11,2025-06-17
2025-06-14,2569.32,marketing_spend,out,Counterparty_24,26806289.67,2025-05-12,2025-06-17
2025-06-14,1778.6,payroll,out,Counterparty_82,26804511.07,2025-05-12,2025-06-07
2025-06-14,10606.91,credit,in,Counterparty_12,26815117.98,,
2025-06-14,315.53,rent,out,Counterparty_77,26814802.45,2025-05-23,2025-06-29
2025-06-14,2576.89,investment_income,in,Counterparty_27,26817379.34,,
2025-06-14,1290.3,loan_repayment,out,Counterparty_95,26816089.04,2025-05-01,2025-06-06
2025-06-14,2043.67,investment_income,in,Counterparty_45,26818132.71,,
2025-06-14,1076.94,utilities,out,Counterparty_99,26817055.77,2025-05-04,2025-06-05
2025-06-14,6851.48,refund,in,Counterparty_48,26823907.25,,
2025-06-14,11948.47,payroll,out,Counterparty_76,26811958.78,2025-05-18,2025-06-20
2025-06-14,5540.28,rent,out,Counterparty_62,26806418.5,2025-05-27,2025-07-03
2025-06-14,3343.27,payroll,out,Counterparty_69,26803075.23,2025-05-23,2025-06-17
2025-06-15,1955.42,marketing_spend,out,Counterparty_9,26801119.81,2025-05-21,2025-06-25
2025-06-15,4607.22,customer_payment,in,Counterparty_65,26805727.03,,
2025-06-15,1377.66,marketing_spend,out,Counterparty_77,26804349.37,2025-05-15,2025-06-12
2025-06-15,15475.67,customer_payment,in,Counterparty_95,26819825.04,,
2025-06-15,3388.89,investment_income,in,Counterparty_57,26823213.93,,
2025-06-15,1235.93,credit,in,Counterparty_63,26824449.86,,
2025-06-15,942.22,investment_income,in,Counterparty_58,26825392.08,,
2025-06-15,1034.73,software_subscription,out,Counterparty_85,26824357.35,2025-05-03,2025-06-09
2025-06-15,13726.51,customer_payment,in,Counterparty_71,26838083.86,,
2025-06-15,10347.23,payroll,out,Counterparty_10,26827736.63,2025-05-12,2025-06-12
2025-06-15,734.79,tax_payment,out,Counterparty_71,26827001.84,2025-05-27,2025-06-23
2025-06-15,8845.56,tax_payment,out,Counterparty_50,26818156.28,2025-05-08,2025-06-09
2025-06-15,1241.14,utilities,out,Counterparty_93,26816915.14,2025-05-07,2025-06-11
2025-06-15,10039.29,customer_payment,in,Counterparty_18,26826954.43,,
2025-06-15,5425.55,supplier_payment,out,Counterparty_70,26821528.88,2025-05-26,2025-07-03
2025-06-15,565.46,credit,in,Counterparty_61,26822094.34,,
2025-06-15,8654.42,investment_income,in,Counterparty_51,26830748.76,,
2025-06-15,15079.81,utilities,out,Counterparty_74,26815668.95,2025-05-23,2025-06-26
2025-06-15,600.65,supplier_payment,out,Counterparty_86,26815068.3,2025-05-11,2025-06-17
2025-06-15,4469.63,credit,in,Counterparty_27,26819537.93,,
2025-06-15,20617.43,asset_sale,in,Counterparty_92,26840155.36,,
2025-06-15,2597.59,software_subscription,out,Counterparty_88,26837557.77,2025-05-19,2025-06-22
2025-06-15,4247.18,rent,out,Counterparty_74,26833310.59,2025-05-02,2025-05-28
2025-06-15,5430.34,investment_income,in,Counterparty_2,26838740.93,,
2025-06-15,7984.25,T&E,out,Counterparty_36,26830756.68,2025-05-30,2025-06-27
2025-06-15,8959.39,investment_income,in,Counterparty_13,26839716.07,,
2025-06-15,1631.36,loan_repayment,out,Counterparty_62,26838084.71,2025-05-22,2025-06-16
2025-06-15,3252.6,supplier_payment,out,Counterparty_29,26834832.11,2025-05-21,2025-06-22
2025-06-15,2306.61,software_subscription,out,Counterparty_14,26832525.5,2025-05-20,2025-06-28
2025-06-15,4271.65,T&E,out,Counterparty_14,26828253.85,2025-05-12,2025-06-07
2025-06-15,4710.4,tax_payment,out,Counterparty_85,26823543.45,2025-05-02,2025-05-29
2025-06-15,2189.42,supplier_payment,out,Counterparty_67,26821354.03,2025-05-02,2025-05-29
2025-06-15,3998.6,supplier_payment,out,Counterparty_28,26817355.43,2025-05-17,2025-06-18
2025-06-15,1184.54,asset_sale,in,Counterparty_89,26818539.97,,
2025-06-15,141.02,customer_payment,in,Counterparty_43,26818680.99,,
2025-06-15,1980.39,credit,in,Counterparty_72,26820661.38,,
2025-06-15,1495.79,loan_repayment,out,Counterparty_16,26819165.59,2025-05-18,2025-06-18
2025-06-15,33930.23,asset_sale,in,Counterparty_37,26853095.82,,
2025-06-15,477.82,rent,out,Counterparty_85,26852618.0,2025-05-16,2025-06-12
2025-06-15,21742.55,credit,in,Counterparty_51,26874360.55,,
2025-06-15,5572.45,refund,in,Counterparty_46,26879933.0,,
2025-06-15,3835.16,rent,out,Counterparty_80,26876097.84,2025-05-22,2025-06-17
2025-06-15,2865.34,software_subscription,out,Counterparty_41,26873232.5,2025-05-08,2025-06-07
2025-06-15,16355.58,credit,in,Counterparty_44,26889588.08,,
2025-06-15,3092.46,loan_repayment,out,Counterparty_4,26886495.62,2025-05-20,2025-06-27
2025-06-15,1540.61,utilities,out,Counterparty_19,26884955.01,2025-05-16,2025-06-17
2025-06-15,4824.59,software_subscription,out,Counterparty_32,26880130.42,2025-05-24,2025-06-23
2025-06-15,995.88,refund,in,Counterparty_32,26881126.3,,
2025-06-16,4218.59,software_subscription,out,Counterparty_33,26876907.71,2025-05-03,2025-06-04
2025-06-16,3530.59,rent,out,Counterparty_87,26873377.12,2025-05-06,2025-06-03
2025-06-16,9432.13,T&E,out,Counterparty_84,26863944.99,2025-05-11,2025-06-06
2025-06-16,339.25,marketing_spend,out,Counterparty_15,26863605.74,2025-05-04,2025-05-30
2025-06-16,2256.37,customer_payment,in,Counterparty_8,26865862.11,,
2025-06-16,3714.84,software_subscription,out,Counterparty_70,26862147.27,2025-05-05,2025-05-30
2025-06-16,2874.15,tax_payment,out,Counterparty_6,26859273.12,2025-05-26,2025-06-24
2025-06-16,427.77,refund,in,Counterparty_41,26859700.89,,
2025-06-16,7691.58,refund,in,Counterparty_65,26867392.47,,
2025-06-16,1952.16,customer_payment,in,Counterparty_55,26869344.63,,
2025-06-16,17172.47,asset_sale,in,Counterparty_70,26886517.1,,
2025-06-16,5827.3,payroll,out,Counterparty_49,26880689.8,2025-05-11,2025-06-16
2025-06-16,704.92,loan_repayment,out,Counterparty_50,26879984.88,2025-05-28,2025-07-03
2025-06-16,112.84,credit,in,Counterparty_38,26880097.72,,
2025-06-16,2673.12,investment_income,in,Counterparty_48,26882770.84,,
2025-06-16,16185.89,credit,in,Counterparty_75,26898956.73,,
2025-06-16,12321.14,investment_income,in,Counterparty_88,26911277.87,,
2025-06-16,19094.63,customer_payment,in,Counterparty_80,26930372.5,,
2025-06-16,4036.66,customer_payment,in,Counterparty_14,26934409.16,,
2025-06-16,2887.62,utilities,out,Counterparty_91,26931521.54,2025-05-19,2025-06-26
2025-06-16,1986.01,supplier_payment,out,Counterparty_92,26929535.53,2025-05-03,2025-05-28
2025-06-16,338.4,tax_payment,out,Counterparty_58,26929197.13,2025-05-07,2025-06-05
2025-06-16,6467.42,utilities,out,Counterparty_87,26922729.71,2025-05-27,2025-06-23
2025-06-16,319.67,asset_sale,in,Counterparty_57,26923049.38,,
2025-06-16,1960.41,T&E,out,Counterparty_10,26921088.97,2025-05-06,2025-06-13
2025-06-16,180.32,investment_income,in,Counterparty_63,26921269.29,,
2025-06-16,3095.94,utilities,out,Counterparty_21,26918173.35,2025-05-23,2025-06-29
2025-06-16,1819.29,tax_payment,out,Counterparty_53,26916354.06,2025-05-25,2025-07-01
2025-06-16,198.87,tax_payment,out,Counterparty_75,26916155.19,2025-05-15,2025-06-20
2025-06-16,925.46,utilities,out,Counterparty_69,26915229.73,2025-05-31,2025-06-26
2025-06-16,439.64,supplier_payment,out,Counterparty_62,26914790.09,2025-05-19,2025-06-18
2025-06-16,15585.05,investment_income,in,Counterparty_84,26930375.14,,
2025-06-16,654.7,payroll,out,Counterparty_1,26929720.44,2025-05-07,2025-06-01
2025-06-16,2476.74,payroll,out,Counterparty_40,26927243.7,2025-05-18,2025-06-22
2025-06-16,5099.55,rent,out,Counterparty_47,26922144.15,2025-05-28,2025-06-23
2025-06-16,463.4,supplier_payment,out,Counterparty_50,26921680.75,2025-05-24,2025-06-30
2025-06-16,1453.17,tax_payment,out,Counterparty_68,26920227.58,2025-05-14,2025-06-21
2025-06-16,1651.5,rent,out,Counterparty_18,26918576.08,2025-05-03,2025-06-08
2025-06-16,2755.1,marketing_spend,out,Counterparty_11,26915820.98,2025-05-21,2025-06-27
2025-06-16,10271.9,refund,in,Counterparty_59,26926092.88,,
2025-06-16,1443.13,loan_repayment,out,Counterparty_34,26924649.75,2025-05-23,2025-06-21
2025-06-16,3407.01,payroll,out,Counterparty_52,26921242.74,2025-05-29,2025-06-29
2025-06-16,1245.84,rent,out,Counterparty_2,26919996.9,2025-05-20,2025-06-17
2025-06-16,4754.98,rent,out,Counterparty_91,26915241.92,2025-05-18,2025-06-18
2025-06-16,1446.13,payroll,out,Counterparty_42,26913795.79,2025-05-09,2025-06-17
2025-06-16,1986.0,loan_repayment,out,Counterparty_75,26911809.79,2025-05-30,2025-06-29
2025-06-16,2721.98,supplier_payment,out,Counterparty_96,26909087.81,2025-05-11,2025-06-11
2025-06-16,347.02,loan_repayment,out,Counterparty_47,26908740.79,2025-05-29,2025-07-06
2025-06-16,22546.76,refund,in,Counterparty_30,26931287.55,,
2025-06-16,1728.91,marketing_spend,out,Counterparty_87,26929558.64,2025-05-22,2025-06-17
2025-06-16,3812.22,tax_payment,out,Counterparty_69,26925746.42,2025-05-28,2025-06-29
2025-06-16,2369.01,T&E,out,Counterparty_19,26923377.41,2025-05-30,2025-07-03
2025-06-16,1017.12,utilities,out,Counterparty_23,26922360.29,2025-05-27,2025-06-25
2025-06-16,3279.34,utilities,out,Counterparty_43,26919080.95,2025-05-10,2025-06-07
2025-06-16,1555.18,software_subscription,out,Counterparty_92,26917525.77,2025-05-03,2025-06-03
2025-06-16,8599.86,refund,in,Counterparty_20,26926125.63,,
2025-06-16,15.36,supplier_payment,out,Counterparty_61,26926110.27,2025-05-27,2025-07-05
2025-06-16,6339.24,asset_sale,in,Counterparty_40,26932449.51,,
2025-06-16,557.95,supplier_payment,out,Counterparty_70,26931891.56,2025-06-01,2025-07-10
2025-06-16,6255.84,payroll,out,Counterparty_84,26925635.72,2025-05-27,2025-06-23
2025-06-16,4888.43,T&E,out,Counterparty_7,26920747.29,2025-05-20,2025-06-19
2025-06-17,6450.53,tax_payment,out,Counterparty_77,26914296.76,2025-05-10,2025-06-08
2025-06-17,655.79,T&E,out,Counterparty_99,26913640.97,2025-05-27,2025-06-29
2025-06-17,2703.86,supplier_payment,out,Counterparty_96,26910937.11,2025-05-28,2025-06-26
2025-06-17,10394.48,refund,in,Counterparty_58,26921331.59,,
2025-06-17,1251.37,marketing_spend,out,Counterparty_26,26920080.22,2025-05-17,2025-06-11
2025-06-17,1325.13,marketing_spend,out,Counterparty_78,26918755.09,2025-05-09,2025-06-17
2025-06-17,2088.21,refund,in,Counterparty_19,26920843.3,,
2025-06-17,1076.15,asset_sale,in,Counterparty_66,26921919.45,,
2025-06-17,10.14,utilities,out,Counterparty_55,26921909.31,2025-05-26,2025-06-28
2025-06-17,3658.75,software_subscription,out,Counterparty_66,26918250.56,2025-05-08,2025-06-03
2025-06-17,126.2,credit,in,Counterparty_35,26918376.76,,
2025-06-17,391.69,tax_payment,out,Counterparty_83,26917985.07,2025-05-13,2025-06-20
2025-06-17,5172.33,marketing_spend,out,Counterparty_19,26912812.74,2025-05-09,2025-06-09
2025-06-17,1086.06,T&E,out,Counterparty_91,26911726.68,2025-05-26,2025-06-24
2025-06-17,107.31,utilities,out,Counterparty_5,26911619.37,2025-05-30,2025-06-27
2025-06-17,3868.8,investment_income,in,Counterparty_21,26915488.17,,
2025-06-17,1798.73,utilities,out,Counterparty_99,26913689.44,2025-05-27,2025-06-27
2025-06-17,790.9,investment_income,in,Counterparty_85,26914480.34,,
2025-06-17,2251.41,supplier_payment,out,Counterparty_12,26912228.93,2025-05-25,2025-06-26
2025-06-17,586.62,asset_sale,in,Counterparty_18,26912815.55,,
2025-06-17,2508.72,supplier_payment,out,Counterparty_60,26910306.83,2025-05-25,2025-06-29
2025-06-17,3647.68,utilities,out,Counterparty_65,26906659.15,2025-05-08,2025-06-14
2025-06-17,22015.77,credit,in,Counterparty_62,26928674.92,,
2025-06-17,641.92,asset_sale,in,Counterparty_41,26929316.84,,
2025-06-17,165.07,loan_repayment,out,Counterparty_74,26929151.77,2025-05-04,2025-06-08
2025-06-17,5541.59,investment_income,in,Counterparty_14,26934693.36,,
2025-06-17,3832.1,customer_payment,in,Counterparty_50,26938525.46,,
2025-06-17,14734.63,customer_payment,in,Counterparty_98,26953260.09,,
2025-06-17,3984.67,asset_sale,in,Counterparty_60,26957244.76,,
2025-06-17,4313.47,customer_payment,in,Counterparty_97,26961558.23,,
2025-06-17,3311.96,refund,in,Counterparty_13,26964870.19,,
2025-06-17,4602.25,software_subscription,out,Counterparty_54,26960267.94,2025-05-20,2025-06-15
2025-06-17,4829.27,customer_payment,in,Counterparty_75,26965097.21,,
2025-06-17,7867.84,investment_income,in,Counterparty_88,26972965.05,,
2025-06-17,76.71,customer_payment,in,Counterparty_29,26973041.76,,
2025-06-17,655.05,investment_income,in,Counterparty_40,26973696.81,,
2025-06-17,1067.18,marketing_spend,out,Counterparty_64,26972629.63,2025-05-15,2025-06-11
2025-06-17,1435.48,payroll,out,Counterparty_36,26971194.15,2025-05-05,2025-06-09
2025-06-17,505.61,marketing_spend,out,Counterparty_68,26970688.54,2025-05-04,2025-05-30
2025-06-17,2357.32,customer_payment,in,Counterparty_76,26973045.86,,
2025-06-17,2754.06,asset_sale,in,Counterparty_96,26975799.92,,
2025-06-17,620.81,software_subscription,out,Counterparty_84,26975179.11,2025-05-21,2025-06-21
2025-06-17,8639.44,credit,in,Counterparty_27,26983818.55,,
2025-06-17,1336.63,loan_repayment,out,Counterparty_40,26982481.92,2025-05-19,2025-06-18
2025-06-17,1332.77,software_subscription,out,Counterparty_48,26981149.15,2025-05-07,2025-06-09
2025-06-17,10645.69,software_subscription,out,Counterparty_55,26970503.46,2025-05-24,2025-06-24
2025-06-17,1357.39,payroll,out,Counterparty_32,26969146.07,2025-05-27,2025-07-03
2025-06-17,2516.36,T&E,out,Counterparty_53,26966629.71,2025-05-08,2025-06-11
2025-06-17,4361.02,loan_repayment,out,Counterparty_61,26962268.69,2025-05-04,2025-06-09
2025-06-17,7926.41,payroll,out,Counterparty_22,26954342.28,2025-05-30,2025-06-30
2025-06-17,5893.46,marketing_spend,out,Counterparty_80,26948448.82,2025-05-05,2025-06-10
2025-06-17,5609.89,software_subscription,out,Counterparty_66,26942838.93,2025-05-04,2025-06-12
2025-06-17,1288.46,software_subscription,out,Counterparty_92,26941550.47,2025-05-05,2025-06-01
2025-06-17,660.67,payroll,out,Counterparty_48,26940889.8,2025-05-27,2025-06-23
2025-06-17,7753.29,utilities,out,Counterparty_95,26933136.51,2025-05-31,2025-07-03
2025-06-17,929.94,payroll,out,Counterparty_52,26932206.57,2025-05-12,2025-06-16
2025-06-17,7083.17,credit,in,Counterparty_77,26939289.74,,
2025-06-17,8503.93,utilities,out,Counterparty_90,26930785.81,2025-05-22,2025-06-29
2025-06-17,764.18,tax_payment,out,Counterparty_96,26930021.63,2025-05-29,2025-07-02
2025-06-17,1572.81,marketing_spend,out,Counterparty_54,26928448.82,2025-05-16,2025-06-12
2025-06-17,16378.88,customer_payment,in,Counterparty_6,26944827.7,,
2025-06-17,9417.46,refund,in,Counterparty_61,26954245.16,,
2025-06-17,206.42,payroll,out,Counterparty_83,26954038.74,2025-05-09,2025-06-11
2025-06-17,3627.5,software_subscription,out,Counterparty_78,26950411.24,2025-05-22,2025-06-18
2025-06-18,965.98,rent,out,Counterparty_78,26949445.26,2025-05-31,2025-07-04
2025-06-18,864.05,rent,out,Counterparty_99,26948581.21,2025-05-16,2025-06-17
2025-06-18,604.36,utilities,out,Counterparty_95,26947976.85,2025-05-29,2025-06-25
2025-06-18,5076.1,marketing_spend,out,Counterparty_23,26942900.75,2025-05-05,2025-06-03
2025-06-18,515.49,marketing_spend,out,Counterparty_16,26942385.26,2025-06-02,2025-07-09
2025-06-18,50.89,software_subscription,out,Counterparty_40,26942334.37,2025-06-01,2025-07-10
2025-06-18,6230.64,asset_sale,in,Counterparty_60,26948565.01,,
2025-06-18,1841.22,rent,out,Counterparty_82,26946723.79,2025-05-14,2025-06-14
2025-06-18,6540.29,rent,out,Counterparty_2,26940183.5,2025-06-01,2025-07-08
2025-06-18,584.4,supplier_payment,out,Counterparty_73,26939599.1,2025-05-31,2025-07-08
2025-06-18,3285.73,software_subscription,out,Counterparty_4,26936313.37,2025-06-01,2025-07-07
2025-06-18,1835.51,marketing_spend,out,Counterparty_71,26934477.86,2025-05-09,2025-06-15
2025-06-18,9988.4,investment_income,in,Counterparty_2,26944466.26,,
2025-06-18,4371.03,supplier_payment,out,Counterparty_89,26940095.23,2025-05-24,2025-07-01
2025-06-18,8098.99,payroll,out,Counterparty_77,26931996.24,2025-05-27,2025-07-01
2025-06-18,1333.01,asset_sale,in,Counterparty_53,26933329.25,,
2025-06-18,616.25,T&E,out,Counterparty_38,26932713.0,2025-05-19,2025-06-24
2025-06-18,890.08,customer_payment,in,Counterparty_30,26933603.08,,
2025-06-18,4406.0,marketing_spend,out,Counterparty_55,26929197.08,2025-06-03,2025-07-02
2025-06-18,2386.54,marketing_spend,out,Counterparty_84,26926810.54,2025-05-09,2025-06-06
2025-06-18,3361.45,software_subscription,out,Counterparty_22,26923449.09,2025-05-15,2025-06-10
2025-06-18,2123.9,customer_payment,in,Counterparty_8,26925572.99,,
2025-06-18,17687.53,refund,in,Counterparty_21,26943260.52,,
2025-06-18,13098.81,customer_payment,in,Counterparty_84,26956359.33,,
2025-06-18,4997.01,credit,in,Counterparty_54,26961356.34,,
2025-06-18,6974.1,software_subscription,out,Counterparty_33,26954382.24,2025-05-30,2025-07-06
2025-06-18,8381.72,credit,in,Counterparty_28,26962763.96,,
2025-06-18,3468.07,asset_sale,in,Counterparty_72,26966232.03,,
2025-06-18,20104.01,refund,in,Counterparty_29,26986336.04,,
2025-06-18,5567.28,software_subscription,out,Counterparty_1,26980768.76,2025-05-11,2025-06-13
2025-06-18,743.36,marketing_spend,out,Counterparty_17,26980025.4,2025-05-11,2025-06-12
2025-06-18,96.76,software_subscription,out,Counterparty_74,26979928.64,2025-05-31,2025-07-02
2025-06-18,5634.26,investment_income,in,Counterparty_44,26985562.9,,
2025-06-18,166.96,asset_sale,in,Counterparty_42,26985729.86,,
2025-06-18,8471.9,customer_payment,in,Counterparty_43,26994201.76,,
2025-06-18,14570.33,customer_payment,in,Counterparty_59,27008772.09,,
2025-06-18,8032.45,customer_payment,in,Counterparty_2,27016804.54,,
2025-06-18,6915.28,investment_income,in,Counterparty_36,27023719.82,,
2025-06-18,4742.91,investment_income,in,Counterparty_28,27028462.73,,
2025-06-18,2033.48,refund,in,Counterparty_56,27030496.21,,
2025-06-18,6602.75,refund,in,Counterparty_13,27037098.96,,
2025-06-18,1311.54,supplier_payment,out,Counterparty_66,27035787.42,2025-05-23,2025-06-25
2025-06-18,4159.75,payroll,out,Counterparty_93,27031627.67,2025-05-26,2025-06-29
2025-06-18,92.03,supplier_payment,out,Counterparty_23,27031535.64,2025-05-22,2025-06-20
2025-06-18,841.97,T&E,out,Counterparty_12,27030693.67,2025-05-09,2025-06-06
2025-06-18,6068.32,investment_income,in,Counterparty_92,27036761.99,,
2025-06-18,1612.17,payroll,out,Counterparty_75,27035149.82,2025-05-08,2025-06-16
2025-06-18,1574.32,credit,in,Counterparty_51,27036724.14,,
2025-06-18,917.46,software_subscription,out,Counterparty_36,27035806.68,2025-05-06,2025-06-11
2025-06-18,3367.11,supplier_payment,out,Counterparty_34,27032439.57,2025-05-21,2025-06-15
2025-06-18,1718.14,tax_payment,out,Counterparty_93,27030721.43,2025-05-29,2025-06-25
2025-06-18,927.1,tax_payment,out,Counterparty_87,27029794.33,2025-05-30,2025-07-05
2025-06-18,1077.7,investment_income,in,Counterparty_57,27030872.03,,
2025-06-18,2295.57,credit,in,Counterparty_80,27033167.6,,
2025-06-18,6407.98,T&E,out,Counterparty_60,27026759.62,2025-05-15,2025-06-13
2025-06-18,833.41,payroll,out,Counterparty_71,27025926.21,2025-05-17,2025-06-19
2025-06-18,1676.96,loan_repayment,out,Counterparty_11,27024249.25,2025-05-26,2025-06-20
2025-06-18,3677.83,customer_payment,in,Counterparty_9,27027927.08,,
2025-06-19,907.52,asset_sale,in,Counterparty_21,27028834.6,,
2025-06-19,9230.94,loan_repayment,out,Counterparty_76,27019603.66,2025-05-26,2025-06-26
2025-06-19,3330.32,asset_sale,in,Counterparty_8,27022933.98,,
2025-06-19,3977.24,refund,in,Counterparty_5,27026911.22,,
2025-06-19,1438.63,investment_income,in,Counterparty_51,27028349.85,,
2025-06-19,581.98,tax_payment,out,Counterparty_75,27027767.87,2025-05-24,2025-06-26
2025-06-19,7346.83,payroll,out,Counterparty_55,27020421.04,2025-05-11,2025-06-07
2025-06-19,17955.46,refund,in,Counterparty_86,27038376.5,,
2025-06-19,1517.65,supplier_payment,out,Counterparty_14,27036858.85,2025-05-26,2025-06-25
2025-06-19,6004.92,tax_payment,out,Counterparty_29,27030853.93,2025-05-09,2025-06-10
2025-06-19,1087.35,rent,out,Counterparty_38,27029766.58,2025-05-22,2025-06-23
2025-06-19,3839.36,marketing_spend,out,Counterparty_46,27025927.22,2025-05-18,2025-06-19
2025-06-19,243.94,payroll,out,Counterparty_76,27025683.28,2025-05-15,2025-06-16
2025-06-19,1900.74,credit,in,Counterparty_12,27027584.02,,
2025-06-19,3575.08,T&E,out,Counterparty_88,27024008.94,2025-05-30,2025-07-01
2025-06-19,3921.97,payroll,out,Counterparty_17,27020086.97,2025-05-19,2025-06-23
2025-06-19,5880.31,customer_payment,in,Counterparty_41,27025967.28,,
2025-06-19,1196.6,payroll,out,Counterparty_61,27024770.68,2025-05-11,2025-06-18
2025-06-19,17890.96,refund,in,Counterparty_72,27042661.64,,
2025-06-19,8162.87,payroll,out,Counterparty_21,27034498.77,2025-06-01,2025-07-04
2025-06-19,5057.54,asset_sale,in,Counterparty_83,27039556.31,,
2025-06-19,6926.37,investment_income,in,Counterparty_95,27046482.68,,
2025-06-19,19451.37,asset_sale,in,Counterparty_20,27065934.05,,
2025-06-19,12013.16,supplier_payment,out,Counterparty_19,27053920.89,2025-05-17,2025-06-19
2025-06-19,5669.34,software_subscription,out,Counterparty_73,27048251.55,2025-05-27,2025-07-04
2025-06-19,1874.71,loan_repayment,out,Counterparty_46,27046376.84,2025-05-31,2025-07-09
2025-06-19,13719.22,credit,in,Counterparty_64,27060096.06,,
2025-06-19,4119.49,rent,out,Counterparty_27,27055976.57,2025-05-11,2025-06-10
2025-06-19,2603.18,payroll,out,Counterparty_61,27053373.39,2025-06-04,2025-07-10
2025-06-19,430.65,refund,in,Counterparty_34,27053804.04,,
2025-06-19,3683.89,payroll,out,Counterparty_82,27050120.15,2025-05-19,2025-06-23
2025-06-19,1267.81,marketing_spend,out,Counterparty_7,27048852.34,2025-05-23,2025-06-25
2025-06-19,1222.86,loan_repayment,out,Counterparty_21,27047629.48,2025-05-27,2025-06-29
2025-06-19,4415.3,asset_sale,in,Counterparty_28,27052044.78,,
2025-06-19,7386.73,supplier_payment,out,Counterparty_8,27044658.05,2025-06-02,2025-07-03
2025-06-19,3604.24,loan_repayment,out,Counterparty_14,27041053.81,2025-05-19,2025-06-24
2025-06-19,1406.91,software_subscription,out,Counterparty_27,27039646.9,2025-05-17,2025-06-13
2025-06-19,1960.09,loan_repayment,out,Counterparty_6,27037686.81,2025-05-17,2025-06-13
2025-06-19,824.45,utilities,out,Counterparty_97,27036862.36,2025-05-31,2025-06-25
2025-06-19,14.5,rent,out,Counterparty_53,27036847.86,2025-05-27,2025-06-28
2025-06-19,1914.73,marketing_spend,out,Counterparty_22,27034933.13,2025-05-19,2025-06-17
2025-06-19,6583.68,credit,in,Counterparty_31,27041516.81,,
2025-06-19,5086.71,marketing_spend,out,Counterparty_68,27036430.1,2025-05-30,2025-06-29
2025-06-19,6883.05,supplier_payment,out,Counterparty_45,27029547.05,2025-05-08,2025-06-13
2025-06-19,1989.5,marketing_spend,out,Counterparty_2,27027557.55,2025-05-25,2025-06-22
2025-06-19,16562.6,credit,in,Counterparty_61,27044120.15,,
2025-06-19,168.91,marketing_spend,out,Counterparty_86,27043951.24,2025-05-09,2025-06-03
2025-06-19,9999.38,payroll,out,Counterparty_78,27033951.86,2025-06-04,2025-07-07
2025-06-19,5063.63,credit,in,Counterparty_40,27039015.49,,
2025-06-19,7140.76,T&E,out,Counterparty_97,27031874.73,2025-05-17,2025-06-16
2025-06-20,9382.64,customer_payment,in,Counterparty_75,27041257.37,,
2025-06-20,6393.19,asset_sale,in,Counterparty_33,27047650.56,,
2025-06-20,109.72,loan_repayment,out,Counterparty_54,27047540.84,2025-05-12,2025-06-12
2025-06-20,2742.11,software_subscription,out,Counterparty_62,27044798.73,2025-05-31,2025-07-08
2025-06-20,10059.28,customer_payment,in,Counterparty_63,27054858.01,,
2025-06-20,5087.73,investment_income,in,Counterparty_62,27059945.74,,
2025-06-20,676.71,refund,in,Counterparty_93,27060622.45,,
2025-06-20,1791.68,software_subscription,out,Counterparty_18,27058830.77,2025-05-27,2025-06-24
2025-06-20,652.08,customer_payment,in,Counterparty_14,27059482.85,,
2025-06-20,3046.07,supplier_payment,out,Counterparty_4,27056436.78,2025-05-26,2025-06-21
2025-06-20,2286.8,supplier_payment,out,Counterparty_58,27054149.98,2025-05-13,2025-06-12
2025-06-20,2703.48,customer_payment,in,Counterparty_19,27056853.46,,
2025-06-20,128.99,marketing_spend,out,Counterparty_71,27056724.47,2025-06-04,2025-07-08
2025-06-20,4384.06,software_subscription,out,Counterparty_18,27052340.41,2025-05-15,2025-06-19
2025-06-20,3695.35,customer_payment,in,Counterparty_84,27056035.76,,
2025-06-20,2136.38,credit,in,Counterparty_58,27058172.14,,
2025-06-20,1425.21,software_subscription,out,Counterparty_65,27056746.93,2025-06-02,2025-07-06
2025-06-20,774.55,loan_repayment,out,Counterparty_56,27055972.38,2025-05-27,2025-06-26
2025-06-20,1952.83,tax_payment,out,Counterparty_96,27054019.55,2025-06-01,2025-06-28
2025-06-20,10785.25,credit,in,Counterparty_22,27064804.8,,
2025-06-20,1292.51,marketing_spend,out,Counterparty_56,27063512.29,2025-06-05,2025-07-06
2025-06-20,1865.8,utilities,out,Counterparty_4,27061646.49,2025-05-25,2025-07-01
2025-06-20,2865.98,marketing_spend,out,Counterparty_1,27058780.51,2025-05-31,2025-07-02
2025-06-20,376.03,rent,out,Counterparty_30,27058404.48,2025-05-07,2025-06-05
2025-06-20,4106.87,investment_income,in,Counterparty_68,27062511.35,,
2025-06-20,3427.7,loan_repayment,out,Counterparty_43,27059083.65,2025-05-13,2025-06-15
2025-06-20,797.1,T&E,out,Counterparty_12,27058286.55,2025-05-30,2025-06-25
2025-06-20,7023.9,T&E,out,Counterparty_21,27051262.65,2025-05-08,2025-06-10
2025-06-20,3524.73,marketing_spend,out,Counterparty_12,27047737.92,2025-06-01,2025-07-04
2025-06-20,5845.8,payroll,out,Counterparty_93,27041892.12,2025-05-25,2025-07-01
2025-06-20,12050.92,customer_payment,in,Counterparty_87,27053943.04,,
2025-06-20,4343.14,supplier_payment,out,Counterparty_84,27049599.9,2025-05-07,2025-06-03
2025-06-20,752.98,credit,in,Counterparty_39,27050352.88,,
2025-06-20,267.23,marketing_spend,out,Counterparty_9,27050085.65,2025-05-18,2025-06-26
2025-06-20,4463.9,credit,in,Counterparty_9,27054549.55,,
2025-06-20,4323.83,software_subscription,out,Counterparty_96,27050225.72,2025-05-30,2025-06-27
2025-06-20,949.53,tax_payment,out,Counterparty_3,27049276.19,2025-06-01,2025-07-05
2025-06-20,8831.85,loan_repayment,out,Counterparty_7,27040444.34,2025-05-23,2025-06-29
2025-06-20,1438.67,marketing_spend,out,Counterparty_38,27039005.67,2025-05-13,2025-06-08
2025-06-20,4048.02,supplier_payment,out,Counterparty_23,27034957.65,2025-05-22,2025-06-16
2025-06-20,963.28,rent,out,Counterparty_99,27033994.37,2025-06-04,2025-07-07
2025-06-20,1787.07,T&E,out,Counterparty_95,27032207.3,2025-05-27,2025-06-28
2025-06-20,2417.71,refund,in,Counterparty_33,27034625.01,,
2025-06-20,734.75,asset_sale,in,Counterparty_32,27035359.76,,
2025-06-20,13710.34,investment_income,in,Counterparty_12,27049070.1,,
2025-06-20,2558.53,T&E,out,Counterparty_4,27046511.57,2025-05-18,2025-06-13
2025-06-20,4168.67,credit,in,Counterparty_85,27050680.24,,
2025-06-20,6306.92,investment_income,in,Counterparty_42,27056987.16,,
2025-06-20,611.14,tax_payment,out,Counterparty_82,27056376.02,2025-05-19,2025-06-24
2025-06-20,3263.43,loan_repayment,out,Counterparty_78,27053112.59,2025-05-11,2025-06-08
2025-06-20,6251.74,credit,in,Counterparty_67,27059364.33,,
2025-06-20,4099.16,customer_payment,in,Counterparty_49,27063463.49,,
2025-06-20,4070.52,rent,out,Counterparty_25,27059392.97,2025-05-09,2025-06-17
2025-06-20,9223.84,marketing_spend,out,Counterparty_40,27050169.13,2025-06-05,2025-07-12
2025-06-20,1443.43,refund,in,Counterparty_19,27051612.56,,
2025-06-20,661.89,supplier_payment,out,Counterparty_5,27050950.67,2025-05-18,2025-06-16
2025-06-20,62.42,T&E,out,Counterparty_2,27050888.25,2025-05-08,2025-06-13
2025-06-20,613.88,marketing_spend,out,Counterparty_89,27050274.37,2025-05-19,2025-06-25
2025-06-20,7255.48,customer_payment,in,Counterparty_68,27057529.85,,
2025-06-20,1674.24,payroll,out,Counterparty_56,27055855.61,2025-05-22,2025-06-18
2025-06-20,1442.77,rent,out,Counterparty_48,27054412.84,2025-05-09,2025-06-17
2025-06-20,4043.44,refund,in,Counterparty_27,27058456.28,,
2025-06-20,14426.12,credit,in,Counterparty_49,27072882.4,,
2025-06-20,7658.49,utilities,out,Counterparty_85,27065223.91,2025-05-25,2025-06-19
2025-06-21,11665.94,loan_repayment,out,Counterparty_74,27053557.97,2025-05-12,2025-06-10
2025-06-21,3431.22,rent,out,Counterparty_38,27050126.75,2025-05-09,2025-06-09
2025-06-21,3566.25,utilities,out,Counterparty_26,27046560.5,2025-06-04,2025-07-13
2025-06-21,1514.58,marketing_spend,out,Counterparty_7,27045045.92,2025-05-18,2025-06-21
2025-06-21,3779.3,loan_repayment,out,Counterparty_73,27041266.62,2025-06-06,2025-07-12
2025-06-21,1125.41,software_subscription,out,Counterparty_74,27040141.21,2025-05-16,2025-06-14
2025-06-21,1589.18,supplier_payment,out,Counterparty_10,27038552.03,2025-05-24,2025-07-01
2025-06-21,1154.52,marketing_spend,out,Counterparty_39,27037397.51,2025-05-19,2025-06-26
2025-06-21,3370.56,marketing_spend,out,Counterparty_16,27034026.95,2025-05-27,2025-06-27
2025-06-21,2175.01,tax_payment,out,Counterparty_51,27031851.94,2025-05-09,2025-06-16
2025-06-21,2737.92,tax_payment,out,Counterparty_67,27029114.02,2025-05-25,2025-06-27
2025-06-21,843.28,marketing_spend,out,Counterparty_32,27028270.74,2025-05-31,2025-07-08
2025-06-21,12193.3,marketing_spend,out,Counterparty_68,27016077.44,2025-05-12,2025-06-07
2025-06-21,1498.66,tax_payment,out,Counterparty_20,27014578.78,2025-05-14,2025-06-15
2025-06-21,1214.73,payroll,out,Counterparty_80,27013364.05,2025-05-24,2025-06-19
2025-06-21,1081.8,software_subscription,out,Counterparty_11,27012282.25,2025-06-06,2025-07-05
2025-06-21,1337.71,marketing_spend,out,Counterparty_21,27010944.54,2025-05-30,2025-07-07
2025-06-21,693.24,supplier_payment,out,Counterparty_84,27010251.3,2025-05-29,2025-07-07
2025-06-21,12016.29,customer_payment,in,Counterparty_10,27022267.59,,
2025-06-21,5794.37,investment_income,in,Counterparty_83,27028061.96,,
2025-06-21,3049.46,payroll,out,Counterparty_2,27025012.5,2025-05-22,2025-06-20
2025-06-21,840.13,refund,in,Counterparty_65,27025852.63,,
2025-06-21,7198.8,investment_income,in,Counterparty_92,27033051.43,,
2025-06-21,3494.81,credit,in,Counterparty_57,27036546.24,,
2025-06-21,1925.36,marketing_spend,out,Counterparty_48,27034620.88,2025-05-21,2025-06-16
2025-06-21,2480.0,utilities,out,Counterparty_20,27032140.88,2025-06-01,2025-06-30
2025-06-21,1135.83,credit,in,Counterparty_1,27033276.71,,
2025-06-21,333.12,software_subscription,out,Counterparty_78,27032943.59,2025-05-23,2025-06-28
2025-06-21,7536.56,supplier_payment,out,Counterparty_82,27025407.03,2025-05-25,2025-06-28
2025-06-21,3629.38,credit,in,Counterparty_16,27029036.41,,
2025-06-21,62.27,credit,in,Counterparty_59,27029098.68,,
2025-06-21,4444.19,software_subscription,out,Counterparty_57,27024654.49,2025-05-29,2025-06-25
2025-06-21,539.48,credit,in,Counterparty_54,27025193.97,,
2025-06-21,84.53,utilities,out,Counterparty_25,27025109.44,2025-06-01,2025-06-26
2025-06-21,1540.75,asset_sale,in,Counterparty_56,27026650.19,,
2025-06-21,1828.19,investment_income,in,Counterparty_8,27028478.38,,
2025-06-21,1519.48,credit,in,Counterparty_59,27029997.86,,
2025-06-21,20411.57,refund,in,Counterparty_48,27050409.43,,
2025-06-21,2738.97,software_subscription,out,Counterparty_38,27047670.46,2025-05-16,2025-06-22
2025-06-21,5264.16,tax_payment,out,Counterparty_11,27042406.3,2025-06-05,2025-07-13
2025-06-21,1891.1,asset_sale,in,Counterparty_48,27044297.4,,
2025-06-21,9649.75,credit,in,Counterparty_50,27053947.15,,
2025-06-21,9189.33,customer_payment,in,Counterparty_61,27063136.48,,
2025-06-21,3180.03,customer_payment,in,Counterparty_8,27066316.51,,
2025-06-21,5445.43,investment_income,in,Counterparty_91,27071761.94,,
2025-06-21,114.55,tax_payment,out,Counterparty_89,27071647.39,2025-05-28,2025-06-30
2025-06-21,935.33,loan_repayment,out,Counterparty_53,27070712.06,2025-05-25,2025-06-27
2025-06-21,3026.0,asset_sale,in,Counterparty_76,27073738.06,,
2025-06-21,2793.14,asset_sale,in,Counterparty_16,27076531.2,,
2025-06-21,81.71,supplier_payment,out,Counterparty_69,27076449.49,2025-05-12,2025-06-16
2025-06-21,3460.3,customer_payment,in,Counterparty_64,27079909.79,,
2025-06-21,6584.81,marketing_spend,out,Counterparty_61,27073324.98,2025-05-24,2025-07-01
2025-06-21,2275.03,asset_sale,in,Counterparty_95,27075600.01,,
2025-06-21,959.65,software_subscription,out,Counterparty_80,27074640.36,2025-05-29,2025-07-01
2025-06-21,1062.12,payroll,out,Counterparty_97,27073578.24,2025-05-21,2025-06-20
2025-06-21,217.06,utilities,out,Counterparty_58,27073361.18,2025-06-01,2025-06-27
2025-06-21,3361.49,rent,out,Counterparty_6,27069999.69,2025-06-06,2025-07-12
2025-06-21,2968.85,investment_income,in,Counterparty_19,27072968.54,,
2025-06-21,534.09,payroll,out,Counterparty_19,27072434.45,2025-05-24,2025-07-01
2025-06-21,501.61,investment_income,in,Counterparty_58,27072936.06,,
2025-06-21,91.96,tax_payment,out,Counterparty_53,27072844.1,2025-05-17,2025-06-19
2025-06-21,4565.35,payroll,out,Counterparty_18,27068278.75,2025-05-18,2025-06-19
2025-06-21,449.84,asset_sale,in,Counterparty_28,27068728.59,,
2025-06-21,1735.57,asset_sale,in,Counterparty_36,27070464.16,,
2025-06-21,1186.83,utilities,out,Counterparty_81,27069277.33,2025-05-19,2025-06-27
2025-06-22,5805.61,rent,out,Counterparty_71,27063471.72,2025-05-11,2025-06-07
2025-06-22,1981.73,asset_sale,in,Counterparty_40,27065453.45,,
2025-06-22,16470.18,customer_payment,in,Counterparty_12,27081923.63,,
2025-06-22,718.26,tax_payment,out,Counterparty_26,27081205.37,2025-05-21,2025-06-22
2025-06-22,341.46,tax_payment,out,Counterparty_54,27080863.91,2025-05-19,2025-06-19
2025-06-22,2546.08,rent,out,Counterparty_64,27078317.83,2025-05-13,2025-06-08
2025-06-22,104.15,marketing_spend,out,Counterparty_38,27078213.68,2025-05-28,2025-06-22
2025-06-22,2808.65,rent,out,Counterparty_85,27075405.03,2025-05-12,2025-06-12
2025-06-22,529.25,tax_payment,out,Counterparty_80,27074875.78,2025-06-07,2025-07-09
2025-06-22,3852.63,marketing_spend,out,Counterparty_67,27071023.15,2025-05-10,2025-06-08
2025-06-22,994.17,software_subscription,out,Counterparty_67,27070028.98,2025-05-26,2025-07-02
2025-06-22,2802.36,refund,in,Counterparty_68,27072831.34,,
2025-06-22,3119.02,payroll,out,Counterparty_17,27069712.32,2025-05-15,2025-06-18
2025-06-22,1596.3,utilities,out,Counterparty_27,27068116.02,2025-05-23,2025-06-26
2025-06-22,2754.83,utilities,out,Counterparty_25,27065361.19,2025-05-27,2025-06-25
2025-06-22,3272.83,loan_repayment,out,Counterparty_32,27062088.36,2025-05-11,2025-06-10
2025-06-22,1441.0,tax_payment,out,Counterparty_53,27060647.36,2025-06-05,2025-07-13
2025-06-22,1363.91,rent,out,Counterparty_68,27059283.45,2025-06-02,2025-06-28
2025-06-22,6078.89,tax_payment,out,Counterparty_51,27053204.56,2025-06-01,2025-07-09
2025-06-22,2215.99,credit,in,Counterparty_63,27055420.55,,
2025-06-22,2488.31,payroll,out,Counterparty_47,27052932.24,2025-06-01,2025-06-29
2025-06-22,5852.18,investment_income,in,Counterparty_83,27058784.42,,
2025-06-22,508.82,utilities,out,Counterparty_65,27058275.6,2025-06-07,2025-07-11
2025-06-22,8191.33,investment_income,in,Counterparty_66,27066466.93,,
2025-06-22,5415.46,refund,in,Counterparty_80,27071882.39,,
2025-06-22,12249.86,refund,in,Counterparty_58,27084132.25,,
2025-06-22,5720.37,software_subscription,out,Counterparty_90,27078411.88,2025-05-25,2025-06-29
2025-06-22,453.28,rent,out,Counterparty_4,27077958.6,2025-06-02,2025-07-03
2025-06-22,3846.98,software_subscription,out,Counterparty_81,27074111.62,2025-05-23,2025-06-29
2025-06-22,235.38,marketing_spend,out,Counterparty_70,27073876.24,2025-06-02,2025-06-29
2025-06-22,108.44,software_subscription,out,Counterparty_58,27073767.8,2025-05-24,2025-06-21
2025-06-22,1719.89,refund,in,Counterparty_86,27075487.69,,
2025-06-22,3530.61,asset_sale,in,Counterparty_74,27079018.3,,
2025-06-22,2420.56,loan_repayment,out,Counterparty_31,27076597.74,2025-05-20,2025-06-27
2025-06-22,1519.11,credit,in,Counterparty_47,27078116.85,,
2025-06-22,1125.22,asset_sale,in,Counterparty_82,27079242.07,,
2025-06-22,5474.28,credit,in,Counterparty_67,27084716.35,,
2025-06-22,29923.35,asset_sale,in,Counterparty_31,27114639.7,,
2025-06-22,153.36,loan_repayment,out,Counterparty_35,27114486.34,2025-06-05,2025-07-05
2025-06-22,2103.19,payroll,out,Counterparty_76,27112383.15,2025-05-25,2025-07-01
2025-06-22,1624.91,credit,in,Counterparty_86,27114008.06,,
2025-06-22,2495.66,supplier_payment,out,Counterparty_46,27111512.4,2025-05-09,2025-06-08
2025-06-22,8093.16,investment_income,in,Counterparty_37,27119605.56,,
2025-06-22,18264.81,credit,in,Counterparty_25,27137870.37,,
2025-06-22,1858.75,investment_income,in,Counterparty_29,27139729.12,,
2025-06-22,11650.5,customer_payment,in,Counterparty_16,27151379.62,,
2025-06-22,792.34,supplier_payment,out,Counterparty_12,27150587.28,2025-05-24,2025-06-25
2025-06-22,2773.42,supplier_payment,out,Counterparty_73,27147813.86,2025-06-07,2025-07-04
2025-06-22,9274.31,credit,in,Counterparty_64,27157088.17,,
2025-06-22,10547.13,refund,in,Counterparty_91,27167635.3,,
2025-06-22,2066.86,T&E,out,Counterparty_55,27165568.44,2025-05-13,2025-06-07
2025-06-22,3537.48,rent,out,Counterparty_2,27162030.96,2025-05-24,2025-06-30
2025-06-22,10004.79,refund,in,Counterparty_63,27172035.75,,
2025-06-22,8654.29,customer_payment,in,Counterparty_44,27180690.04,,
2025-06-22,2587.08,asset_sale,in,Counterparty_69,27183277.12,,
2025-06-22,13345.16,customer_payment,in,Counterparty_42,27196622.28,,
2025-06-22,1955.39,investment_income,in,Counterparty_97,27198577.67,,
2025-06-22,13561.54,customer_payment,in,Counterparty_59,27212139.21,,
2025-06-22,567.91,investment_income,in,Counterparty_13,27212707.12,,
2025-06-22,2240.52,investment_income,in,Counterparty_31,27214947.64,,
2025-06-22,668.64,utilities,out,Counterparty_26,27214279.0,2025-06-02,2025-06-29
2025-06-23,2003.14,customer_payment,in,Counterparty_22,27216282.14,,
2025-06-23,95.45,rent,out,Counterparty_18,27216186.69,2025-05-14,2025-06-19
2025-06-23,1967.94,utilities,out,Counterparty_9,27214218.75,2025-06-04,2025-07-10
2025-06-23,2560.41,asset_sale,in,Counterparty_86,27216779.16,,
2025-06-23,2227.09,marketing_spend,out,Counterparty_75,27214552.07,2025-06-07,2025-07-14
2025-06-23,1271.51,payroll,out,Counterparty_77,27213280.56,2025-05-30,2025-06-30
2025-06-23,9836.12,software_subscription,out,Counterparty_24,27203444.44,2025-05-14,2025-06-16
2025-06-23,6029.84,customer_payment,in,Counterparty_20,27209474.28,,
2025-06-23,3540.17,rent,out,Counterparty_2,27205934.11,2025-05-10,2025-06-08
2025-06-23,3561.67,credit,in,Counterparty_32,27209495.78,,
2025-06-23,2151.15,credit,in,Counterparty_24,27211646.93,,
2025-06-23,2463.58,software_subscription,out,Counterparty_58,27209183.35,2025-05-29,2025-07-06
2025-06-23,5805.63,credit,in,Counterparty_56,27214988.98,,
2025-06-23,816.44,marketing_spend,out,Counterparty_78,27214172.54,2025-05-30,2025-06-29
2025-06-23,5461.48,supplier_payment,out,Counterparty_7,27208711.06,2025-05-29,2025-06-29
2025-06-23,5057.02,investment_income,in,Counterparty_54,27213768.08,,
2025-06-23,23871.73,customer_payment,in,Counterparty_61,27237639.81,,
2025-06-23,18422.59,investment_income,in,Counterparty_54,27256062.4,,
2025-06-23,904.49,asset_sale,in,Counterparty_7,27256966.89,,
2025-06-23,2704.09,tax_payment,out,Counterparty_57,27254262.8,2025-05-11,2025-06-09
2025-06-23,351.05,software_subscription,out,Counterparty_54,27253911.75,2025-05-24,2025-06-18
2025-06-23,6702.24,payroll,out,Counterparty_75,27247209.51,2025-06-03,2025-07-08
2025-06-23,1017.15,asset_sale,in,Counterparty_25,27248226.66,,
2025-06-23,6174.22,refund,in,Counterparty_1,27254400.88,,
2025-06-23,3911.78,utilities,out,Counterparty_22,27250489.1,2025-05-21,2025-06-22
2025-06-23,445.27,tax_payment,out,Counterparty_37,27250043.83,2025-06-06,2025-07-03
2025-06-23,924.75,asset_sale,in,Counterparty_42,27250968.58,,
2025-06-23,857.87,customer_payment,in,Counterparty_52,27251826.45,,
2025-06-23,6597.22,credit,in,Counterparty_8,27258423.67,,
2025-06-23,16506.55,refund,in,Counterparty_40,27274930.22,,
2025-06-23,3920.28,credit,in,Counterparty_32,27278850.5,,
2025-06-23,2538.44,tax_payment,out,Counterparty_31,27276312.06,2025-05-30,2025-07-05
2025-06-23,3198.53,marketing_spend,out,Counterparty_79,27273113.53,2025-05-22,2025-06-24
2025-06-23,3425.66,marketing_spend,out,Counterparty_40,27269687.87,2025-06-05,2025-07-10
2025-06-23,1825.67,tax_payment,out,Counterparty_3,27267862.2,2025-05-11,2025-06-15
2025-06-23,7145.7,supplier_payment,out,Counterparty_42,27260716.5,2025-05-24,2025-06-20
2025-06-23,304.25,loan_repayment,out,Counterparty_21,27260412.25,2025-05-14,2025-06-10
2025-06-23,6040.88,T&E,out,Counterparty_63,27254371.37,2025-05-29,2025-07-06
2025-06-23,10538.16,supplier_payment,out,Counterparty_29,27243833.21,2025-05-20,2025-06-19
2025-06-23,2493.04,software_subscription,out,Counterparty_66,27241340.17,2025-05-30,2025-07-02
2025-06-23,728.66,utilities,out,Counterparty_37,27240611.51,2025-06-05,2025-06-30
2025-06-23,5518.1,tax_payment,out,Counterparty_93,27235093.41,2025-06-03,2025-07-02
2025-06-23,2940.65,tax_payment,out,Counterparty_53,27232152.76,2025-05-30,2025-06-29
2025-06-23,5431.44,tax_payment,out,Counterparty_11,27226721.32,2025-05-12,2025-06-20
2025-06-23,1592.5,utilities,out,Counterparty_61,27225128.82,2025-05-24,2025-07-02
2025-06-23,5179.19,payroll,out,Counterparty_37,27219949.63,2025-05-25,2025-06-26
2025-06-23,1910.06,utilities,out,Counterparty_41,27218039.57,2025-05-29,2025-06-27
2025-06-23,3324.75,loan_repayment,out,Counterparty_95,27214714.82,2025-05-31,2025-06-28
2025-06-23,1747.59,tax_payment,out,Counterparty_79,27212967.23,2025-05-20,2025-06-18
2025-06-24,705.33,customer_payment,in,Counterparty_92,27213672.56,,
2025-06-24,3471.6,tax_payment,out,Counterparty_8,27210200.96,2025-05-31,2025-07-03
2025-06-24,1361.34,software_subscription,out,Counterparty_71,27208839.62,2025-05-15,2025-06-12
2025-06-24,12905.03,credit,in,Counterparty_60,27221744.65,,
2025-06-24,1727.42,supplier_payment,out,Counterparty_59,27220017.23,2025-05-30,2025-06-30
2025-06-24,275.49,utilities,out,Counterparty_1,27219741.74,2025-05-18,2025-06-14
2025-06-24,465.54,software_subscription,out,Counterparty_65,27219276.2,2025-05-27,2025-06-26
2025-06-24,3185.86,software_subscription,out,Counterparty_65,27216090.34,2025-05-16,2025-06-21
2025-06-24,9182.08,marketing_spend,out,Counterparty_40,27206908.26,2025-05-15,2025-06-14
2025-06-24,300.2,utilities,out,Counterparty_5,27206608.06,2025-05-22,2025-06-30
2025-06-24,2405.23,payroll,out,Counterparty_1,27204202.83,2025-05-19,2025-06-18
2025-06-24,15502.36,investment_income,in,Counterparty_41,27219705.19,,
2025-06-24,2626.49,supplier_payment,out,Counterparty_50,27217078.7,2025-06-08,2025-07-16
2025-06-24,1229.65,T&E,out,Counterparty_38,27215849.05,2025-06-05,2025-07-01
2025-06-24,11601.04,refund,in,Counterparty_60,27227450.09,,
2025-06-24,265.26,tax_payment,out,Counterparty_80,27227184.83,2025-06-08,2025-07-05
2025-06-24,1188.96,software_subscription,out,Counterparty_73,27225995.87,2025-05-12,2025-06-06
2025-06-24,7744.99,investment_income,in,Counterparty_35,27233740.86,,
2025-06-24,847.76,loan_repayment,out,Counterparty_97,27232893.1,2025-05-11,2025-06-11
2025-06-24,6902.24,supplier_payment,out,Counterparty_12,27225990.86,2025-06-04,2025-07-03
2025-06-24,397.48,payroll,out,Counterparty_83,27225593.38,2025-05-31,2025-07-05
2025-06-24,1383.32,rent,out,Counterparty_1,27224210.06,2025-05-29,2025-07-04
2025-06-24,499.9,tax_payment,out,Counterparty_66,27223710.16,2025-05-31,2025-07-05
2025-06-24,4477.36,software_subscription,out,Counterparty_29,27219232.8,2025-05-25,2025-06-28
2025-06-24,2618.74,marketing_spend,out,Counterparty_84,27216614.06,2025-06-02,2025-06-28
2025-06-24,763.7,supplier_payment,out,Counterparty_63,27215850.36,2025-05-29,2025-07-01
2025-06-24,26005.37,refund,in,Counterparty_69,27241855.73,,
2025-06-24,9973.12,T&E,out,Counterparty_58,27231882.61,2025-05-18,2025-06-15
2025-06-24,1907.0,credit,in,Counterparty_27,27233789.61,,
2025-06-24,1656.63,software_subscription,out,Counterparty_78,27232132.98,2025-06-06,2025-07-14
2025-06-24,909.02,loan_repayment,out,Counterparty_20,27231223.96,2025-06-04,2025-07-02
2025-06-24,912.77,customer_payment,in,Counterparty_50,27232136.73,,
2025-06-24,2159.3,payroll,out,Counterparty_1,27229977.43,2025-06-09,2025-07-04
2025-06-24,600.69,loan_repayment,out,Counterparty_3,27229376.74,2025-05-24,2025-06-24
2025-06-24,3859.41,software_subscription,out,Counterparty_76,27225517.33,2025-06-09,2025-07-18
2025-06-24,8719.11,asset_sale,in,Counterparty_82,27234236.44,,
2025-06-24,1743.88,supplier_payment,out,Counterparty_8,27232492.56,2025-05-23,2025-06-18
2025-06-24,151.71,software_subscription,out,Counterparty_42,27232340.85,2025-05-17,2025-06-16
2025-06-24,3907.37,marketing_spend,out,Counterparty_38,27228433.48,2025-06-04,2025-07-02
2025-06-24,222.72,supplier_payment,out,Counterparty_18,27228210.76,2025-06-06,2025-07-02
2025-06-24,2528.62,supplier_payment,out,Counterparty_51,27225682.14,2025-05-24,2025-06-22
2025-06-24,4393.05,T&E,out,Counterparty_43,27221289.09,2025-06-08,2025-07-10
2025-06-24,585.11,marketing_spend,out,Counterparty_51,27220703.98,2025-06-09,2025-07-10
2025-06-24,1339.97,marketing_spend,out,Counterparty_17,27219364.01,2025-06-02,2025-07-01
2025-06-24,3380.53,investment_income,in,Counterparty_36,27222744.54,,
2025-06-24,11694.7,rent,out,Counterparty_35,27211049.84,2025-06-09,2025-07-15
2025-06-24,3577.27,marketing_spend,out,Counterparty_76,27207472.57,2025-05-27,2025-07-03
2025-06-24,2842.57,refund,in,Counterparty_92,27210315.14,,
2025-06-24,11611.18,refund,in,Counterparty_30,27221926.32,,
2025-06-24,2194.01,tax_payment,out,Counterparty_27,27219732.31,2025-05-21,2025-06-21
2025-06-24,3774.04,credit,in,Counterparty_55,27223506.35,,
2025-06-24,1537.35,tax_payment,out,Counterparty_19,27221969.0,2025-05-30,2025-06-24
2025-06-24,14295.16,payroll,out,Counterparty_5,27207673.84,2025-06-08,2025-07-14
2025-06-24,4718.71,credit,in,Counterparty_35,27212392.55,,
2025-06-24,1650.63,tax_payment,out,Counterparty_73,27210741.92,2025-05-22,2025-06-20
2025-06-24,18361.22,credit,in,Counterparty_83,27229103.14,,
2025-06-24,1323.68,loan_repayment,out,Counterparty_40,27227779.46,2025-05-17,2025-06-25
2025-06-24,1509.62,supplier_payment,out,Counterparty_56,27226269.84,2025-05-11,2025-06-15
2025-06-24,667.4,software_subscription,out,Counterparty_62,27225602.44,2025-05-29,2025-06-30
2025-06-24,4427.07,refund,in,Counterparty_4,27230029.51,,
2025-06-24,846.15,customer_payment,in,Counterparty_4,27230875.66,,
2025-06-24,2649.28,refund,in,Counterparty_97,27233524.94,,
2025-06-24,750.1,T&E,out,Counterparty_43,27232774.84,2025-05-16,2025-06-24
2025-06-24,1431.79,marketing_spend,out,Counterparty_89,27231343.05,2025-05-13,2025-06-11
2025-06-25,8762.01,customer_payment,in,Counterparty_31,27240105.06,,
2025-06-25,1266.65,supplier_payment,out,Counterparty_44,27238838.41,2025-06-06,2025-07-08
2025-06-25,16071.08,asset_sale,in,Counterparty_77,27254909.49,,
2025-06-25,12017.12,investment_income,in,Counterparty_27,27266926.61,,
2025-06-25,8787.31,rent,out,Counterparty_72,27258139.3,2025-06-03,2025-07-06
2025-06-25,14564.68,refund,in,Counterparty_91,27272703.98,,
2025-06-25,3611.71,customer_payment,in,Counterparty_47,27276315.69,,
2025-06-25,11.15,utilities,out,Counterparty_28,27276304.54,2025-05-14,2025-06-22
2025-06-25,2663.84,credit,in,Counterparty_52,27278968.38,,
2025-06-25,33263.48,refund,in,Counterparty_58,27312231.86,,
2025-06-25,2107.31,credit,in,Counterparty_79,27314339.17,,
2025-06-25,3806.77,payroll,out,Counterparty_74,27310532.4,2025-05-12,2025-06-11
2025-06-25,2908.3,credit,in,Counterparty_10,27313440.7,,
2025-06-25,843.14,utilities,out,Counterparty_21,27312597.56,2025-05-28,2025-06-28
2025-06-25,1628.29,credit,in,Counterparty_89,27314225.85,,
2025-06-25,3320.8,credit,in,Counterparty_63,27317546.65,,
2025-06-25,1628.09,investment_income,in,Counterparty_96,27319174.74,,
2025-06-25,10378.61,credit,in,Counterparty_8,27329553.35,,
2025-06-25,8343.69,refund,in,Counterparty_23,27337897.04,,
2025-06-25,6842.92,T&E,out,Counterparty_91,27331054.12,2025-05-15,2025-06-22
2025-06-25,1650.61,loan_repayment,out,Counterparty_92,27329403.51,2025-05-28,2025-07-01
2025-06-25,687.77,T&E,out,Counterparty_22,27328715.74,2025-05-19,2025-06-17
2025-06-25,14698.12,refund,in,Counterparty_62,27343413.86,,
2025-06-25,305.4,credit,in,Counterparty_45,27343719.26,,
2025-06-25,523.5,asset_sale,in,Counterparty_41,27344242.76,,
2025-06-25,2608.18,tax_payment,out,Counterparty_92,27341634.58,2025-05-22,2025-06-21
2025-06-25,1672.76,credit,in,Counterparty_31,27343307.34,,
2025-06-25,6186.97,utilities,out,Counterparty_46,27337120.37,2025-05-13,2025-06-10
2025-06-25,3248.35,payroll,out,Counterparty_51,27333872.02,2025-06-05,2025-07-08
2025-06-25,15.5,T&E,out,Counterparty_72,27333856.52,2025-06-01,2025-07-07
2025-06-25,6356.57,investment_income,in,Counterparty_16,27340213.09,,
2025-06-25,5993.31,refund,in,Counterparty_2,27346206.4,,
2025-06-25,3727.15,payroll,out,Counterparty_67,27342479.25,2025-05-14,2025-06-20
2025-06-25,123.0,T&E,out,Counterparty_69,27342356.25,2025-05-31,2025-07-01
2025-06-25,2035.28,customer_payment,in,Counterparty_64,27344391.53,,
2025-06-25,33.96,utilities,out,Counterparty_19,27344357.57,2025-06-09,2025-07-11
2025-06-25,830.7,supplier_payment,out,Counterparty_44,27343526.87,2025-05-31,2025-06-25
2025-06-25,5534.45,T&E,out,Counterparty_47,27337992.42,2025-05-27,2025-06-28
2025-06-25,652.56,utilities,out,Counterparty_48,27337339.86,2025-05-18,2025-06-12
2025-06-25,1941.21,loan_repayment,out,Counterparty_67,27335398.65,2025-05-21,2025-06-16
2025-06-25,2544.52,utilities,out,Counterparty_76,27332854.13,2025-06-09,2025-07-11
2025-06-25,702.47,tax_payment,out,Counterparty_73,27332151.66,2025-05-26,2025-06-22
2025-06-25,1765.56,utilities,out,Counterparty_74,27330386.1,2025-05-23,2025-06-23
2025-06-25,238.24,rent,out,Counterparty_28,27330147.86,2025-05-24,2025-07-02
2025-06-25,12844.92,asset_sale,in,Counterparty_30,27342992.78,,
2025-06-25,13952.54,refund,in,Counterparty_23,27356945.32,,
2025-06-25,1052.42,rent,out,Counterparty_74,27355892.9,2025-06-09,2025-07-06
2025-06-25,493.61,supplier_payment,out,Counterparty_38,27355399.29,2025-05-26,2025-06-25
2025-06-25,3259.4,investment_income,in,Counterparty_89,27358658.69,,
2025-06-25,240.61,payroll,out,Counterparty_18,27358418.08,2025-06-09,2025-07-05
2025-06-25,1133.5,asset_sale,in,Counterparty_47,27359551.58,,
2025-06-25,18167.58,asset_sale,in,Counterparty_12,27377719.16,,
2025-06-25,8999.45,T&E,out,Counterparty_82,27368719.71,2025-05-20,2025-06-25
2025-06-25,1872.13,rent,out,Counterparty_63,27366847.58,2025-06-01,2025-07-09
2025-06-25,1359.52,T&E,out,Counterparty_79,27365488.06,2025-05-15,2025-06-18
2025-06-25,6356.03,refund,in,Counterparty_61,27371844.09,,
2025-06-25,2691.91,utilities,out,Counterparty_29,27369152.18,2025-06-04,2025-07-07
2025-06-25,1412.92,software_subscription,out,Counterparty_40,27367739.26,2025-06-07,2025-07-13
2025-06-25,10246.33,payroll,out,Counterparty_56,27357492.93,2025-05-23,2025-06-25
2025-06-25,628.25,tax_payment,out,Counterparty_11,27356864.68,2025-05-30,2025-06-28
2025-06-25,3091.47,rent,out,Counterparty_25,27353773.21,2025-05-23,2025-06-29
2025-06-25,3266.45,rent,out,Counterparty_10,27350506.76,2025-05-30,2025-07-02
2025-06-26,2259.53,rent,out,Counterparty_21,27348247.23,2025-05-16,2025-06-24
2025-06-26,3374.09,payroll,out,Counterparty_94,27344873.14,2025-05-17,2025-06-19
2025-06-26,1879.09,asset_sale,in,Counterparty_54,27346752.23,,
2025-06-26,168.73,marketing_spend,out,Counterparty_12,27346583.5,2025-05-18,2025-06-21
2025-06-26,3316.34,supplier_payment,out,Counterparty_5,27343267.16,2025-06-07,2025-07-05
2025-06-26,12478.1,customer_payment,in,Counterparty_32,27355745.26,,
2025-06-26,1510.03,customer_payment,in,Counterparty_61,27357255.29,,
2025-06-26,9937.65,refund,in,Counterparty_20,27367192.94,,
2025-06-26,2308.27,customer_payment,in,Counterparty_91,27369501.21,,
2025-06-26,460.3,tax_payment,out,Counterparty_91,27369040.91,2025-05-21,2025-06-17
2025-06-26,5129.04,asset_sale,in,Counterparty_59,27374169.95,,
2025-06-26,8639.89,marketing_spend,out,Counterparty_53,27365530.06,2025-05-14,2025-06-21
2025-06-26,4355.2,payroll,out,Counterparty_88,27361174.86,2025-05-21,2025-06-21
2025-06-26,1076.65,asset_sale,in,Counterparty_62,27362251.51,,
2025-06-26,3197.01,utilities,out,Counterparty_10,27359054.5,2025-05-18,2025-06-26
2025-06-26,347.44,tax_payment,out,Counterparty_99,27358707.06,2025-05-21,2025-06-22
2025-06-26,9.42,loan_repayment,out,Counterparty_36,27358697.64,2025-06-05,2025-07-04
2025-06-26,3752.56,marketing_spend,out,Counterparty_72,27354945.08,2025-06-03,2025-07-04
2025-06-26,5536.79,utilities,out,Counterparty_5,27349408.29,2025-06-02,2025-07-08
2025-06-26,1199.8,T&E,out,Counterparty_25,27348208.49,2025-05-25,2025-06-25
2025-06-26,680.45,tax_payment,out,Counterparty_94,27347528.04,2025-06-06,2025-07-08
2025-06-26,1609.55,supplier_payment,out,Counterparty_95,27345918.49,2025-06-03,2025-07-05
2025-06-26,12484.79,customer_payment,in,Counterparty_10,27358403.28,,
2025-06-26,1026.0,supplier_payment,out,Counterparty_16,27357377.28,2025-05-22,2025-06-20
2025-06-26,3700.57,marketing_spend,out,Counterparty_20,27353676.71,2025-06-11,2025-07-08
2025-06-26,2545.24,payroll,out,Counterparty_91,27351131.47,2025-05-23,2025-06-17
2025-06-26,12817.63,credit,in,Counterparty_23,27363949.1,,
2025-06-26,294.66,supplier_payment,out,Counterparty_66,27363654.44,2025-05-27,2025-07-02
2025-06-26,3223.91,loan_repayment,out,Counterparty_61,27360430.53,2025-06-08,2025-07-04
2025-06-26,3280.52,supplier_payment,out,Counterparty_23,27357150.01,2025-06-11,2025-07-09
2025-06-26,295.34,marketing_spend,out,Counterparty_56,27356854.67,2025-05-25,2025-06-22
2025-06-26,6802.85,payroll,out,Counterparty_34,27350051.82,2025-06-05,2025-07-01
2025-06-26,82.63,payroll,out,Counterparty_16,27349969.19,2025-05-18,2025-06-16
2025-06-26,215.2,utilities,out,Counterparty_80,27349753.99,2025-05-21,2025-06-24
2025-06-26,2764.39,rent,out,Counterparty_3,27346989.6,2025-06-09,2025-07-07
2025-06-26,822.68,T&E,out,Counterparty_67,27346166.92,2025-05-25,2025-06-19
2025-06-26,2258.77,tax_payment,out,Counterparty_3,27343908.15,2025-05-28,2025-06-25
2025-06-26,3411.23,rent,out,Counterparty_37,27340496.92,2025-06-07,2025-07-02
2025-06-26,2841.58,refund,in,Counterparty_24,27343338.5,,
2025-06-26,473.15,payroll,out,Counterparty_40,27342865.35,2025-06-04,2025-07-10
2025-06-26,6836.22,credit,in,Counterparty_53,27349701.57,,
2025-06-26,10075.09,credit,in,Counterparty_15,27359776.66,,
2025-06-26,2860.98,software_subscription,out,Counterparty_46,27356915.68,2025-05-14,2025-06-19
2025-06-26,4187.08,loan_repayment,out,Counterparty_54,27352728.6,2025-05-16,2025-06-19
2025-06-26,11100.38,customer_payment,in,Counterparty_27,27363828.98,,
2025-06-26,2727.61,tax_payment,out,Counterparty_38,27361101.37,2025-05-20,2025-06-24
2025-06-26,204.66,loan_repayment,out,Counterparty_96,27360896.71,2025-05-26,2025-06-29
2025-06-26,707.54,marketing_spend,out,Counterparty_56,27360189.17,2025-05-20,2025-06-18
2025-06-26,3388.69,payroll,out,Counterparty_81,27356800.48,2025-05-24,2025-06-20
2025-06-26,1207.38,marketing_spend,out,Counterparty_15,27355593.1,2025-06-08,2025-07-14
2025-06-26,671.92,payroll,out,Counterparty_98,27354921.18,2025-06-05,2025-07-02
2025-06-26,43.24,rent,out,Counterparty_70,27354877.94,2025-05-15,2025-06-18
2025-06-26,733.29,loan_repayment,out,Counterparty_45,27354144.65,2025-05-16,2025-06-13
2025-06-26,3682.71,loan_repayment,out,Counterparty_56,27350461.94,2025-05-26,2025-06-26
2025-06-26,2130.34,supplier_payment,out,Counterparty_45,27348331.6,2025-05-31,2025-07-02
2025-06-26,3972.93,T&E,out,Counterparty_7,27344358.67,2025-06-04,2025-07-04
2025-06-26,1583.43,payroll,out,Counterparty_54,27342775.24,2025-05-16,2025-06-22
2025-06-26,913.83,software_subscription,out,Counterparty_48,27341861.41,2025-05-16,2025-06-20
2025-06-26,173.95,payroll,out,Counterparty_7,27341687.46,2025-06-06,2025-07-04
2025-06-26,740.67,customer_payment,in,Counterparty_62,27342428.13,,
2025-06-26,3976.55,software_subscription,out,Counterparty_13,27338451.58,2025-06-07,2025-07-03
2025-06-26,4003.07,software_subscription,out,Counterparty_2,27334448.51,2025-06-06,2025-07-04
2025-06-26,1533.16,loan_repayment,out,Counterparty_88,27332915.35,2025-05-13,2025-06-08
2025-06-26,3364.05,marketing_spend,out,Counterparty_19,27329551.3,2025-05-16,2025-06-15
2025-06-26,2973.66,tax_payment,out,Counterparty_54,27326577.64,2025-05-27,2025-06-26
2025-06-26,1674.8,tax_payment,out,Counterparty_20,27324902.84,2025-05-15,2025-06-09
2025-06-26,796.28,payroll,out,Counterparty_33,27324106.56,2025-05-21,2025-06-25
2025-06-27,2371.22,marketing_spend,out,Counterparty_21,27321735.34,2025-05-31,2025-06-26
2025-06-27,31.83,loan_repayment,out,Counterparty_35,27321703.51,2025-05-19,2025-06-19
2025-06-27,5906.19,loan_repayment,out,Counterparty_24,27315797.32,2025-06-04,2025-07-13
2025-06-27,12047.07,investment_income,in,Counterparty_90,27327844.39,,
2025-06-27,1058.6,marketing_spend,out,Counterparty_24,27326785.79,2025-06-08,2025-07-14
2025-06-27,4474.21,credit,in,Counterparty_91,27331260.0,,
2025-06-27,9496.59,refund,in,Counterparty_23,27340756.59,,
2025-06-27,2279.42,asset_sale,in,Counterparty_20,27343036.01,,
2025-06-27,234.75,utilities,out,Counterparty_45,27342801.26,2025-06-05,2025-07-10
2025-06-27,916.72,loan_repayment,out,Counterparty_87,27341884.54,2025-06-11,2025-07-20
2025-06-27,2606.2,credit,in,Counterparty_1,27344490.74,,
2025-06-27,39313.61,asset_sale,in,Counterparty_44,27383804.35,,
2025-06-27,3485.5,rent,out,Counterparty_46,27380318.85,2025-05-22,2025-06-29
2025-06-27,6465.91,customer_payment,in,Counterparty_93,27386784.76,,
2025-06-27,9769.12,investment_income,in,Counterparty_94,27396553.88,,
2025-06-27,2841.95,T&E,out,Counterparty_46,27393711.93,2025-05-27,2025-06-23
2025-06-27,354.62,payroll,out,Counterparty_24,27393357.31,2025-05-18,2025-06-20
2025-06-27,3477.04,investment_income,in,Counterparty_52,27396834.35,,
2025-06-27,1713.78,utilities,out,Counterparty_68,27395120.57,2025-06-02,2025-07-07
2025-06-27,5446.29,utilities,out,Counterparty_8,27389674.28,2025-06-01,2025-07-08
2025-06-27,34496.06,customer_payment,in,Counterparty_90,27424170.34,,
2025-06-27,2972.22,loan_repayment,out,Counterparty_93,27421198.12,2025-05-30,2025-06-29
2025-06-27,6191.0,asset_sale,in,Counterparty_83,27427389.12,,
2025-06-27,5569.36,asset_sale,in,Counterparty_87,27432958.48,,
2025-06-27,6114.6,asset_sale,in,Counterparty_28,27439073.08,,
2025-06-27,10644.46,credit,in,Counterparty_56,27449717.54,,
2025-06-27,2668.39,utilities,out,Counterparty_36,27447049.15,2025-05-14,2025-06-21
2025-06-27,498.63,investment_income,in,Counterparty_85,27447547.78,,
2025-06-27,3639.03,investment_income,in,Counterparty_38,27451186.81,,
2025-06-27,1812.62,supplier_payment,out,Counterparty_79,27449374.19,2025-05-23,2025-06-27
2025-06-27,8471.91,tax_payment,out,Counterparty_80,27440902.28,2025-05-31,2025-07-03
2025-06-27,506.28,tax_payment,out,Counterparty_67,27440396.0,2025-05-23,2025-06-30
2025-06-27,5980.42,rent,out,Counterparty_19,27434415.58,2025-06-07,2025-07-11
2025-06-27,8310.09,rent,out,Counterparty_24,27426105.49,2025-06-08,2025-07-14
2025-06-27,4398.74,supplier_payment,out,Counterparty_25,27421706.75,2025-06-05,2025-07-10
2025-06-27,37.15,rent,out,Counterparty_59,27421669.6,2025-06-11,2025-07-12
2025-06-27,5505.89,utilities,out,Counterparty_72,27416163.71,2025-05-29,2025-06-29
2025-06-27,3178.44,asset_sale,in,Counterparty_1,27419342.15,,
2025-06-27,2037.86,marketing_spend,out,Counterparty_63,27417304.29,2025-06-05,2025-07-11
2025-06-27,7466.64,tax_payment,out,Counterparty_64,27409837.65,2025-05-28,2025-07-04
2025-06-27,3795.8,investment_income,in,Counterparty_60,27413633.45,,
2025-06-27,1151.43,rent,out,Counterparty_90,27412482.02,2025-05-17,2025-06-15
2025-06-27,749.99,software_subscription,out,Counterparty_93,27411732.03,2025-06-06,2025-07-10
2025-06-27,1187.17,asset_sale,in,Counterparty_85,27412919.2,,
2025-06-27,2058.54,credit,in,Counterparty_81,27414977.74,,
2025-06-27,5208.4,tax_payment,out,Counterparty_91,27409769.34,2025-06-03,2025-06-30
2025-06-27,850.91,supplier_payment,out,Counterparty_11,27408918.43,2025-05-16,2025-06-19
2025-06-27,7057.26,loan_repayment,out,Counterparty_82,27401861.17,2025-06-01,2025-07-01
2025-06-27,2739.79,rent,out,Counterparty_42,27399121.38,2025-06-08,2025-07-09
2025-06-27,1010.73,marketing_spend,out,Counterparty_72,27398110.65,2025-05-22,2025-06-16
2025-06-27,10944.66,payroll,out,Counterparty_92,27387165.99,2025-06-06,2025-07-05
2025-06-27,1400.04,supplier_payment,out,Counterparty_19,27385765.95,2025-06-09,2025-07-04
2025-06-27,3430.28,rent,out,Counterparty_95,27382335.67,2025-05-17,2025-06-16
2025-06-27,7164.39,refund,in,Counterparty_64,27389500.06,,
2025-06-27,18315.75,asset_sale,in,Counterparty_45,27407815.81,,
2025-06-27,213.1,T&E,out,Counterparty_90,27407602.71,2025-06-02,2025-06-30
2025-06-27,830.29,tax_payment,out,Counterparty_5,27406772.42,2025-05-30,2025-06-28
2025-06-27,4255.24,T&E,out,Counterparty_77,27402517.18,2025-05-14,2025-06-18
2025-06-28,12641.24,investment_income,in,Counterparty_47,27415158.42,,
2025-06-28,9082.08,T&E,out,Counterparty_32,27406076.34,2025-06-09,2025-07-14
2025-06-28,5563.9,software_subscription,out,Counterparty_83,27400512.44,2025-05-29,2025-06-25
2025-06-28,2848.18,utilities,out,Counterparty_66,27397664.26,2025-05-16,2025-06-13
2025-06-28,3500.75,asset_sale,in,Counterparty_72,27401165.01,,
2025-06-28,196.22,software_subscription,out,Counterparty_31,27400968.79,2025-05-27,2025-06-21
2025-06-28,2117.0,payroll,out,Counterparty_34,27398851.79,2025-06-13,2025-07-18
2025-06-28,4590.75,rent,out,Counterparty_44,27394261.04,2025-05-29,2025-06-23
2025-06-28,16375.35,credit,in,Counterparty_8,27410636.39,,
2025-06-28,2671.58,investment_income,in,Counterparty_91,27413307.97,,
2025-06-28,12001.61,investment_income,in,Counterparty_45,27425309.58,,
2025-06-28,515.7,utilities,out,Counterparty_81,27424793.88,2025-06-01,2025-06-29
2025-06-28,1640.82,software_subscription,out,Counterparty_22,27423153.06,2025-05-22,2025-06-21
2025-06-28,6249.91,tax_payment,out,Counterparty_63,27416903.15,2025-05-25,2025-07-01
2025-06-28,11329.05,refund,in,Counterparty_16,27428232.2,,
2025-06-28,1624.86,T&E,out,Counterparty_88,27426607.34,2025-06-10,2025-07-06
2025-06-28,13694.79,utilities,out,Counterparty_39,27412912.55,2025-05-30,2025-06-28
2025-06-28,844.19,loan_repayment,out,Counterparty_63,27412068.36,2025-05-31,2025-06-27
2025-06-28,6407.71,utilities,out,Counterparty_42,27405660.65,2025-05-20,2025-06-25
2025-06-28,5005.05,software_subscription,out,Counterparty_27,27400655.6,2025-06-06,2025-07-11
2025-06-28,10601.82,refund,in,Counterparty_95,27411257.42,,
2025-06-28,1193.1,marketing_spend,out,Counterparty_83,27410064.32,2025-05-24,2025-06-27
2025-06-28,577.28,tax_payment,out,Counterparty_74,27409487.04,2025-05-24,2025-06-18
2025-06-28,1761.77,marketing_spend,out,Counterparty_10,27407725.27,2025-06-09,2025-07-13
2025-06-28,7891.04,asset_sale,in,Counterparty_54,27415616.31,,
2025-06-28,1904.34,utilities,out,Counterparty_44,27413711.97,2025-06-11,2025-07-08
2025-06-28,1094.99,payroll,out,Counterparty_25,27412616.98,2025-05-28,2025-07-04
2025-06-28,46.54,T&E,out,Counterparty_52,27412570.44,2025-06-08,2025-07-07
2025-06-28,506.5,software_subscription,out,Counterparty_74,27412063.94,2025-06-08,2025-07-03
2025-06-28,209.97,loan_repayment,out,Counterparty_42,27411853.97,2025-06-13,2025-07-13
2025-06-28,127.19,software_subscription,out,Counterparty_44,27411726.78,2025-05-25,2025-06-20
2025-06-28,2514.38,loan_repayment,out,Counterparty_26,27409212.4,2025-06-10,2025-07-05
2025-06-28,1669.51,investment_income,in,Counterparty_63,27410881.91,,
2025-06-28,632.69,payroll,out,Counterparty_70,27410249.22,2025-06-06,2025-07-10
2025-06-28,5358.62,customer_payment,in,Counterparty_12,27415607.84,,
2025-06-28,15916.18,investment_income,in,Counterparty_1,27431524.02,,
2025-06-28,2410.1,rent,out,Counterparty_32,27429113.92,2025-05-31,2025-06-28
2025-06-28,1229.66,credit,in,Counterparty_22,27430343.58,,
2025-06-28,3007.54,software_subscription,out,Counterparty_92,27427336.04,2025-06-04,2025-06-29
2025-06-28,5358.09,software_subscription,out,Counterparty_11,27421977.95,2025-05-16,2025-06-11
2025-06-28,2869.77,refund,in,Counterparty_24,27424847.72,,
2025-06-28,5244.1,rent,out,Counterparty_40,27419603.62,2025-06-05,2025-07-14
2025-06-28,5008.07,T&E,out,Counterparty_6,27414595.55,2025-06-07,2025-07-03
2025-06-28,2199.64,utilities,out,Counterparty_3,27412395.91,2025-05-19,2025-06-23
2025-06-28,3731.94,investment_income,in,Counterparty_81,27416127.85,,
2025-06-28,85.34,software_subscription,out,Counterparty_70,27416042.51,2025-05-18,2025-06-24
2025-06-28,7073.45,investment_income,in,Counterparty_30,27423115.96,,
2025-06-28,2775.13,marketing_spend,out,Counterparty_33,27420340.83,2025-06-01,2025-07-06
2025-06-28,2789.27,utilities,out,Counterparty_2,27417551.56,2025-06-05,2025-07-07
2025-06-28,26252.6,refund,in,Counterparty_17,27443804.16,,
2025-06-28,14442.68,refund,in,Counterparty_49,27458246.84,,
2025-06-28,3774.57,refund,in,Counterparty_76,27462021.41,,
2025-06-28,2860.21,payroll,out,Counterparty_40,27459161.2,2025-06-04,2025-07-03
2025-06-28,275.95,supplier_payment,out,Counterparty_71,27458885.25,2025-05-27,2025-06-25
2025-06-28,504.1,utilities,out,Counterparty_51,27458381.15,2025-05-27,2025-07-04
2025-06-28,346.55,refund,in,Counterparty_14,27458727.7,,
2025-06-28,8476.23,loan_repayment,out,Counterparty_93,27450251.47,2025-06-04,2025-07-06
2025-06-28,3920.92,payroll,out,Counterparty_63,27446330.55,2025-05-16,2025-06-19
2025-06-28,5635.78,refund,in,Counterparty_47,27451966.33,,
2025-06-28,7659.96,investment_income,in,Counterparty_26,27459626.29,,
2025-06-28,2791.62,credit,in,Counterparty_66,27462417.91,,
2025-06-28,3547.92,asset_sale,in,Counterparty_58,27465965.83,,
2025-06-28,1148.44,loan_repayment,out,Counterparty_61,27464817.39,2025-05-15,2025-06-23
2025-06-29,670.18,loan_repayment,out,Counterparty_48,27464147.21,2025-06-12,2025-07-08
2025-06-29,1300.3,customer_payment,in,Counterparty_65,27465447.51,,
2025-06-29,3991.44,refund,in,Counterparty_72,27469438.95,,
2025-06-29,5712.1,payroll,out,Counterparty_67,27463726.85,2025-06-10,2025-07-16
2025-06-29,1436.23,supplier_payment,out,Counterparty_33,27462290.62,2025-05-31,2025-06-26
2025-06-29,1423.07,refund,in,Counterparty_65,27463713.69,,
2025-06-29,2012.76,payroll,out,Counterparty_79,27461700.93,2025-06-07,2025-07-09
2025-06-29,2943.12,utilities,out,Counterparty_28,27458757.81,2025-05-20,2025-06-16
2025-06-29,132.56,rent,out,Counterparty_36,27458625.25,2025-06-03,2025-07-01
2025-06-29,4976.81,payroll,out,Counterparty_23,27453648.44,2025-05-19,2025-06-19
2025-06-29,3312.42,rent,out,Counterparty_27,27450336.02,2025-05-16,2025-06-23
2025-06-29,3243.57,rent,out,Counterparty_2,27447092.45,2025-05-17,2025-06-16
2025-06-29,4928.34,T&E,out,Counterparty_5,27442164.11,2025-06-02,2025-06-28
2025-06-29,610.16,rent,out,Counterparty_29,27441553.95,2025-06-04,2025-07-06
2025-06-29,1989.46,supplier_payment,out,Counterparty_13,27439564.49,2025-06-07,2025-07-03
2025-06-29,7172.04,asset_sale,in,Counterparty_13,27446736.53,,
2025-06-29,11171.03,utilities,out,Counterparty_54,27435565.5,2025-05-31,2025-07-07
2025-06-29,1973.57,T&E,out,Counterparty_77,27433591.93,2025-06-04,2025-07-12
2025-06-29,2393.61,T&E,out,Counterparty_80,27431198.32,2025-06-11,2025-07-09
2025-06-29,124.27,tax_payment,out,Counterparty_25,27431074.05,2025-05-28,2025-07-02
2025-06-29,1643.87,payroll,out,Counterparty_28,27429430.18,2025-05-31,2025-07-04
2025-06-29,5341.96,supplier_payment,out,Counterparty_29,27424088.22,2025-06-05,2025-07-04
2025-06-29,44971.03,credit,in,Counterparty_17,27469059.25,,
2025-06-29,706.94,payroll,out,Counterparty_5,27468352.31,2025-06-13,2025-07-14
2025-06-29,4351.74,software_subscription,out,Counterparty_8,27464000.57,2025-05-21,2025-06-22
2025-06-29,1932.57,refund,in,Counterparty_92,27465933.14,,
2025-06-29,3858.45,software_subscription,out,Counterparty_38,27462074.69,2025-05-26,2025-06-20
2025-06-29,4961.38,utilities,out,Counterparty_73,27457113.31,2025-06-07,2025-07-07
2025-06-29,5067.8,marketing_spend,out,Counterparty_59,27452045.51,2025-06-12,2025-07-15
2025-06-29,11710.1,refund,in,Counterparty_96,27463755.61,,
2025-06-29,2389.93,investment_income,in,Counterparty_27,27466145.54,,
2025-06-29,2033.58,payroll,out,Counterparty_93,27464111.96,2025-05-24,2025-06-25
2025-06-29,1611.85,investment_income,in,Counterparty_5,27465723.81,,
2025-06-29,6745.01,loan_repayment,out,Counterparty_64,27458978.8,2025-06-01,2025-06-28
2025-06-29,2666.66,supplier_payment,out,Counterparty_64,27456312.14,2025-05-20,2025-06-16
2025-06-29,747.5,credit,in,Counterparty_94,27457059.64,,
2025-06-29,20288.43,customer_payment,in,Counterparty_33,27477348.07,,
2025-06-29,7795.74,refund,in,Counterparty_24,27485143.81,,
2025-06-29,4396.17,investment_income,in,Counterparty_96,27489539.98,,
2025-06-29,2261.09,T&E,out,Counterparty_74,27487278.89,2025-06-07,2025-07-16
2025-06-29,2365.1,refund,in,Counterparty_68,27489643.99,,
2025-06-29,248.28,tax_payment,out,Counterparty_93,27489395.71,2025-05-23,2025-07-01
2025-06-29,638.38,payroll,out,Counterparty_17,27488757.33,2025-05-30,2025-07-08
2025-06-29,2825.34,marketing_spend,out,Counterparty_34,27485931.99,2025-06-07,2025-07-08
2025-06-29,4582.47,investment_income,in,Counterparty_72,27490514.46,,
2025-06-29,7520.74,marketing_spend,out,Counterparty_48,27482993.72,2025-05-20,2025-06-17
2025-06-29,1465.33,payroll,out,Counterparty_95,27481528.39,2025-06-04,2025-07-05
2025-06-29,945.01,T&E,out,Counterparty_32,27480583.38,2025-05-29,2025-07-05
2025-06-29,6455.89,loan_repayment,out,Counterparty_7,27474127.49,2025-06-02,2025-07-04
2025-06-29,6685.57,marketing_spend,out,Counterparty_34,27467441.92,2025-05-24,2025-06-29
2025-06-29,1804.27,asset_sale,in,Counterparty_45,27469246.19,,
2025-06-29,3003.18,tax_payment,out,Counterparty_79,27466243.01,2025-05-24,2025-06-23
2025-06-29,2454.31,T&E,out,Counterparty_94,27463788.7,2025-06-10,2025-07-16
2025-06-29,1110.13,marketing_spend,out,Counterparty_78,27462678.57,2025-06-06,2025-07-12
2025-06-29,1031.86,marketing_spend,out,Counterparty_15,27461646.71,2025-06-07,2025-07-08
2025-06-29,5400.46,tax_payment,out,Counterparty_96,27456246.25,2025-06-11,2025-07-18
2025-06-29,2508.76,marketing_spend,out,Counterparty_58,27453737.49,2025-06-07,2025-07-14
2025-06-29,455.12,tax_payment,out,Counterparty_53,27453282.37,2025-06-01,2025-06-26
2025-06-29,385.91,investment_income,in,Counterparty_7,27453668.28,,
2025-06-29,101.91,customer_payment,in,Counterparty_28,27453770.19,,
2025-06-29,11084.38,credit,in,Counterparty_83,27464854.57,,
2025-06-29,1700.94,asset_sale,in,Counterparty_17,27466555.51,,
2025-06-29,6959.56,customer_payment,in,Counterparty_69,27473515.07,,
2025-06-29,742.34,payroll,out,Counterparty_86,27472772.73,2025-06-03,2025-06-29
2025-06-30,248.43,asset_sale,in,Counterparty_35,27473021.16,,
2025-06-30,1812.65,payroll,out,Counterparty_37,27471208.51,2025-06-06,2025-07-15
2025-06-30,3226.43,customer_payment,in,Counterparty_86,27474434.94,,
2025-06-30,24513.67,credit,in,Counterparty_27,27498948.61,,
2025-06-30,6125.54,refund,in,Counterparty_56,27505074.15,,
2025-06-30,4181.11,customer_payment,in,Counterparty_30,27509255.26,,
2025-06-30,138.54,loan_repayment,out,Counterparty_66,27509116.72,2025-05-19,2025-06-18
2025-06-30,2990.36,rent,out,Counterparty_82,27506126.36,2025-06-13,2025-07-11
2025-06-30,1502.93,T&E,out,Counterparty_89,27504623.43,2025-05-26,2025-07-01
2025-06-30,13389.12,loan_repayment,out,Counterparty_84,27491234.31,2025-06-08,2025-07-04
2025-06-30,285.88,software_subscription,out,Counterparty_14,27490948.43,2025-06-02,2025-07-07
2025-06-30,2214.25,utilities,out,Counterparty_48,27488734.18,2025-06-12,2025-07-16
2025-06-30,6305.74,loan_repayment,out,Counterparty_46,27482428.44,2025-05-26,2025-06-30
2025-06-30,510.83,utilities,out,Counterparty_6,27481917.61,2025-05-22,2025-06-29
2025-06-30,819.04,loan_repayment,out,Counterparty_44,27481098.57,2025-05-28,2025-06-27
2025-06-30,2193.62,tax_payment,out,Counterparty_22,27478904.95,2025-05-22,2025-06-23
2025-06-30,1176.49,loan_repayment,out,Counterparty_94,27477728.46,2025-05-22,2025-06-27
2025-06-30,165.18,tax_payment,out,Counterparty_97,27477563.28,2025-06-06,2025-07-10
2025-06-30,4558.64,supplier_payment,out,Counterparty_67,27473004.64,2025-06-09,2025-07-11
2025-06-30,4951.56,software_subscription,out,Counterparty_94,27468053.08,2025-06-05,2025-07-08
2025-06-30,1296.89,rent,out,Counterparty_76,27466756.19,2025-06-10,2025-07-09
2025-06-30,3260.07,rent,out,Counterparty_33,27463496.12,2025-06-08,2025-07-14
2025-06-30,1272.91,marketing_spend,out,Counterparty_89,27462223.21,2025-06-08,2025-07-10
2025-06-30,1615.28,software_subscription,out,Counterparty_22,27460607.93,2025-06-14,2025-07-14
2025-06-30,2002.89,tax_payment,out,Counterparty_33,27458605.04,2025-05-19,2025-06-25
2025-06-30,6381.63,rent,out,Counterparty_41,27452223.41,2025-06-02,2025-07-03
2025-06-30,637.48,rent,out,Counterparty_93,27451585.93,2025-06-14,2025-07-12
2025-06-30,10782.57,rent,out,Counterparty_44,27440803.36,2025-05-30,2025-06-26
2025-06-30,8169.75,supplier_payment,out,Counterparty_8,27432633.61,2025-06-06,2025-07-07
2025-06-30,1232.14,investment_income,in,Counterparty_57,27433865.75,,
2025-06-30,2958.64,payroll,out,Counterparty_66,27430907.11,2025-05-19,2025-06-15
2025-06-30,6528.71,supplier_payment,out,Counterparty_2,27424378.4,2025-05-17,2025-06-11
2025-06-30,2917.97,software_subscription,out,Counterparty_30,27421460.43,2025-05-23,2025-06-18
2025-06-30,1454.15,utilities,out,Counterparty_58,27420006.28,2025-06-03,2025-06-28
2025-06-30,1296.47,rent,out,Counterparty_60,27418709.81,2025-05-24,2025-06-26
2025-06-30,58170.99,credit,in,Counterparty_3,27476880.8,,
2025-06-30,2779.29,software_subscription,out,Counterparty_55,27474101.51,2025-06-08,2025-07-17
2025-06-30,2486.17,customer_payment,in,Counterparty_17,27476587.68,,
2025-06-30,7114.88,tax_payment,out,Counterparty_45,27469472.8,2025-06-02,2025-07-08
2025-06-30,5721.13,investment_income,in,Counterparty_21,27475193.93,,
2025-06-30,8308.92,asset_sale,in,Counterparty_2,27483502.85,,
2025-06-30,1122.59,customer_payment,in,Counterparty_81,27484625.44,,
2025-06-30,3990.05,loan_repayment,out,Counterparty_77,27480635.39,2025-05-20,2025-06-18
2025-06-30,15402.0,credit,in,Counterparty_56,27496037.39,,
2025-06-30,12827.01,customer_payment,in,Counterparty_31,27508864.4,,
2025-06-30,628.71,software_subscription,out,Counterparty_71,27508235.69,2025-06-08,2025-07-17
2025-06-30,14621.16,investment_income,in,Counterparty_86,27522856.85,,
2025-06-30,57.56,tax_payment,out,Counterparty_85,27522799.29,2025-06-08,2025-07-06
2025-06-30,2655.3,investment_income,in,Counterparty_65,27525454.59,,
2025-06-30,2975.98,utilities,out,Counterparty_14,27522478.61,2025-05-29,2025-06-27
2025-06-30,29702.9,customer_payment,in,Counterparty_24,27552181.51,,
2025-06-30,1834.3,utilities,out,Counterparty_79,27550347.21,2025-05-18,2025-06-22
2025-06-30,4895.84,investment_income,in,Counterparty_43,27555243.05,,
2025-06-30,2532.41,supplier_payment,out,Counterparty_29,27552710.64,2025-06-08,2025-07-10
2025-06-30,5376.58,refund,in,Counterparty_52,27558087.22,,
2025-06-30,5862.08,customer_payment,in,Counterparty_65,27563949.3,,
2025-06-30,13075.67,customer_payment,in,Counterparty_68,27577024.97,,
2025-06-30,717.59,credit,in,Counterparty_79,27577742.56,,
2025-06-30,21865.54,refund,in,Counterparty_79,27599608.1,,
2025-06-30,195.44,software_subscription,out,Counterparty_18,27599412.66,2025-06-01,2025-06-28
2025-07-01,4237.11,loan_repayment,out,Counterparty_62,27595175.55,2025-05-29,2025-06-30
2025-07-01,1903.67,loan_repayment,out,Counterparty_47,27593271.88,2025-06-09,2025-07-17
2025-07-01,295.7,software_subscription,out,Counterparty_37,27592976.18,2025-06-09,2025-07-15
2025-07-01,1700.83,utilities,out,Counterparty_73,27591275.35,2025-05-31,2025-07-07
2025-07-01,65.76,utilities,out,Counterparty_1,27591209.59,2025-06-15,2025-07-20
2025-07-01,4297.25,software_subscription,out,Counterparty_98,27586912.34,2025-05-30,2025-06-30
2025-07-01,720.18,marketing_spend,out,Counterparty_91,27586192.16,2025-06-11,2025-07-09
2025-07-01,8202.59,customer_payment,in,Counterparty_94,27594394.75,,
2025-07-01,2450.24,marketing_spend,out,Counterparty_71,27591944.51,2025-05-18,2025-06-24
2025-07-01,9.13,payroll,out,Counterparty_34,27591935.38,2025-06-07,2025-07-04
2025-07-01,3143.28,software_subscription,out,Counterparty_34,27588792.1,2025-06-12,2025-07-14
2025-07-01,1532.93,payroll,out,Counterparty_5,27587259.17,2025-06-15,2025-07-11
2025-07-01,4937.29,tax_payment,out,Counterparty_63,27582321.88,2025-06-10,2025-07-12
2025-07-01,1029.81,supplier_payment,out,Counterparty_90,27581292.07,2025-06-07,2025-07-09
2025-07-01,1829.4,loan_repayment,out,Counterparty_39,27579462.67,2025-06-03,2025-07-02
2025-07-01,1119.92,asset_sale,in,Counterparty_38,27580582.59,,
2025-07-01,3394.18,credit,in,Counterparty_11,27583976.77,,
2025-07-01,198.04,investment_income,in,Counterparty_5,27584174.81,,
2025-07-01,22.35,customer_payment,in,Counterparty_48,27584197.16,,
2025-07-01,217.95,loan_repayment,out,Counterparty_43,27583979.21,2025-05-19,2025-06-16
2025-07-01,444.37,software_subscription,out,Counterparty_11,27583534.84,2025-06-14,2025-07-21
2025-07-01,1806.4,software_subscription,out,Counterparty_9,27581728.44,2025-06-12,2025-07-11
2025-07-01,847.85,software_subscription,out,Counterparty_12,27580880.59,2025-05-24,2025-06-19
2025-07-01,1521.7,loan_repayment,out,Counterparty_94,27579358.89,2025-06-15,2025-07-19
2025-07-01,5641.04,supplier_payment,out,Counterparty_33,27573717.85,2025-05-28,2025-06-29
2025-07-01,17019.41,payroll,out,Counterparty_92,27556698.44,2025-05-30,2025-07-05
2025-07-01,6786.63,credit,in,Counterparty_29,27563485.07,,
2025-07-01,1041.8,supplier_payment,out,Counterparty_62,27562443.27,2025-06-04,2025-06-30
2025-07-01,2530.9,asset_sale,in,Counterparty_88,27564974.17,,
2025-07-01,1445.36,loan_repayment,out,Counterparty_56,27563528.81,2025-06-11,2025-07-09
2025-07-01,502.35,rent,out,Counterparty_92,27563026.46,2025-05-23,2025-06-20
2025-07-01,6124.09,customer_payment,in,Counterparty_17,27569150.55,,
2025-07-01,2638.3,loan_repayment,out,Counterparty_28,27566512.25,2025-05-23,2025-06-27
2025-07-01,265.07,customer_payment,in,Counterparty_83,27566777.32,,
2025-07-01,3712.48,investment_income,in,Counterparty_42,27570489.8,,
2025-07-01,1005.25,refund,in,Counterparty_96,27571495.05,,
2025-07-01,415.01,utilities,out,Counterparty_71,27571080.04,2025-06-13,2025-07-08
2025-07-01,71.65,rent,out,Counterparty_75,27571008.39,2025-06-14,2025-07-17
2025-07-01,1187.15,T&E,out,Counterparty_20,27569821.24,2025-06-12,2025-07-09
2025-07-01,446.7,supplier_payment,out,Counterparty_57,27569374.54,2025-06-11,2025-07-15
2025-07-01,6643.37,refund,in,Counterparty_51,27576017.91,,
2025-07-01,816.24,supplier_payment,out,Counterparty_33,27575201.67,2025-06-16,2025-07-17
2025-07-01,1605.01,investment_income,in,Counterparty_67,27576806.68,,
2025-07-01,8552.0,investment_income,in,Counterparty_94,27585358.68,,
2025-07-01,3172.8,utilities,out,Counterparty_3,27582185.88,2025-06-14,2025-07-17
2025-07-02,5053.41,credit,in,Counterparty_71,27587239.29,,
2025-07-02,718.75,software_subscription,out,Counterparty_15,27586520.54,2025-06-17,2025-07-12
2025-07-02,99.33,refund,in,Counterparty_3,27586619.87,,
2025-07-02,1052.59,utilities,out,Counterparty_5,27585567.28,2025-05-27,2025-07-01
2025-07-02,30765.01,customer_payment,in,Counterparty_98,27616332.29,,
2025-07-02,554.48,payroll,out,Counterparty_47,27615777.81,2025-05-23,2025-06-30
2025-07-02,6900.19,customer_payment,in,Counterparty_5,27622678.0,,
2025-07-02,2382.6,investment_income,in,Counterparty_85,27625060.6,,
2025-07-02,10089.17,customer_payment,in,Counterparty_41,27635149.77,,
2025-07-02,822.72,rent,out,Counterparty_39,27634327.05,2025-05-29,2025-07-02
2025-07-02,102.91,investment_income,in,Counterparty_3,27634429.96,,
2025-07-02,130.49,marketing_spend,out,Counterparty_44,27634299.47,2025-05-22,2025-06-17
2025-07-02,904.23,software_subscription,out,Counterparty_54,27633395.24,2025-06-10,2025-07-15
2025-07-02,1666.15,supplier_payment,out,Counterparty_14,27631729.09,2025-05-27,2025-06-28
2025-07-02,49.52,payroll,out,Counterparty_58,27631679.57,2025-06-03,2025-07-08
2025-07-02,8401.16,asset_sale,in,Counterparty_34,27640080.73,,
2025-07-02,79.83,marketing_spend,out,Counterparty_43,27640000.9,2025-05-29,2025-07-03
2025-07-02,1629.26,customer_payment,in,Counterparty_1,27641630.16,,
2025-07-02,8107.12,credit,in,Counterparty_12,27649737.28,,
2025-07-02,684.61,payroll,out,Counterparty_45,27649052.67,2025-05-23,2025-06-29
2025-07-02,733.94,payroll,out,Counterparty_23,27648318.73,2025-06-02,2025-07-07
2025-07-02,8539.53,loan_repayment,out,Counterparty_6,27639779.2,2025-05-24,2025-06-26
2025-07-02,365.01,payroll,out,Counterparty_43,27639414.19,2025-06-01,2025-06-29
2025-07-02,4345.26,rent,out,Counterparty_66,27635068.93,2025-05-26,2025-06-27
2025-07-02,4178.67,customer_payment,in,Counterparty_40,27639247.6,,
2025-07-02,3327.66,customer_payment,in,Counterparty_92,27642575.26,,
2025-07-02,2101.57,refund,in,Counterparty_25,27644676.83,,
2025-07-02,789.23,utilities,out,Counterparty_43,27643887.6,2025-05-22,2025-06-16
2025-07-02,1815.5,tax_payment,out,Counterparty_82,27642072.1,2025-05-26,2025-06-20
2025-07-02,1925.59,utilities,out,Counterparty_37,27640146.51,2025-06-03,2025-07-05
2025-07-02,4813.06,asset_sale,in,Counterparty_40,27644959.57,,
2025-07-02,2142.84,tax_payment,out,Counterparty_48,27642816.73,2025-05-26,2025-07-04
2025-07-02,2127.26,loan_repayment,out,Counterparty_11,27640689.47,2025-05-20,2025-06-25
2025-07-02,2024.92,credit,in,Counterparty_26,27642714.39,,
2025-07-02,1669.29,customer_payment,in,Counterparty_36,27644383.68,,
2025-07-02,425.76,loan_repayment,out,Counterparty_25,27643957.92,2025-06-06,2025-07-05
2025-07-02,605.38,marketing_spend,out,Counterparty_36,27643352.54,2025-05-24,2025-06-21
2025-07-02,223.25,payroll,out,Counterparty_5,27643129.29,2025-06-17,2025-07-16
2025-07-02,174.36,asset_sale,in,Counterparty_45,27643303.65,,
2025-07-02,10440.91,credit,in,Counterparty_21,27653744.56,,
2025-07-02,1521.97,marketing_spend,out,Counterparty_98,27652222.59,2025-06-09,2025-07-07
2025-07-02,868.97,utilities,out,Counterparty_48,27651353.62,2025-06-06,2025-07-10
2025-07-02,8891.99,credit,in,Counterparty_4,27660245.61,,
2025-07-02,21572.71,asset_sale,in,Counterparty_84,27681818.32,,
2025-07-02,10270.08,rent,out,Counterparty_7,27671548.24,2025-06-06,2025-07-09
2025-07-02,4211.71,T&E,out,Counterparty_35,27667336.53,2025-05-29,2025-07-06
2025-07-02,211.34,payroll,out,Counterparty_30,27667125.19,2025-06-14,2025-07-19
2025-07-02,7748.03,asset_sale,in,Counterparty_23,27674873.22,,
2025-07-02,1805.47,software_subscription,out,Counterparty_96,27673067.75,2025-06-16,2025-07-13
2025-07-02,190.74,rent,out,Counterparty_31,27672877.01,2025-06-15,2025-07-21
2025-07-02,4599.48,credit,in,Counterparty_21,27677476.49,,
2025-07-02,16.84,tax_payment,out,Counterparty_87,27677459.65,2025-06-09,2025-07-08
2025-07-02,660.84,customer_payment,in,Counterparty_88,27678120.49,,
2025-07-02,2693.76,refund,in,Counterparty_94,27680814.25,,
2025-07-03,7925.63,credit,in,Counterparty_8,27688739.88,,
2025-07-03,91.51,asset_sale,in,Counterparty_51,27688831.39,,
2025-07-03,60.25,utilities,out,Counterparty_61,27688771.14,2025-06-03,2025-06-28
2025-07-03,6515.83,customer_payment,in,Counterparty_56,27695286.97,,
2025-07-03,1990.92,asset_sale,in,Counterparty_29,27697277.89,,
2025-07-03,5873.8,investment_income,in,Counterparty_78,27703151.69,,
2025-07-03,1258.79,customer_payment,in,Counterparty_7,27704410.48,,
2025-07-03,11539.06,asset_sale,in,Counterparty_51,27715949.54,,
2025-07-03,1833.77,credit,in,Counterparty_67,27717783.31,,
2025-07-03,6896.57,customer_payment,in,Counterparty_6,27724679.88,,
2025-07-03,4956.22,credit,in,Counterparty_86,27729636.1,,
2025-07-03,3361.21,rent,out,Counterparty_7,27726274.89,2025-06-11,2025-07-07
2025-07-03,162.99,software_subscription,out,Counterparty_30,27726111.9,2025-06-17,2025-07-12
2025-07-03,3686.91,customer_payment,in,Counterparty_25,27729798.81,,
2025-07-03,36.05,investment_income,in,Counterparty_51,27729834.86,,
2025-07-03,3235.68,asset_sale,in,Counterparty_96,27733070.54,,
2025-07-03,5546.47,credit,in,Counterparty_1,27738617.01,,
2025-07-03,100.73,payroll,out,Counterparty_10,27738516.28,2025-05-31,2025-07-01
2025-07-03,5645.9,customer_payment,in,Counterparty_11,27744162.18,,
2025-07-03,1319.72,software_subscription,out,Counterparty_80,27742842.46,2025-06-02,2025-07-08
2025-07-03,419.33,rent,out,Counterparty_43,27742423.13,2025-05-27,2025-07-05
2025-07-03,244.97,software_subscription,out,Counterparty_24,27742178.16,2025-05-24,2025-06-27
2025-07-03,1374.95,utilities,out,Counterparty_54,27740803.21,2025-06-02,2025-07-10
2025-07-03,1223.56,tax_payment,out,Counterparty_9,27739579.65,2025-05-23,2025-06-26
2025-07-03,4597.32,supplier_payment,out,Counterparty_50,27734982.33,2025-06-14,2025-07-14
2025-07-03,2671.77,T&E,out,Counterparty_53,27732310.56,2025-06-10,2025-07-15
2025-07-03,8314.38,tax_payment,out,Counterparty_21,27723996.18,2025-06-10,2025-07-18
2025-07-03,3498.97,asset_sale,in,Counterparty_44,27727495.15,,
2025-07-03,2422.66,investment_income,in,Counterparty_44,27729917.81,,
2025-07-03,459.33,rent,out,Counterparty_84,27729458.48,2025-06-16,2025-07-21
2025-07-03,1275.86,refund,in,Counterparty_79,27730734.34,,
2025-07-03,1331.22,loan_repayment,out,Counterparty_95,27729403.12,2025-05-23,2025-06-26
2025-07-03,7387.35,credit,in,Counterparty_6,27736790.47,,
2025-07-03,12506.18,asset_sale,in,Counterparty_54,27749296.65,,
2025-07-03,822.48,payroll,out,Counterparty_70,27748474.17,2025-06-05,2025-07-09
2025-07-03,1416.32,T&E,out,Counterparty_1,27747057.85,2025-06-01,2025-06-29
2025-07-03,300.77,marketing_spend,out,Counterparty_65,27746757.08,2025-05-24,2025-06-19
2025-07-03,3025.04,payroll,out,Counterparty_51,27743732.04,2025-06-01,2025-07-04
2025-07-03,1356.41,customer_payment,in,Counterparty_74,27745088.45,,
2025-07-03,2237.16,credit,in,Counterparty_24,27747325.61,,
2025-07-03,929.45,marketing_spend,out,Counterparty_61,27746396.16,2025-05-28,2025-06-28
2025-07-03,356.3,utilities,out,Counterparty_57,27746039.86,2025-05-28,2025-06-26
2025-07-03,381.65,supplier_payment,out,Counterparty_51,27745658.21,2025-06-10,2025-07-18
2025-07-03,9877.61,T&E,out,Counterparty_64,27735780.6,2025-05-20,2025-06-14
2025-07-03,5182.33,asset_sale,in,Counterparty_68,27740962.93,,
2025-07-03,5378.81,credit,in,Counterparty_62,27746341.74,,
2025-07-03,638.55,rent,out,Counterparty_5,27745703.19,2025-05-20,2025-06-28
2025-07-03,9056.57,loan_repayment,out,Counterparty_29,27736646.62,2025-06-02,2025-06-29
2025-07-03,881.06,payroll,out,Counterparty_53,27735765.56,2025-05-25,2025-06-28
2025-07-03,6126.08,marketing_spend,out,Counterparty_41,27729639.48,2025-05-31,2025-07-03
2025-07-03,6555.76,marketing_spend,out,Counterparty_66,27723083.72,2025-06-04,2025-07-09
2025-07-03,113.98,tax_payment,out,Counterparty_53,27722969.74,2025-06-15,2025-07-15
2025-07-04,176.17,utilities,out,Counterparty_92,27722793.57,2025-06-13,2025-07-22
2025-07-04,7682.56,customer_payment,in,Counterparty_76,27730476.13,,
2025-07-04,977.73,payroll,out,Counterparty_3,27729498.4,2025-06-06,2025-07-14
2025-07-04,416.97,refund,in,Counterparty_70,27729915.37,,
2025-07-04,1251.86,utilities,out,Counterparty_19,27728663.51,2025-06-02,2025-06-30
2025-07-04,8312.48,payroll,out,Counterparty_54,27720351.03,2025-06-03,2025-07-02
2025-07-04,2444.23,customer_payment,in,Counterparty_26,27722795.26,,
2025-07-04,2138.5,supplier_payment,out,Counterparty_90,27720656.76,2025-05-23,2025-06-25
2025-07-04,510.14,tax_payment,out,Counterparty_59,27720146.62,2025-06-09,2025-07-11
2025-07-04,3267.36,loan_repayment,out,Counterparty_40,27716879.26,2025-06-08,2025-07-09
2025-07-04,68.36,loan_repayment,out,Counterparty_75,27716810.9,2025-06-10,2025-07-09
2025-07-04,3091.45,loan_repayment,out,Counterparty_44,27713719.45,2025-05-22,2025-06-23
2025-07-04,805.29,marketing_spend,out,Counterparty_83,27712914.16,2025-06-05,2025-07-08
2025-07-04,7313.15,investment_income,in,Counterparty_8,27720227.31,,
2025-07-04,3829.63,software_subscription,out,Counterparty_48,27716397.68,2025-06-09,2025-07-06
2025-07-04,99.15,payroll,out,Counterparty_9,27716298.53,2025-05-21,2025-06-27
2025-07-04,2011.52,software_subscription,out,Counterparty_66,27714287.01,2025-06-07,2025-07-09
2025-07-04,2070.33,tax_payment,out,Counterparty_82,27712216.68,2025-05-25,2025-06-21
2025-07-04,965.35,rent,out,Counterparty_92,27711251.33,2025-05-22,2025-06-24
2025-07-04,5390.11,investment_income,in,Counterparty_50,27716641.44,,
2025-07-04,1463.14,asset_sale,in,Counterparty_42,27718104.58,,
2025-07-04,522.39,investment_income,in,Counterparty_49,27718626.97,,
2025-07-04,340.75,tax_payment,out,Counterparty_63,27718286.22,2025-05-27,2025-06-30
2025-07-04,3383.55,utilities,out,Counterparty_51,27714902.67,2025-05-26,2025-06-22
2025-07-04,945.05,software_subscription,out,Counterparty_95,27713957.62,2025-06-07,2025-07-02
2025-07-04,8432.63,software_subscription,out,Counterparty_56,27705524.99,2025-05-31,2025-07-03
2025-07-04,283.0,T&E,out,Counterparty_49,27705241.99,2025-06-08,2025-07-10
2025-07-04,510.89,T&E,out,Counterparty_74,27704731.1,2025-06-11,2025-07-06
2025-07-04,5402.62,asset_sale,in,Counterparty_54,27710133.72,,
2025-07-04,1702.32,loan_repayment,out,Counterparty_11,27708431.4,2025-06-09,2025-07-08
2025-07-04,2240.41,credit,in,Counterparty_60,27710671.81,,
2025-07-04,2952.44,supplier_payment,out,Counterparty_24,27707719.37,2025-05-25,2025-07-03
2025-07-04,5850.6,refund,in,Counterparty_46,27713569.97,,
2025-07-04,2262.49,supplier_payment,out,Counterparty_36,27711307.48,2025-06-14,2025-07-15
2025-07-04,9141.05,loan_repayment,out,Counterparty_52,27702166.43,2025-06-05,2025-06-30
2025-07-04,1347.47,asset_sale,in,Counterparty_48,27703513.9,,
2025-07-04,3531.74,tax_payment,out,Counterparty_14,27699982.16,2025-06-13,2025-07-08
2025-07-04,6097.11,refund,in,Counterparty_15,27706079.27,,
2025-07-04,18735.86,investment_income,in,Counterparty_95,27724815.13,,
2025-07-04,1982.27,asset_sale,in,Counterparty_15,27726797.4,,
2025-07-04,3617.72,refund,in,Counterparty_36,27730415.12,,
2025-07-04,2212.15,refund,in,Counterparty_24,27732627.27,,
2025-07-04,1369.91,rent,out,Counterparty_45,27731257.36,2025-05-21,2025-06-21
2025-07-04,1863.19,supplier_payment,out,Counterparty_43,27729394.17,2025-05-23,2025-06-27
2025-07-04,53.5,supplier_payment,out,Counterparty_40,27729340.67,2025-06-07,2025-07-12
2025-07-04,812.01,tax_payment,out,Counterparty_25,27728528.66,2025-05-30,2025-06-26
2025-07-04,2029.24,software_subscription,out,Counterparty_6,27726499.42,2025-06-07,2025-07-03
2025-07-04,262.84,payroll,out,Counterparty_96,27726236.58,2025-05-23,2025-07-01
2025-07-04,2336.12,rent,out,Counterparty_53,27723900.46,2025-05-30,2025-07-05
2025-07-04,324.57,marketing_spend,out,Counterparty_31,27723575.89,2025-05-23,2025-06-25
2025-07-04,2212.78,tax_payment,out,Counterparty_1,27721363.11,2025-05-22,2025-06-17
2025-07-05,2195.24,software_subscription,out,Counterparty_70,27719167.87,2025-05-22,2025-06-20
2025-07-05,247.03,refund,in,Counterparty_44,27719414.9,,
2025-07-05,1140.55,refund,in,Counterparty_43,27720555.45,,
2025-07-05,551.17,software_subscription,out,Counterparty_54,27720004.28,2025-05-25,2025-06-26
2025-07-05,680.62,customer_payment,in,Counterparty_93,27720684.9,,
2025-07-05,2970.61,marketing_spend,out,Counterparty_40,27717714.29,2025-05-26,2025-07-03
2025-07-05,1160.33,rent,out,Counterparty_73,27716553.96,2025-06-19,2025-07-26
2025-07-05,2308.49,refund,in,Counterparty_88,27718862.45,,
2025-07-05,12.53,customer_payment,in,Counterparty_98,27718874.98,,
2025-07-05,2180.66,marketing_spend,out,Counterparty_66,27716694.32,2025-05-25,2025-06-23
2025-07-05,4261.96,credit,in,Counterparty_24,27720956.28,,
2025-07-05,308.12,credit,in,Counterparty_19,27721264.4,,
2025-07-05,983.29,marketing_spend,out,Counterparty_12,27720281.11,2025-05-23,2025-06-19
2025-07-05,2098.01,tax_payment,out,Counterparty_25,27718183.1,2025-05-29,2025-06-26
2025-07-05,460.87,supplier_payment,out,Counterparty_78,27717722.23,2025-06-09,2025-07-16
2025-07-05,5729.2,rent,out,Counterparty_50,27711993.03,2025-06-13,2025-07-16
2025-07-05,1818.97,asset_sale,in,Counterparty_88,27713812.0,,
2025-07-05,445.85,asset_sale,in,Counterparty_16,27714257.85,,
2025-07-05,755.46,loan_repayment,out,Counterparty_46,27713502.39,2025-06-12,2025-07-08
2025-07-05,960.43,utilities,out,Counterparty_39,27712541.96,2025-05-23,2025-06-19
2025-07-05,57.82,refund,in,Counterparty_93,27712599.78,,
2025-07-05,7943.74,customer_payment,in,Counterparty_28,27720543.52,,
2025-07-05,1440.29,tax_payment,out,Counterparty_75,27719103.23,2025-06-05,2025-07-14
2025-07-05,266.34,investment_income,in,Counterparty_60,27719369.57,,
2025-07-05,2701.91,utilities,out,Counterparty_71,27716667.66,2025-06-19,2025-07-14
2025-07-05,4297.87,payroll,out,Counterparty_65,27712369.79,2025-05-23,2025-06-17
2025-07-05,893.53,loan_repayment,out,Counterparty_14,27711476.26,2025-06-09,2025-07-04
2025-07-05,1314.21,T&E,out,Counterparty_88,27710162.05,2025-06-17,2025-07-21
2025-07-05,899.89,rent,out,Counterparty_24,27709262.16,2025-05-23,2025-06-29
2025-07-05,369.41,utilities,out,Counterparty_5,27708892.75,2025-06-05,2025-07-08
2025-07-05,4376.19,utilities,out,Counterparty_52,27704516.56,2025-06-18,2025-07-13
2025-07-05,3276.67,utilities,out,Counterparty_4,27701239.89,2025-05-24,2025-06-21
2025-07-05,70.19,credit,in,Counterparty_57,27701310.08,,
2025-07-05,2366.35,utilities,out,Counterparty_86,27698943.73,2025-05-27,2025-06-24
2025-07-05,4100.15,credit,in,Counterparty_52,27703043.88,,
2025-07-05,4835.52,refund,in,Counterparty_46,27707879.4,,
2025-07-05,2627.91,marketing_spend,out,Counterparty_45,27705251.49,2025-05-22,2025-06-25
2025-07-05,1286.22,asset_sale,in,Counterparty_9,27706537.71,,
2025-07-05,4235.47,investment_income,in,Counterparty_28,27710773.18,,
2025-07-05,194.13,marketing_spend,out,Counterparty_22,27710579.05,2025-05-23,2025-06-29
2025-07-05,6780.25,credit,in,Counterparty_32,27717359.3,,
2025-07-05,299.02,marketing_spend,out,Counterparty_21,27717060.28,2025-06-16,2025-07-14
2025-07-05,282.06,customer_payment,in,Counterparty_69,27717342.34,,
2025-07-05,1356.86,T&E,out,Counterparty_8,27715985.48,2025-05-25,2025-06-21
2025-07-05,14029.77,software_subscription,out,Counterparty_67,27701955.71,2025-06-06,2025-07-02
2025-07-05,3112.09,asset_sale,in,Counterparty_24,27705067.8,,
2025-07-05,1133.89,marketing_spend,out,Counterparty_4,27703933.91,2025-06-15,2025-07-10
2025-07-05,12685.03,investment_income,in,Counterparty_39,27716618.94,,
2025-07-05,3404.73,software_subscription,out,Counterparty_63,27713214.21,2025-05-24,2025-06-23
2025-07-05,525.99,loan_repayment,out,Counterparty_94,27712688.22,2025-05-31,2025-07-06
2025-07-05,1195.79,credit,in,Counterparty_79,27713884.01,,
2025-07-05,1114.33,tax_payment,out,Counterparty_4,27712769.68,2025-05-23,2025-07-01
2025-07-05,7006.2,refund,in,Counterparty_19,27719775.88,,
2025-07-06,270.98,T&E,out,Counterparty_62,27719504.9,2025-06-09,2025-07-16
2025-07-06,747.0,utilities,out,Counterparty_48,27718757.9,2025-05-26,2025-06-22
2025-07-06,651.18,supplier_payment,out,Counterparty_38,27718106.72,2025-05-30,2025-07-04
2025-07-06,1919.98,investment_income,in,Counterparty_52,27720026.7,,
2025-07-06,727.49,tax_payment,out,Counterparty_63,27719299.21,2025-06-15,2025-07-11
2025-07-06,1795.4,utilities,out,Counterparty_59,27717503.81,2025-05-29,2025-07-07
2025-07-06,7417.32,customer_payment,in,Counterparty_80,27724921.13,,
2025-07-06,3181.83,marketing_spend,out,Counterparty_75,27721739.3,2025-06-13,2025-07-12
2025-07-06,4462.02,T&E,out,Counterparty_51,27717277.28,2025-06-05,2025-07-10
2025-07-06,12483.5,credit,in,Counterparty_60,27729760.78,,
2025-07-06,7143.43,loan_repayment,out,Counterparty_53,27722617.35,2025-05-26,2025-06-23
2025-07-06,4110.59,asset_sale,in,Counterparty_39,27726727.94,,
2025-07-06,62.82,loan_repayment,out,Counterparty_50,27726665.12,2025-05-24,2025-06-27
2025-07-06,595.54,rent,out,Counterparty_11,27726069.58,2025-05-26,2025-06-24
2025-07-06,771.85,payroll,out,Counterparty_49,27725297.73,2025-06-15,2025-07-20
2025-07-06,650.49,software_subscription,out,Counterparty_80,27724647.24,2025-06-05,2025-07-06
2025-07-06,3588.53,supplier_payment,out,Counterparty_48,27721058.71,2025-06-16,2025-07-22
2025-07-06,3582.46,payroll,out,Counterparty_11,27717476.25,2025-06-10,2025-07-06
2025-07-06,325.89,T&E,out,Counterparty_24,27717150.36,2025-06-04,2025-06-29
2025-07-06,2141.75,payroll,out,Counterparty_94,27715008.61,2025-05-24,2025-06-26
2025-07-06,6141.57,credit,in,Counterparty_74,27721150.18,,
2025-07-06,323.89,T&E,out,Counterparty_33,27720826.29,2025-06-17,2025-07-20
2025-07-06,1652.73,T&E,out,Counterparty_20,27719173.56,2025-06-14,2025-07-16
2025-07-06,41.48,asset_sale,in,Counterparty_6,27719215.04,,
2025-07-06,72.21,refund,in,Counterparty_24,27719287.25,,
2025-07-06,1434.36,tax_payment,out,Counterparty_2,27717852.89,2025-06-10,2025-07-06
2025-07-06,1200.56,asset_sale,in,Counterparty_88,27719053.45,,
2025-07-06,307.98,tax_payment,out,Counterparty_74,27718745.47,2025-05-26,2025-07-01
2025-07-06,1893.25,rent,out,Counterparty_57,27716852.22,2025-06-05,2025-07-03
2025-07-06,1655.17,customer_payment,in,Counterparty_80,27718507.39,,
2025-07-06,2533.23,refund,in,Counterparty_83,27721040.62,,
2025-07-06,317.73,payroll,out,Counterparty_10,27720722.89,2025-06-11,2025-07-16
2025-07-06,1714.07,payroll,out,Counterparty_9,27719008.82,2025-05-23,2025-07-01
2025-07-06,3180.82,marketing_spend,out,Counterparty_96,27715828.0,2025-05-28,2025-06-28
2025-07-06,1736.97,supplier_payment,out,Counterparty_18,27714091.03,2025-06-04,2025-07-04
2025-07-06,2248.59,rent,out,Counterparty_14,27711842.44,2025-06-04,2025-07-07
2025-07-06,5311.48,refund,in,Counterparty_79,27717153.92,,
2025-07-06,336.71,software_subscription,out,Counterparty_4,27716817.21,2025-06-09,2025-07-08
2025-07-06,1523.43,asset_sale,in,Counterparty_1,27718340.64,,
2025-07-06,620.0,investment_income,in,Counterparty_72,27718960.64,,
2025-07-06,2266.24,tax_payment,out,Counterparty_77,27716694.4,2025-05-29,2025-07-06
2025-07-06,613.38,payroll,out,Counterparty_31,27716081.02,2025-06-03,2025-07-06
2025-07-06,1752.7,utilities,out,Counterparty_66,27714328.32,2025-05-31,2025-06-25
2025-07-06,2796.77,investment_income,in,Counterparty_18,27717125.09,,
2025-07-06,12590.87,T&E,out,Counterparty_47,27704534.22,2025-06-18,2025-07-13
2025-07-06,234.83,payroll,out,Counterparty_16,27704299.39,2025-06-18,2025-07-24
2025-07-06,7914.11,software_subscription,out,Counterparty_90,27696385.28,2025-06-04,2025-07-09
2025-07-06,220.29,T&E,out,Counterparty_88,27696164.99,2025-06-17,2025-07-18
2025-07-06,2014.25,T&E,out,Counterparty_80,27694150.74,2025-05-23,2025-06-25
2025-07-06,757.48,investment_income,in,Counterparty_17,27694908.22,,
2025-07-06,4895.26,customer_payment,in,Counterparty_4,27699803.48,,
2025-07-06,1150.46,asset_sale,in,Counterparty_47,27700953.94,,
2025-07-06,2153.0,payroll,out,Counterparty_76,27698800.94,2025-06-08,2025-07-12
2025-07-06,13.69,marketing_spend,out,Counterparty_10,27698787.25,2025-06-16,2025-07-17
2025-07-06,4426.46,loan_repayment,out,Counterparty_30,27694360.79,2025-06-14,2025-07-21
2025-07-06,1447.44,credit,in,Counterparty_58,27695808.23,,
2025-07-06,1578.89,asset_sale,in,Counterparty_34,27697387.12,,
2025-07-06,789.98,T&E,out,Counterparty_78,27696597.14,2025-06-08,2025-07-07
2025-07-06,2281.91,supplier_payment,out,Counterparty_16,27694315.23,2025-06-08,2025-07-04
2025-07-06,13268.61,investment_income,in,Counterparty_28,27707583.84,,
2025-07-06,2287.05,payroll,out,Counterparty_23,27705296.79,2025-06-01,2025-06-28
2025-07-06,114.18,utilities,out,Counterparty_19,27705182.61,2025-06-01,2025-06-27
2025-07-06,361.64,customer_payment,in,Counterparty_91,27705544.25,,
2025-07-06,5498.23,tax_payment,out,Counterparty_29,27700046.02,2025-06-13,2025-07-21
2025-07-07,3457.67,asset_sale,in,Counterparty_6,27703503.69,,
2025-07-07,3340.62,customer_payment,in,Counterparty_70,27706844.31,,
2025-07-07,2447.11,investment_income,in,Counterparty_23,27709291.42,,
2025-07-07,2997.31,investment_income,in,Counterparty_21,27712288.73,,
2025-07-07,1108.89,loan_repayment,out,Counterparty_25,27711179.84,2025-06-13,2025-07-21
2025-07-07,1160.08,credit,in,Counterparty_78,27712339.92,,
2025-07-07,2187.88,customer_payment,in,Counterparty_57,27714527.8,,
2025-07-07,804.67,payroll,out,Counterparty_61,27713723.13,2025-06-06,2025-07-03
2025-07-07,675.58,rent,out,Counterparty_2,27713047.55,2025-06-05,2025-07-03
2025-07-07,2861.5,customer_payment,in,Counterparty_51,27715909.05,,
2025-07-07,557.94,rent,out,Counterparty_74,27715351.11,2025-06-12,2025-07-11
2025-07-07,987.1,refund,in,Counterparty_32,27716338.21,,
2025-07-07,802.18,marketing_spend,out,Counterparty_24,27715536.03,2025-06-19,2025-07-14
2025-07-07,1497.3,payroll,out,Counterparty_78,27714038.73,2025-06-03,2025-07-11
2025-07-07,3165.97,rent,out,Counterparty_35,27710872.76,2025-06-06,2025-07-12
2025-07-07,5024.5,credit,in,Counterparty_18,27715897.26,,
2025-07-07,409.48,customer_payment,in,Counterparty_95,27716306.74,,
2025-07-07,276.66,utilities,out,Counterparty_16,27716030.08,2025-06-22,2025-07-19
2025-07-07,6175.37,utilities,out,Counterparty_61,27709854.71,2025-06-05,2025-07-11
2025-07-07,5548.15,utilities,out,Counterparty_49,27704306.56,2025-05-24,2025-06-19
2025-07-07,2124.08,utilities,out,Counterparty_97,27702182.48,2025-06-02,2025-07-09
2025-07-07,10972.76,refund,in,Counterparty_18,27713155.24,,
2025-07-07,1050.83,supplier_payment,out,Counterparty_43,27712104.41,2025-06-10,2025-07-16
2025-07-07,258.77,payroll,out,Counterparty_30,27711845.64,2025-06-15,2025-07-10
2025-07-07,16729.78,customer_payment,in,Counterparty_74,27728575.42,,
2025-07-07,2455.3,loan_repayment,out,Counterparty_63,27726120.12,2025-06-09,2025-07-13
2025-07-07,1436.37,credit,in,Counterparty_86,27727556.49,,
2025-07-07,83.0,supplier_payment,out,Counterparty_30,27727473.49,2025-06-06,2025-07-14
2025-07-07,10397.44,investment_income,in,Counterparty_86,27737870.93,,
2025-07-07,396.03,customer_payment,in,Counterparty_52,27738266.96,,
2025-07-07,4059.47,T&E,out,Counterparty_21,27734207.49,2025-06-17,2025-07-17
2025-07-07,6047.36,utilities,out,Counterparty_14,27728160.13,2025-06-19,2025-07-16
2025-07-07,3666.73,supplier_payment,out,Counterparty_5,27724493.4,2025-06-14,2025-07-17
2025-07-07,9181.22,investment_income,in,Counterparty_29,27733674.62,,
2025-07-07,1698.9,loan_repayment,out,Counterparty_36,27731975.72,2025-06-14,2025-07-17
2025-07-07,20.27,credit,in,Counterparty_25,27731995.99,,
2025-07-07,1615.98,T&E,out,Counterparty_8,27730380.01,2025-06-17,2025-07-20
2025-07-07,6604.66,investment_income,in,Counterparty_60,27736984.67,,
2025-07-07,514.69,rent,out,Counterparty_48,27736469.98,2025-06-22,2025-07-18
2025-07-07,2645.6,rent,out,Counterparty_86,27733824.38,2025-06-08,2025-07-07
2025-07-07,9042.86,credit,in,Counterparty_51,27742867.24,,
2025-07-07,8797.18,refund,in,Counterparty_82,27751664.42,,
2025-07-07,2610.34,investment_income,in,Counterparty_84,27754274.76,,
2025-07-07,1819.02,utilities,out,Counterparty_94,27752455.74,2025-05-27,2025-07-01
2025-07-07,3806.8,T&E,out,Counterparty_30,27748648.94,2025-05-30,2025-07-05
2025-07-07,1072.83,asset_sale,in,Counterparty_81,27749721.77,,
2025-07-07,9439.92,tax_payment,out,Counterparty_96,27740281.85,2025-06-10,2025-07-10
2025-07-07,1268.12,T&E,out,Counterparty_68,27739013.73,2025-05-30,2025-06-30
2025-07-07,780.81,asset_sale,in,Counterparty_84,27739794.54,,
2025-07-07,671.49,customer_payment,in,Counterparty_52,27740466.03,,
2025-07-07,3954.46,tax_payment,out,Counterparty_7,27736511.57,2025-05-27,2025-06-28
2025-07-07,2001.23,marketing_spend,out,Counterparty_86,27734510.34,2025-05-24,2025-06-24
2025-07-07,1601.51,customer_payment,in,Counterparty_83,27736111.85,,
2025-07-07,680.37,rent,out,Counterparty_77,27735431.48,2025-06-14,2025-07-22
2025-07-08,1017.67,loan_repayment,out,Counterparty_33,27734413.81,2025-06-11,2025-07-17
2025-07-08,510.42,utilities,out,Counterparty_80,27733903.39,2025-05-30,2025-06-30
2025-07-08,601.07,credit,in,Counterparty_30,27734504.46,,
2025-07-08,362.1,asset_sale,in,Counterparty_66,27734866.56,,
2025-07-08,7916.55,tax_payment,out,Counterparty_66,27726950.01,2025-05-31,2025-07-02
2025-07-08,909.26,rent,out,Counterparty_27,27726040.75,2025-06-12,2025-07-16
2025-07-08,861.04,tax_payment,out,Counterparty_34,27725179.71,2025-06-20,2025-07-18
2025-07-08,2928.7,customer_payment,in,Counterparty_34,27728108.41,,
2025-07-08,6028.56,credit,in,Counterparty_90,27734136.97,,
2025-07-08,1537.04,customer_payment,in,Counterparty_81,27735674.01,,
2025-07-08,15.64,payroll,out,Counterparty_92,27735658.37,2025-06-19,2025-07-22
2025-07-08,1056.04,credit,in,Counterparty_68,27736714.41,,
2025-07-08,37.93,utilities,out,Counterparty_84,27736676.48,2025-06-01,2025-06-28
2025-07-08,3926.21,T&E,out,Counterparty_36,27732750.27,2025-06-13,2025-07-21
2025-07-08,3782.12,refund,in,Counterparty_75,27736532.39,,
2025-07-08,1037.5,credit,in,Counterparty_94,27737569.89,,
2025-07-08,14458.24,investment_income,in,Counterparty_46,27752028.13,,
2025-07-08,1744.34,T&E,out,Counterparty_97,27750283.79,2025-06-12,2025-07-17
2025-07-08,2003.64,marketing_spend,out,Counterparty_13,27748280.15,2025-06-09,2025-07-16
2025-07-08,518.58,asset_sale,in,Counterparty_17,27748798.73,,
2025-07-08,2827.8,payroll,out,Counterparty_88,27745970.93,2025-06-07,2025-07-04
2025-07-08,673.03,refund,in,Counterparty_80,27746643.96,,
2025-07-08,220.06,asset_sale,in,Counterparty_95,27746864.02,,
2025-07-08,745.22,customer_payment,in,Counterparty_54,27747609.24,,
2025-07-08,397.1,credit,in,Counterparty_51,27748006.34,,
2025-07-08,488.07,rent,out,Counterparty_59,27747518.27,2025-06-16,2025-07-13
2025-07-08,1183.3,investment_income,in,Counterparty_74,27748701.57,,
2025-07-08,2025.85,tax_payment,out,Counterparty_78,27746675.72,2025-06-17,2025-07-18
2025-07-08,1236.28,utilities,out,Counterparty_31,27745439.44,2025-06-08,2025-07-04
2025-07-08,8961.69,loan_repayment,out,Counterparty_55,27736477.75,2025-06-16,2025-07-13
2025-07-08,391.68,refund,in,Counterparty_69,27736869.43,,
2025-07-08,4595.8,utilities,out,Counterparty_24,27732273.63,2025-06-12,2025-07-12
2025-07-08,1681.33,credit,in,Counterparty_76,27733954.96,,
2025-07-08,945.61,tax_payment,out,Counterparty_98,27733009.35,2025-05-28,2025-07-02
2025-07-08,892.96,investment_income,in,Counterparty_83,27733902.31,,
2025-07-08,5250.25,rent,out,Counterparty_63,27728652.06,2025-05-28,2025-07-06
2025-07-08,2623.75,asset_sale,in,Counterparty_84,27731275.81,,
2025-07-08,305.44,asset_sale,in,Counterparty_20,27731581.25,,
2025-07-08,1036.03,T&E,out,Counterparty_44,27730545.22,2025-06-16,2025-07-15
2025-07-08,3833.89,marketing_spend,out,Counterparty_73,27726711.33,2025-05-25,2025-06-29
2025-07-08,748.91,payroll,out,Counterparty_10,27725962.42,2025-06-23,2025-07-20
2025-07-08,1827.32,loan_repayment,out,Counterparty_22,27724135.1,2025-05-29,2025-06-23
2025-07-08,8936.99,tax_payment,out,Counterparty_92,27715198.11,2025-06-07,2025-07-16
2025-07-08,955.77,asset_sale,in,Counterparty_26,27716153.88,,
2025-07-08,1502.18,utilities,out,Counterparty_83,27714651.7,2025-05-31,2025-07-05
2025-07-08,461.84,supplier_payment,out,Counterparty_15,27714189.86,2025-06-21,2025-07-16
2025-07-08,571.62,utilities,out,Counterparty_59,27713618.24,2025-05-28,2025-06-23
2025-07-08,239.36,rent,out,Counterparty_29,27713378.88,2025-06-14,2025-07-09
2025-07-08,1158.89,marketing_spend,out,Counterparty_92,27712219.99,2025-06-11,2025-07-08
2025-07-08,17207.54,investment_income,in,Counterparty_17,27729427.53,,
2025-07-08,706.41,investment_income,in,Counterparty_72,27730133.94,,
2025-07-08,525.82,supplier_payment,out,Counterparty_42,27729608.12,2025-05-25,2025-06-28
2025-07-08,22988.74,asset_sale,in,Counterparty_8,27752596.86,,
2025-07-08,765.8,customer_payment,in,Counterparty_67,27753362.66,,
2025-07-08,3773.2,refund,in,Counterparty_34,27757135.86,,
2025-07-08,16070.23,investment_income,in,Counterparty_48,27773206.09,,
2025-07-09,2409.25,utilities,out,Counterparty_76,27770796.84,2025-06-13,2025-07-20
2025-07-09,4047.98,customer_payment,in,Counterparty_50,27774844.82,,
2025-07-09,7068.16,investment_income,in,Counterparty_76,27781912.98,,
2025-07-09,4182.13,supplier_payment,out,Counterparty_47,27777730.85,2025-06-08,2025-07-13
2025-07-09,350.3,rent,out,Counterparty_66,27777380.55,2025-06-03,2025-07-02
2025-07-09,5124.26,marketing_spend,out,Counterparty_25,27772256.29,2025-06-20,2025-07-18
2025-07-09,10332.8,customer_payment,in,Counterparty_44,27782589.09,,
2025-07-09,91.49,payroll,out,Counterparty_79,27782497.6,2025-06-08,2025-07-03
2025-07-09,1956.07,software_subscription,out,Counterparty_38,27780541.53,2025-06-01,2025-07-09
2025-07-09,3608.9,software_subscription,out,Counterparty_36,27776932.63,2025-06-03,2025-07-06
2025-07-09,3699.58,utilities,out,Counterparty_31,27773233.05,2025-06-02,2025-07-02
2025-07-09,2225.83,T&E,out,Counterparty_93,27771007.22,2025-06-22,2025-07-27
2025-07-09,927.26,marketing_spend,out,Counterparty_10,27770079.96,2025-06-21,2025-07-24
2025-07-09,7455.99,software_subscription,out,Counterparty_50,27762623.97,2025-06-20,2025-07-25
2025-07-09,513.31,utilities,out,Counterparty_64,27762110.66,2025-06-04,2025-07-04
2025-07-09,14361.14,asset_sale,in,Counterparty_5,27776471.8,,
2025-07-09,270.14,software_subscription,out,Counterparty_60,27776201.66,2025-06-07,2025-07-12
2025-07-09,256.63,loan_repayment,out,Counterparty_37,27775945.03,2025-06-12,2025-07-08
2025-07-09,1073.44,T&E,out,Counterparty_51,27774871.59,2025-06-09,2025-07-07
2025-07-09,1386.35,T&E,out,Counterparty_31,27773485.24,2025-06-20,2025-07-22
2025-07-09,129.2,refund,in,Counterparty_59,27773614.44,,
2025-07-09,4586.73,asset_sale,in,Counterparty_77,27778201.17,,
2025-07-09,9355.19,software_subscription,out,Counterparty_49,27768845.98,2025-06-08,2025-07-12
2025-07-09,2265.11,credit,in,Counterparty_43,27771111.09,,
2025-07-09,2698.22,payroll,out,Counterparty_64,27768412.87,2025-06-08,2025-07-05
2025-07-09,47.36,utilities,out,Counterparty_34,27768365.51,2025-06-20,2025-07-21
2025-07-09,7840.38,credit,in,Counterparty_82,27776205.89,,
2025-07-09,3631.62,software_subscription,out,Counterparty_89,27772574.27,2025-06-11,2025-07-06
2025-07-09,1220.25,credit,in,Counterparty_36,27773794.52,,
2025-07-09,10147.27,investment_income,in,Counterparty_52,27783941.79,,
2025-07-09,3071.88,software_subscription,out,Counterparty_30,27780869.91,2025-06-01,2025-07-01
2025-07-09,12736.25,credit,in,Counterparty_73,27793606.16,,
2025-07-09,4262.07,refund,in,Counterparty_87,27797868.23,,
2025-07-09,476.4,payroll,out,Counterparty_69,27797391.83,2025-06-12,2025-07-14
2025-07-09,30.76,investment_income,in,Counterparty_49,27797422.59,,
2025-07-09,3141.97,investment_income,in,Counterparty_61,27800564.56,,
2025-07-09,3994.35,customer_payment,in,Counterparty_12,27804558.91,,
2025-07-09,3317.7,tax_payment,out,Counterparty_6,27801241.21,2025-06-01,2025-07-02
2025-07-09,1889.86,tax_payment,out,Counterparty_15,27799351.35,2025-06-04,2025-07-01
2025-07-09,2859.34,marketing_spend,out,Counterparty_59,27796492.01,2025-06-01,2025-07-06
2025-07-09,3986.98,marketing_spend,out,Counterparty_61,27792505.03,2025-06-08,2025-07-05
2025-07-09,1895.43,T&E,out,Counterparty_89,27790609.6,2025-06-16,2025-07-23
2025-07-09,3462.19,marketing_spend,out,Counterparty_38,27787147.41,2025-06-16,2025-07-22
2025-07-09,676.35,utilities,out,Counterparty_81,27786471.06,2025-06-19,2025-07-14
2025-07-09,3310.4,marketing_spend,out,Counterparty_54,27783160.66,2025-05-28,2025-07-04
2025-07-09,5291.22,refund,in,Counterparty_56,27788451.88,,
2025-07-09,6255.29,refund,in,Counterparty_30,27794707.17,,
2025-07-09,544.89,marketing_spend,out,Counterparty_31,27794162.28,2025-06-12,2025-07-21
2025-07-09,328.19,investment_income,in,Counterparty_54,27794490.47,,
2025-07-09,660.87,software_subscription,out,Counterparty_54,27793829.6,2025-06-08,2025-07-09
2025-07-09,598.25,supplier_payment,out,Counterparty_71,27793231.35,2025-06-15,2025-07-19
2025-07-09,2036.32,loan_repayment,out,Counterparty_92,27791195.03,2025-06-06,2025-07-15
2025-07-09,7355.13,asset_sale,in,Counterparty_8,27798550.16,,
2025-07-09,2281.83,utilities,out,Counterparty_88,27796268.33,2025-06-21,2025-07-25
2025-07-09,10189.84,marketing_spend,out,Counterparty_18,27786078.49,2025-05-26,2025-06-24
2025-07-09,4642.92,payroll,out,Counterparty_2,27781435.57,2025-06-12,2025-07-09
2025-07-09,5031.08,credit,in,Counterparty_7,27786466.65,,
2025-07-09,723.07,payroll,out,Counterparty_43,27785743.58,2025-06-04,2025-07-06
2025-07-09,6229.91,utilities,out,Counterparty_37,27779513.67,2025-05-27,2025-06-21
2025-07-09,3219.94,supplier_payment,out,Counterparty_26,27776293.73,2025-06-21,2025-07-22
2025-07-09,2474.82,tax_payment,out,Counterparty_21,27773818.91,2025-06-09,2025-07-08
2025-07-10,1813.46,investment_income,in,Counterparty_52,27775632.37,,
2025-07-10,369.91,supplier_payment,out,Counterparty_6,27775262.46,2025-06-16,2025-07-14
2025-07-10,8285.22,asset_sale,in,Counterparty_67,27783547.68,,
2025-07-10,6804.13,marketing_spend,out,Counterparty_86,27776743.55,2025-06-05,2025-07-13
2025-07-10,23380.61,customer_payment,in,Counterparty_94,27800124.16,,
2025-07-10,11588.76,asset_sale,in,Counterparty_14,27811712.92,,
2025-07-10,1715.74,payroll,out,Counterparty_2,27809997.18,2025-06-13,2025-07-15
2025-07-10,2202.61,customer_payment,in,Counterparty_40,27812199.79,,
2025-07-10,11333.33,credit,in,Counterparty_51,27823533.12,,
2025-07-10,3027.27,supplier_payment,out,Counterparty_43,27820505.85,2025-06-05,2025-07-09
2025-07-10,1324.24,loan_repayment,out,Counterparty_24,27819181.61,2025-06-03,2025-06-28
2025-07-10,93.76,marketing_spend,out,Counterparty_54,27819087.85,2025-05-30,2025-06-28
2025-07-10,63.74,customer_payment,in,Counterparty_14,27819151.59,,
2025-07-10,1965.74,asset_sale,in,Counterparty_1,27821117.33,,
2025-07-10,974.05,marketing_spend,out,Counterparty_95,27820143.28,2025-06-08,2025-07-15
2025-07-10,1062.24,T&E,out,Counterparty_86,27819081.04,2025-06-21,2025-07-28
2025-07-10,5363.48,T&E,out,Counterparty_2,27813717.56,2025-06-09,2025-07-05
2025-07-10,4922.3,asset_sale,in,Counterparty_41,27818639.86,,
2025-07-10,2635.22,T&E,out,Counterparty_37,27816004.64,2025-06-05,2025-07-11
2025-07-10,3214.94,marketing_spend,out,Counterparty_72,27812789.7,2025-06-05,2025-07-05
2025-07-10,3650.4,refund,in,Counterparty_55,27816440.1,,
2025-07-10,5580.3,rent,out,Counterparty_14,27810859.8,2025-06-12,2025-07-17
2025-07-10,83.72,supplier_payment,out,Counterparty_86,27810776.08,2025-06-24,2025-07-31
2025-07-10,880.46,tax_payment,out,Counterparty_90,27809895.62,2025-06-08,2025-07-05
2025-07-10,946.28,T&E,out,Counterparty_66,27808949.34,2025-06-20,2025-07-17
2025-07-10,4612.17,asset_sale,in,Counterparty_7,27813561.51,,
2025-07-10,524.07,loan_repayment,out,Counterparty_1,27813037.44,2025-06-05,2025-06-30
2025-07-10,1910.84,asset_sale,in,Counterparty_27,27814948.28,,
2025-07-10,1616.11,payroll,out,Counterparty_57,27813332.17,2025-06-22,2025-07-31
2025-07-10,3709.3,software_subscription,out,Counterparty_82,27809622.87,2025-06-03,2025-07-01
2025-07-10,1110.43,supplier_payment,out,Counterparty_1,27808512.44,2025-06-09,2025-07-13
2025-07-10,715.84,supplier_payment,out,Counterparty_38,27807796.6,2025-06-14,2025-07-12
2025-07-10,597.08,payroll,out,Counterparty_87,27807199.52,2025-06-05,2025-07-11
2025-07-10,1238.38,payroll,out,Counterparty_40,27805961.14,2025-06-12,2025-07-20
2025-07-10,2003.75,investment_income,in,Counterparty_85,27807964.89,,
2025-07-10,807.57,marketing_spend,out,Counterparty_23,27807157.32,2025-06-10,2025-07-06
2025-07-10,2323.7,rent,out,Counterparty_97,27804833.62,2025-06-06,2025-07-01
2025-07-10,10173.39,refund,in,Counterparty_13,27815007.01,,
2025-07-10,3930.81,T&E,out,Counterparty_15,27811076.2,2025-06-03,2025-06-29
2025-07-10,789.16,customer_payment,in,Counterparty_36,27811865.36,,
2025-07-10,332.58,marketing_spend,out,Counterparty_10,27811532.78,2025-06-21,2025-07-25
2025-07-10,422.12,supplier_payment,out,Counterparty_53,27811110.66,2025-06-01,2025-07-08
2025-07-10,8117.93,asset_sale,in,Counterparty_32,27819228.59,,
2025-07-10,2721.1,software_subscription,out,Counterparty_80,27816507.49,2025-06-17,2025-07-23
2025-07-10,2911.52,supplier_payment,out,Counterparty_10,27813595.97,2025-06-07,2025-07-06
2025-07-10,1247.68,loan_repayment,out,Counterparty_93,27812348.29,2025-06-05,2025-07-02
2025-07-10,2263.46,credit,in,Counterparty_5,27814611.75,,
2025-07-10,1859.56,customer_payment,in,Counterparty_77,27816471.31,,
2025-07-10,10099.2,investment_income,in,Counterparty_41,27826570.51,,
2025-07-10,2954.03,loan_repayment,out,Counterparty_26,27823616.48,2025-06-04,2025-07-08
2025-07-10,1186.29,marketing_spend,out,Counterparty_41,27822430.19,2025-06-22,2025-07-29
2025-07-10,2.1,rent,out,Counterparty_2,27822428.09,2025-06-14,2025-07-17
2025-07-10,2091.94,marketing_spend,out,Counterparty_50,27820336.15,2025-05-31,2025-07-08
2025-07-10,9852.79,customer_payment,in,Counterparty_83,27830188.94,,
2025-07-11,1931.14,refund,in,Counterparty_91,27832120.08,,
2025-07-11,1724.54,investment_income,in,Counterparty_35,27833844.62,,
2025-07-11,6951.06,utilities,out,Counterparty_4,27826893.56,2025-06-10,2025-07-11
2025-07-11,119.85,tax_payment,out,Counterparty_23,27826773.71,2025-05-30,2025-07-08
2025-07-11,543.86,payroll,out,Counterparty_25,27826229.85,2025-06-17,2025-07-21
2025-07-11,6973.93,investment_income,in,Counterparty_6,27833203.78,,
2025-07-11,9220.23,investment_income,in,Counterparty_63,27842424.01,,
2025-07-11,1201.18,T&E,out,Counterparty_89,27841222.83,2025-05-31,2025-07-04
2025-07-11,6920.21,T&E,out,Counterparty_86,27834302.62,2025-06-05,2025-07-12
2025-07-11,2880.94,T&E,out,Counterparty_14,27831421.68,2025-06-08,2025-07-11
2025-07-11,334.95,utilities,out,Counterparty_38,27831086.73,2025-06-12,2025-07-17
2025-07-11,1211.8,supplier_payment,out,Counterparty_17,27829874.93,2025-06-05,2025-07-06
2025-07-11,751.98,loan_repayment,out,Counterparty_37,27829122.95,2025-05-30,2025-06-27
2025-07-11,221.83,tax_payment,out,Counterparty_16,27828901.12,2025-06-11,2025-07-08
2025-07-11,10652.93,asset_sale,in,Counterparty_80,27839554.05,,
2025-07-11,1413.22,customer_payment,in,Counterparty_96,27840967.27,,
2025-07-11,8334.2,investment_income,in,Counterparty_44,27849301.47,,
2025-07-11,3417.12,customer_payment,in,Counterparty_47,27852718.59,,
2025-07-11,4353.95,software_subscription,out,Counterparty_40,27848364.64,2025-06-21,2025-07-16
2025-07-11,1195.02,tax_payment,out,Counterparty_20,27847169.62,2025-06-03,2025-07-01
2025-07-11,13340.58,asset_sale,in,Counterparty_13,27860510.2,,
2025-07-11,7677.63,asset_sale,in,Counterparty_91,27868187.83,,
2025-07-11,660.73,credit,in,Counterparty_25,27868848.56,,
2025-07-11,1544.45,refund,in,Counterparty_1,27870393.01,,
2025-07-11,2113.19,software_subscription,out,Counterparty_19,27868279.82,2025-06-04,2025-06-29
2025-07-11,4936.7,T&E,out,Counterparty_13,27863343.12,2025-06-22,2025-07-17
2025-07-11,1114.18,T&E,out,Counterparty_1,27862228.94,2025-06-13,2025-07-19
2025-07-11,1489.32,customer_payment,in,Counterparty_50,27863718.26,,
2025-07-11,22298.79,customer_payment,in,Counterparty_99,27886017.05,,
2025-07-11,2145.19,loan_repayment,out,Counterparty_39,27883871.86,2025-06-05,2025-07-04
2025-07-11,8276.59,asset_sale,in,Counterparty_7,27892148.45,,
2025-07-11,775.56,asset_sale,in,Counterparty_92,27892924.01,,
2025-07-11,6568.44,tax_payment,out,Counterparty_13,27886355.57,2025-06-26,2025-07-23
2025-07-11,4050.19,investment_income,in,Counterparty_74,27890405.76,,
2025-07-11,7613.31,credit,in,Counterparty_87,27898019.07,,
2025-07-11,1062.42,rent,out,Counterparty_86,27896956.65,2025-06-15,2025-07-12
2025-07-11,8352.36,customer_payment,in,Counterparty_74,27905309.01,,
2025-07-11,368.84,asset_sale,in,Counterparty_37,27905677.85,,
2025-07-11,2890.89,investment_income,in,Counterparty_32,27908568.74,,
2025-07-11,8988.8,credit,in,Counterparty_38,27917557.54,,
2025-07-11,474.01,refund,in,Counterparty_21,27918031.55,,
2025-07-11,5934.37,refund,in,Counterparty_23,27923965.92,,
2025-07-11,1129.16,investment_income,in,Counterparty_41,27925095.08,,
2025-07-11,1039.36,software_subscription,out,Counterparty_52,27924055.72,2025-06-13,2025-07-10
2025-07-11,4480.05,payroll,out,Counterparty_30,27919575.67,2025-06-21,2025-07-26
2025-07-11,2706.82,customer_payment,in,Counterparty_55,27922282.49,,
2025-07-12,2620.46,software_subscription,out,Counterparty_93,27919662.03,2025-06-05,2025-07-13
2025-07-12,3173.69,investment_income,in,Counterparty_92,27922835.72,,
2025-07-12,3240.18,payroll,out,Counterparty_28,27919595.54,2025-06-15,2025-07-10
2025-07-12,13413.91,investment_income,in,Counterparty_3,27933009.45,,
2025-07-12,643.56,supplier_payment,out,Counterparty_8,27932365.89,2025-06-01,2025-06-28
2025-07-12,1141.22,rent,out,Counterparty_33,27931224.67,2025-06-12,2025-07-09
2025-07-12,4770.48,investment_income,in,Counterparty_78,27935995.15,,
2025-07-12,1910.32,loan_repayment,out,Counterparty_98,27934084.83,2025-06-17,2025-07-22
2025-07-12,1357.68,asset_sale,in,Counterparty_2,27935442.51,,
2025-07-12,34.59,rent,out,Counterparty_19,27935407.92,2025-05-31,2025-06-28
2025-07-12,1292.26,utilities,out,Counterparty_97,27934115.66,2025-06-12,2025-07-15
2025-07-12,1935.22,loan_repayment,out,Counterparty_12,27932180.44,2025-06-03,2025-07-03
2025-07-12,1146.99,software_subscription,out,Counterparty_62,27931033.45,2025-06-23,2025-07-27
2025-07-12,4079.58,customer_payment,in,Counterparty_41,27935113.03,,
2025-07-12,1586.81,software_subscription,out,Counterparty_76,27933526.22,2025-06-13,2025-07-11
2025-07-12,2443.38,marketing_spend,out,Counterparty_56,27931082.84,2025-06-23,2025-07-20
2025-07-12,347.06,rent,out,Counterparty_96,27930735.78,2025-06-10,2025-07-17
2025-07-12,5272.89,rent,out,Counterparty_29,27925462.89,2025-06-10,2025-07-17
2025-07-12,6623.08,T&E,out,Counterparty_94,27918839.81,2025-06-17,2025-07-24
2025-07-12,1596.56,tax_payment,out,Counterparty_47,27917243.25,2025-06-24,2025-07-19
2025-07-12,6701.25,asset_sale,in,Counterparty_68,27923944.5,,
2025-07-12,1456.19,software_subscription,out,Counterparty_61,27922488.31,2025-06-22,2025-07-30
2025-07-12,231.85,utilities,out,Counterparty_92,27922256.46,2025-06-13,2025-07-19
2025-07-12,638.81,supplier_payment,out,Counterparty_88,27921617.65,2025-06-24,2025-07-21
2025-07-12,4114.87,investment_income,in,Counterparty_9,27925732.52,,
2025-07-12,15498.24,asset_sale,in,Counterparty_89,27941230.76,,
2025-07-12,4738.92,supplier_payment,out,Counterparty_47,27936491.84,2025-06-24,2025-08-01
2025-07-12,5432.45,investment_income,in,Counterparty_2,27941924.29,,
2025-07-12,1650.41,supplier_payment,out,Counterparty_92,27940273.88,2025-06-20,2025-07-25
2025-07-12,2871.08,T&E,out,Counterparty_75,27937402.8,2025-06-08,2025-07-15
2025-07-12,36.56,T&E,out,Counterparty_10,27937366.24,2025-06-22,2025-07-18
2025-07-12,6158.59,investment_income,in,Counterparty_62,27943524.83,,
2025-07-12,614.99,payroll,out,Counterparty_78,27942909.84,2025-06-02,2025-07-09
2025-07-12,761.45,investment_income,in,Counterparty_59,27943671.29,,
2025-07-12,755.06,marketing_spend,out,Counterparty_18,27942916.23,2025-06-09,2025-07-16
2025-07-12,6451.46,supplier_payment,out,Counterparty_16,27936464.77,2025-06-11,2025-07-14
2025-07-12,2015.06,refund,in,Counterparty_84,27938479.83,,
2025-07-12,4330.83,payroll,out,Counterparty_24,27934149.0,2025-06-09,2025-07-09
2025-07-12,1311.73,marketing_spend,out,Counterparty_38,27932837.27,2025-06-06,2025-07-04
2025-07-12,3689.76,customer_payment,in,Counterparty_45,27936527.03,,
2025-07-12,4691.15,customer_payment,in,Counterparty_22,27941218.18,,
2025-07-12,6071.36,credit,in,Counterparty_27,27947289.54,,
2025-07-12,1032.13,refund,in,Counterparty_28,27948321.67,,
2025-07-13,595.76,tax_payment,out,Counterparty_18,27947725.91,2025-06-02,2025-07-10
2025-07-13,51.34,asset_sale,in,Counterparty_81,27947777.25,,
2025-07-13,6880.31,refund,in,Counterparty_22,27954657.56,,
2025-07-13,4998.51,credit,in,Counterparty_26,27959656.07,,
2025-07-13,25702.88,investment_income,in,Counterparty_19,27985358.95,,
2025-07-13,18442.01,customer_payment,in,Counterparty_93,28003800.96,,
2025-07-13,5030.7,payroll,out,Counterparty_85,27998770.26,2025-06-14,2025-07-15
2025-07-13,3825.05,software_subscription,out,Counterparty_55,27994945.21,2025-06-02,2025-07-01
2025-07-13,128.85,asset_sale,in,Counterparty_3,27995074.06,,
2025-07-13,4436.99,customer_payment,in,Counterparty_16,27999511.05,,
2025-07-13,365.97,marketing_spend,out,Counterparty_42,27999145.08,2025-06-04,2025-07-09
2025-07-13,556.93,marketing_spend,out,Counterparty_81,27998588.15,2025-06-03,2025-07-10
2025-07-13,599.78,marketing_spend,out,Counterparty_57,27997988.37,2025-06-20,2025-07-17
2025-07-13,41.25,rent,out,Counterparty_27,27997947.12,2025-06-15,2025-07-14
2025-07-13,1492.77,payroll,out,Counterparty_84,27996454.35,2025-06-11,2025-07-06
2025-07-13,3885.34,customer_payment,in,Counterparty_28,28000339.69,,
2025-07-13,718.12,investment_income,in,Counterparty_81,28001057.81,,
2025-07-13,4968.75,customer_payment,in,Counterparty_19,28006026.56,,
2025-07-13,2843.56,asset_sale,in,Counterparty_42,28008870.12,,
2025-07-13,2152.65,supplier_payment,out,Counterparty_69,28006717.47,2025-06-15,2025-07-18
2025-07-13,1913.93,investment_income,in,Counterparty_48,28008631.4,,
2025-07-13,12481.45,customer_payment,in,Counterparty_41,28021112.85,,
2025-07-13,2899.33,payroll,out,Counterparty_11,28018213.52,2025-06-09,2025-07-17
2025-07-13,1567.57,software_subscription,out,Counterparty_19,28016645.95,2025-06-20,2025-07-20
2025-07-13,2257.68,supplier_payment,out,Counterparty_88,28014388.27,2025-06-12,2025-07-17
2025-07-13,15928.34,marketing_spend,out,Counterparty_8,27998459.93,2025-06-21,2025-07-18
2025-07-13,2882.39,payroll,out,Counterparty_39,27995577.54,2025-06-26,2025-08-02
2025-07-13,9453.83,credit,in,Counterparty_31,28005031.37,,
2025-07-13,53.96,investment_income,in,Counterparty_31,28005085.33,,
2025-07-13,3693.84,asset_sale,in,Counterparty_86,28008779.17,,
2025-07-13,4103.94,software_subscription,out,Counterparty_90,28004675.23,2025-05-30,2025-06-26
2025-07-13,13447.25,refund,in,Counterparty_70,28018122.48,,
2025-07-13,3850.89,investment_income,in,Counterparty_95,28021973.37,,
2025-07-13,4730.08,customer_payment,in,Counterparty_55,28026703.45,,
2025-07-13,1259.06,loan_repayment,out,Counterparty_84,28025444.39,2025-06-22,2025-07-24
2025-07-13,52.02,credit,in,Counterparty_6,28025496.41,,
2025-07-13,3300.58,credit,in,Counterparty_34,28028796.99,,
2025-07-13,383.01,loan_repayment,out,Counterparty_7,28028413.98,2025-06-24,2025-08-01
2025-07-13,130.48,tax_payment,out,Counterparty_16,28028283.5,2025-06-09,2025-07-08
2025-07-13,2949.31,credit,in,Counterparty_32,28031232.81,,
2025-07-13,836.09,marketing_spend,out,Counterparty_38,28030396.72,2025-06-09,2025-07-08
2025-07-13,2770.23,asset_sale,in,Counterparty_92,28033166.95,,
2025-07-14,4384.48,utilities,out,Counterparty_31,28028782.47,2025-06-27,2025-07-29
2025-07-14,907.47,investment_income,in,Counterparty_44,28029689.94,,
2025-07-14,2931.51,loan_repayment,out,Counterparty_64,28026758.43,2025-06-26,2025-07-24
2025-07-14,1451.35,utilities,out,Counterparty_10,28025307.08,2025-06-23,2025-07-18
2025-07-14,6252.91,payroll,out,Counterparty_71,28019054.17,2025-06-01,2025-07-10
2025-07-14,1124.1,T&E,out,Counterparty_11,28017930.07,2025-06-22,2025-07-21
2025-07-14,378.02,asset_sale,in,Counterparty_23,28018308.09,,
2025-07-14,1011.05,rent,out,Counterparty_6,28017297.04,2025-06-25,2025-07-29
2025-07-14,1262.17,T&E,out,Counterparty_66,28016034.87,2025-06-10,2025-07-16
2025-07-14,2039.98,payroll,out,Counterparty_55,28013994.89,2025-06-25,2025-07-26
2025-07-14,2280.36,software_subscription,out,Counterparty_69,28011714.53,2025-06-23,2025-07-24
2025-07-14,1718.13,refund,in,Counterparty_88,28013432.66,,
2025-07-14,595.19,utilities,out,Counterparty_85,28012837.47,2025-05-31,2025-07-03
2025-07-14,230.84,asset_sale,in,Counterparty_54,28013068.31,,
2025-07-14,2148.73,loan_repayment,out,Counterparty_33,28010919.58,2025-06-23,2025-07-19
2025-07-14,1868.07,tax_payment,out,Counterparty_13,28009051.51,2025-06-14,2025-07-21
2025-07-14,1527.43,tax_payment,out,Counterparty_23,28007524.08,2025-06-25,2025-07-24
2025-07-14,4067.12,software_subscription,out,Counterparty_48,28003456.96,2025-06-20,2025-07-28
2025-07-14,547.36,T&E,out,Counterparty_97,28002909.6,2025-06-06,2025-07-06
2025-07-14,1438.96,supplier_payment,out,Counterparty_27,28001470.64,2025-06-15,2025-07-24
2025-07-14,2634.7,investment_income,in,Counterparty_90,28004105.34,,
2025-07-14,3419.39,utilities,out,Counterparty_39,28000685.95,2025-06-13,2025-07-20
2025-07-14,2636.48,credit,in,Counterparty_82,28003322.43,,
2025-07-14,1856.1,credit,in,Counterparty_25,28005178.53,,
2025-07-14,631.32,supplier_payment,out,Counterparty_14,28004547.21,2025-06-24,2025-07-31
2025-07-14,5385.14,refund,in,Counterparty_82,28009932.35,,
2025-07-14,519.73,rent,out,Counterparty_81,28009412.62,2025-05-31,2025-06-30
2025-07-14,178.5,investment_income,in,Counterparty_69,28009591.12,,
2025-07-14,2075.82,marketing_spend,out,Counterparty_24,28007515.3,2025-06-17,2025-07-12
2025-07-14,1984.22,customer_payment,in,Counterparty_11,28009499.52,,
2025-07-14,417.61,customer_payment,in,Counterparty_53,28009917.13,,
2025-07-14,3643.29,utilities,out,Counterparty_61,28006273.84,2025-06-23,2025-07-29
2025-07-14,400.94,loan_repayment,out,Counterparty_98,28005872.9,2025-06-02,2025-07-09
2025-07-14,5988.03,payroll,out,Counterparty_33,27999884.87,2025-05-31,2025-07-07
2025-07-14,2797.13,customer_payment,in,Counterparty_19,28002682.0,,
2025-07-14,129.9,loan_repayment,out,Counterparty_74,28002552.1,2025-06-14,2025-07-22
2025-07-14,1717.05,asset_sale,in,Counterparty_22,28004269.15,,
2025-07-14,597.79,loan_repayment,out,Counterparty_52,28003671.36,2025-06-05,2025-07-09
2025-07-14,7557.53,customer_payment,in,Counterparty_34,28011228.89,,
2025-07-14,285.9,utilities,out,Counterparty_32,28010942.99,2025-06-13,2025-07-20
2025-07-14,705.93,payroll,out,Counterparty_11,28010237.06,2025-06-25,2025-07-22
2025-07-14,1922.51,tax_payment,out,Counterparty_25,28008314.55,2025-06-27,2025-07-27
2025-07-14,5271.01,asset_sale,in,Counterparty_98,28013585.56,,
2025-07-14,616.78,rent,out,Counterparty_47,28012968.78,2025-06-29,2025-07-25
2025-07-14,1137.91,supplier_payment,out,Counterparty_64,28011830.87,2025-06-11,2025-07-11
2025-07-14,2779.81,rent,out,Counterparty_53,28009051.06,2025-06-08,2025-07-13
2025-07-14,3907.16,tax_payment,out,Counterparty_39,28005143.9,2025-06-22,2025-07-23
2025-07-14,400.73,rent,out,Counterparty_31,28004743.17,2025-06-11,2025-07-19
2025-07-14,2156.7,rent,out,Counterparty_47,28002586.47,2025-06-04,2025-06-29
2025-07-14,2110.3,refund,in,Counterparty_99,28004696.77,,
2025-07-14,642.17,investment_income,in,Counterparty_11,28005338.94,,
2025-07-14,593.41,credit,in,Counterparty_87,28005932.35,,
2025-07-14,2671.92,loan_repayment,out,Counterparty_37,28003260.43,2025-06-22,2025-07-23
2025-07-14,18475.72,customer_payment,in,Counterparty_24,28021736.15,,
2025-07-14,1023.68,investment_income,in,Counterparty_28,28022759.83,,
2025-07-14,2161.08,investment_income,in,Counterparty_26,28024920.91,,
2025-07-14,4707.93,refund,in,Counterparty_41,28029628.84,,
2025-07-14,809.22,tax_payment,out,Counterparty_9,28028819.62,2025-06-26,2025-07-28
2025-07-14,2213.16,credit,in,Counterparty_73,28031032.78,,
2025-07-14,4141.42,refund,in,Counterparty_84,28035174.2,,
2025-07-14,462.09,tax_payment,out,Counterparty_57,28034712.11,2025-06-04,2025-07-07
2025-07-14,894.11,tax_payment,out,Counterparty_47,28033818.0,2025-06-29,2025-07-27
2025-07-14,367.32,supplier_payment,out,Counterparty_78,28033450.68,2025-06-03,2025-07-11
2025-07-15,2926.94,marketing_spend,out,Counterparty_50,28030523.74,2025-06-20,2025-07-22
2025-07-15,347.69,T&E,out,Counterparty_77,28030176.05,2025-06-27,2025-07-26
2025-07-15,1616.88,software_subscription,out,Counterparty_99,28028559.17,2025-06-15,2025-07-16
2025-07-15,253.21,T&E,out,Counterparty_36,28028305.96,2025-06-09,2025-07-13
2025-07-15,6141.8,utilities,out,Counterparty_32,28022164.16,2025-06-11,2025-07-07
2025-07-15,2372.12,rent,out,Counterparty_92,28019792.04,2025-06-19,2025-07-27
2025-07-15,6536.45,tax_payment,out,Counterparty_39,28013255.59,2025-06-25,2025-07-21
2025-07-15,944.3,software_subscription,out,Counterparty_53,28012311.29,2025-06-13,2025-07-13
2025-07-15,5071.86,payroll,out,Counterparty_95,28007239.43,2025-06-11,2025-07-13
2025-07-15,3.07,software_subscription,out,Counterparty_92,28007236.36,2025-06-12,2025-07-19
2025-07-15,2540.14,software_subscription,out,Counterparty_25,28004696.22,2025-06-01,2025-07-07
2025-07-15,870.95,T&E,out,Counterparty_19,28003825.27,2025-06-13,2025-07-19
2025-07-15,5951.92,supplier_payment,out,Counterparty_49,27997873.35,2025-06-15,2025-07-14
2025-07-15,5067.26,utilities,out,Counterparty_55,27992806.09,2025-06-04,2025-07-04
2025-07-15,389.89,utilities,out,Counterparty_45,27992416.2,2025-06-17,2025-07-25
2025-07-15,3999.01,supplier_payment,out,Counterparty_15,27988417.19,2025-06-05,2025-07-04
2025-07-15,2015.08,T&E,out,Counterparty_27,27986402.11,2025-06-30,2025-07-25
2025-07-15,8047.98,tax_payment,out,Counterparty_81,27978354.13,2025-06-27,2025-07-28
2025-07-15,3770.91,payroll,out,Counterparty_62,27974583.22,2025-06-07,2025-07-16
2025-07-15,2666.57,supplier_payment,out,Counterparty_17,27971916.65,2025-06-09,2025-07-15
2025-07-15,6243.4,rent,out,Counterparty_4,27965673.25,2025-06-26,2025-07-26
2025-07-15,1220.06,T&E,out,Counterparty_38,27964453.19,2025-06-01,2025-06-30
2025-07-15,3356.3,T&E,out,Counterparty_14,27961096.89,2025-06-28,2025-08-02
2025-07-15,4418.97,T&E,out,Counterparty_12,27956677.92,2025-06-17,2025-07-17
2025-07-15,2604.94,T&E,out,Counterparty_98,27954072.98,2025-06-18,2025-07-24
2025-07-15,2859.42,rent,out,Counterparty_3,27951213.56,2025-06-21,2025-07-16
2025-07-15,1817.16,supplier_payment,out,Counterparty_62,27949396.4,2025-06-18,2025-07-19
2025-07-15,1595.95,T&E,out,Counterparty_90,27947800.45,2025-06-30,2025-08-05
2025-07-15,19.65,rent,out,Counterparty_64,27947780.8,2025-06-01,2025-06-29
2025-07-15,1464.35,utilities,out,Counterparty_46,27946316.45,2025-06-14,2025-07-19
2025-07-15,1358.29,software_subscription,out,Counterparty_88,27944958.16,2025-06-06,2025-07-07
2025-07-15,1071.07,tax_payment,out,Counterparty_21,27943887.09,2025-06-06,2025-07-07
2025-07-15,2892.95,software_subscription,out,Counterparty_70,27940994.14,2025-06-25,2025-07-26
2025-07-15,2884.36,rent,out,Counterparty_32,27938109.78,2025-06-12,2025-07-20
2025-07-15,6864.37,marketing_spend,out,Counterparty_12,27931245.41,2025-06-13,2025-07-21
2025-07-15,910.09,marketing_spend,out,Counterparty_40,27930335.32,2025-06-11,2025-07-15
2025-07-15,9830.69,customer_payment,in,Counterparty_74,27940166.01,,
2025-07-15,5039.3,credit,in,Counterparty_59,27945205.31,,
2025-07-15,91.85,customer_payment,in,Counterparty_16,27945297.16,,
2025-07-15,1935.51,refund,in,Counterparty_54,27947232.67,,
2025-07-15,2992.28,credit,in,Counterparty_70,27950224.95,,
2025-07-15,6606.71,supplier_payment,out,Counterparty_1,27943618.24,2025-06-23,2025-07-23
2025-07-15,6406.66,investment_income,in,Counterparty_29,27950024.9,,
2025-07-15,626.45,marketing_spend,out,Counterparty_10,27949398.45,2025-06-16,2025-07-16
2025-07-15,10830.55,customer_payment,in,Counterparty_63,27960229.0,,
2025-07-15,1886.37,customer_payment,in,Counterparty_66,27962115.37,,
2025-07-15,9070.6,customer_payment,in,Counterparty_95,27971185.97,,
2025-07-15,6558.57,investment_income,in,Counterparty_47,27977744.54,,
2025-07-15,390.92,asset_sale,in,Counterparty_85,27978135.46,,
2025-07-15,2631.44,customer_payment,in,Counterparty_54,27980766.9,,
2025-07-15,2905.1,refund,in,Counterparty_54,27983672.0,,
2025-07-15,894.39,asset_sale,in,Counterparty_60,27984566.39,,
2025-07-15,3972.64,asset_sale,in,Counterparty_85,27988539.03,,
2025-07-15,3785.23,credit,in,Counterparty_99,27992324.26,,
2025-07-15,2598.33,credit,in,Counterparty_47,27994922.59,,
2025-07-15,1154.08,customer_payment,in,Counterparty_33,27996076.67,,
2025-07-15,226.0,investment_income,in,Counterparty_55,27996302.67,,
2025-07-15,20015.99,asset_sale,in,Counterparty_93,28016318.66,,
2025-07-15,569.12,customer_payment,in,Counterparty_37,28016887.78,,
2025-07-15,12118.46,asset_sale,in,Counterparty_42,28029006.24,,
2025-07-15,2199.12,investment_income,in,Counterparty_6,28031205.36,,
2025-07-15,1992.8,refund,in,Counterparty_92,28033198.16,,
2025-07-15,6149.75,investment_income,in,Counterparty_47,28039347.91,,
2025-07-15,140.47,credit,in,Counterparty_71,28039488.38,,
2025-07-15,3335.77,asset_sale,in,Counterparty_4,28042824.15,,
2025-07-15,2640.86,investment_income,in,Counterparty_72,28045465.01,,
2025-07-16,1012.94,loan_repayment,out,Counterparty_56,28044452.07,2025-06-13,2025-07-15
2025-07-16,4178.8,asset_sale,in,Counterparty_82,28048630.87,,
2025-07-16,7102.34,investment_income,in,Counterparty_70,28055733.21,,
2025-07-16,2226.85,marketing_spend,out,Counterparty_40,28053506.36,2025-06-08,2025-07-10
2025-07-16,8512.55,credit,in,Counterparty_99,28062018.91,,
2025-07-16,114.04,payroll,out,Counterparty_24,28061904.87,2025-06-23,2025-07-26
2025-07-16,9645.56,investment_income,in,Counterparty_23,28071550.43,,
2025-07-16,624.64,loan_repayment,out,Counterparty_31,28070925.79,2025-06-07,2025-07-11
2025-07-16,3.4,supplier_payment,out,Counterparty_39,28070922.39,2025-06-30,2025-07-31
2025-07-16,317.51,software_subscription,out,Counterparty_36,28070604.88,2025-06-25,2025-07-27
2025-07-16,310.77,loan_repayment,out,Counterparty_46,28070294.11,2025-06-12,2025-07-13
2025-07-16,2134.31,asset_sale,in,Counterparty_70,28072428.42,,
2025-07-16,2002.29,utilities,out,Counterparty_76,28070426.13,2025-06-26,2025-07-24
2025-07-16,545.11,T&E,out,Counterparty_76,28069881.02,2025-06-04,2025-07-03
2025-07-16,1684.87,loan_repayment,out,Counterparty_7,28068196.15,2025-06-30,2025-08-04
2025-07-16,6307.04,customer_payment,in,Counterparty_79,28074503.19,,
2025-07-16,4404.65,software_subscription,out,Counterparty_62,28070098.54,2025-06-30,2025-08-01
2025-07-16,3884.33,investment_income,in,Counterparty_67,28073982.87,,
2025-07-16,4762.69,supplier_payment,out,Counterparty_25,28069220.18,2025-06-09,2025-07-06
2025-07-16,4688.45,credit,in,Counterparty_50,28073908.63,,
2025-07-16,5524.19,customer_payment,in,Counterparty_67,28079432.82,,
2025-07-16,3191.06,T&E,out,Counterparty_82,28076241.76,2025-06-30,2025-07-28
2025-07-16,1325.13,credit,in,Counterparty_96,28077566.89,,
2025-07-16,1846.58,refund,in,Counterparty_85,28079413.47,,
2025-07-16,458.55,asset_sale,in,Counterparty_26,28079872.02,,
2025-07-16,2103.87,rent,out,Counterparty_97,28077768.15,2025-06-26,2025-08-01
2025-07-16,1901.44,loan_repayment,out,Counterparty_87,28075866.71,2025-06-11,2025-07-06
2025-07-16,2688.05,payroll,out,Counterparty_37,28073178.66,2025-06-17,2025-07-22
2025-07-16,200.48,asset_sale,in,Counterparty_76,28073379.14,,
2025-07-16,630.66,credit,in,Counterparty_85,28074009.8,,
2025-07-16,5602.03,tax_payment,out,Counterparty_74,28068407.77,2025-06-14,2025-07-09
2025-07-16,2487.5,payroll,out,Counterparty_22,28065920.27,2025-06-08,2025-07-09
2025-07-16,63.96,software_subscription,out,Counterparty_25,28065856.31,2025-06-13,2025-07-22
2025-07-16,1636.0,marketing_spend,out,Counterparty_16,28064220.31,2025-06-25,2025-07-30
2025-07-16,148.04,investment_income,in,Counterparty_35,28064368.35,,
2025-07-16,633.98,T&E,out,Counterparty_2,28063734.37,2025-06-16,2025-07-19
2025-07-16,368.04,credit,in,Counterparty_1,28064102.41,,
2025-07-16,7018.7,credit,in,Counterparty_68,28071121.11,,
2025-07-16,134.49,investment_income,in,Counterparty_93,28071255.6,,
2025-07-16,1538.35,supplier_payment,out,Counterparty_98,28069717.25,2025-06-09,2025-07-06
2025-07-16,125.98,payroll,out,Counterparty_5,28069591.27,2025-06-07,2025-07-15
2025-07-16,299.26,software_subscription,out,Counterparty_99,28069292.01,2025-06-04,2025-07-10
2025-07-16,2077.51,marketing_spend,out,Counterparty_79,28067214.5,2025-06-26,2025-08-02
2025-07-16,7592.04,investment_income,in,Counterparty_59,28074806.54,,
2025-07-16,643.32,T&E,out,Counterparty_97,28074163.22,2025-06-26,2025-07-29
2025-07-16,3822.88,supplier_payment,out,Counterparty_37,28070340.34,2025-06-30,2025-07-26
2025-07-16,2618.77,credit,in,Counterparty_96,28072959.11,,
2025-07-17,2847.12,payroll,out,Counterparty_30,28070111.99,2025-06-16,2025-07-12
2025-07-17,502.74,supplier_payment,out,Counterparty_97,28069609.25,2025-06-08,2025-07-13
2025-07-17,8548.04,supplier_payment,out,Counterparty_31,28061061.21,2025-06-11,2025-07-18
2025-07-17,4217.23,asset_sale,in,Counterparty_40,28065278.44,,
2025-07-17,3463.12,marketing_spend,out,Counterparty_57,28061815.32,2025-06-18,2025-07-21
2025-07-17,3221.73,refund,in,Counterparty_37,28065037.05,,
2025-07-17,2802.84,investment_income,in,Counterparty_79,28067839.89,,
2025-07-17,25965.16,credit,in,Counterparty_81,28093805.05,,
2025-07-17,2616.34,investment_income,in,Counterparty_86,28096421.39,,
2025-07-17,2023.56,asset_sale,in,Counterparty_53,28098444.95,,
2025-07-17,1778.32,credit,in,Counterparty_17,28100223.27,,
2025-07-17,19238.42,refund,in,Counterparty_62,28119461.69,,
2025-07-17,4309.74,credit,in,Counterparty_54,28123771.43,,
2025-07-17,8742.48,investment_income,in,Counterparty_73,28132513.91,,
2025-07-17,7129.87,supplier_payment,out,Counterparty_61,28125384.04,2025-06-27,2025-08-02
2025-07-17,6052.47,customer_payment,in,Counterparty_42,28131436.51,,
2025-07-17,2328.09,credit,in,Counterparty_67,28133764.6,,
2025-07-17,138.78,investment_income,in,Counterparty_87,28133903.38,,
2025-07-17,2417.05,credit,in,Counterparty_18,28136320.43,,
2025-07-17,686.03,investment_income,in,Counterparty_25,28137006.46,,
2025-07-17,995.48,supplier_payment,out,Counterparty_5,28136010.98,2025-06-18,2025-07-18
2025-07-17,1353.09,payroll,out,Counterparty_4,28134657.89,2025-06-20,2025-07-26
2025-07-17,1588.69,asset_sale,in,Counterparty_49,28136246.58,,
2025-07-17,687.38,software_subscription,out,Counterparty_2,28135559.2,2025-06-23,2025-07-25
2025-07-17,1818.14,credit,in,Counterparty_57,28137377.34,,
2025-07-17,7026.72,asset_sale,in,Counterparty_5,28144404.06,,
2025-07-17,3033.64,tax_payment,out,Counterparty_61,28141370.42,2025-06-10,2025-07-05
2025-07-17,5511.6,asset_sale,in,Counterparty_19,28146882.02,,
2025-07-17,4598.75,asset_sale,in,Counterparty_4,28151480.77,,
2025-07-17,2817.46,supplier_payment,out,Counterparty_46,28148663.31,2025-06-09,2025-07-13
2025-07-17,1994.33,customer_payment,in,Counterparty_13,28150657.64,,
2025-07-17,5529.32,credit,in,Counterparty_81,28156186.96,,
2025-07-17,527.75,credit,in,Counterparty_31,28156714.71,,
2025-07-17,6942.99,credit,in,Counterparty_12,28163657.7,,
2025-07-17,1729.46,asset_sale,in,Counterparty_35,28165387.16,,
2025-07-17,1342.18,refund,in,Counterparty_45,28166729.34,,
2025-07-17,9126.19,investment_income,in,Counterparty_47,28175855.53,,
2025-07-17,264.24,utilities,out,Counterparty_72,28175591.29,2025-06-22,2025-07-19
2025-07-17,2861.57,T&E,out,Counterparty_49,28172729.72,2025-06-18,2025-07-27
2025-07-17,18389.81,refund,in,Counterparty_22,28191119.53,,
2025-07-17,3084.4,payroll,out,Counterparty_44,28188035.13,2025-06-18,2025-07-24
2025-07-17,2856.12,customer_payment,in,Counterparty_42,28190891.25,,
2025-07-17,582.05,payroll,out,Counterparty_42,28190309.2,2025-06-18,2025-07-13
2025-07-17,4637.83,investment_income,in,Counterparty_98,28194947.03,,
2025-07-17,791.66,software_subscription,out,Counterparty_86,28194155.37,2025-06-05,2025-07-01
2025-07-17,4099.57,utilities,out,Counterparty_81,28190055.8,2025-06-29,2025-08-07
2025-07-17,1289.13,T&E,out,Counterparty_84,28188766.67,2025-06-29,2025-08-04
2025-07-17,2552.19,supplier_payment,out,Counterparty_53,28186214.48,2025-06-19,2025-07-16
2025-07-17,3287.28,asset_sale,in,Counterparty_93,28189501.76,,
2025-07-17,1538.81,loan_repayment,out,Counterparty_61,28187962.95,2025-06-05,2025-07-04
2025-07-17,542.52,rent,out,Counterparty_70,28187420.43,2025-06-26,2025-08-02
2025-07-17,2370.24,investment_income,in,Counterparty_13,28189790.67,,
2025-07-17,3000.71,marketing_spend,out,Counterparty_64,28186789.96,2025-06-08,2025-07-08
2025-07-17,5654.11,marketing_spend,out,Counterparty_84,28181135.85,2025-06-12,2025-07-20
2025-07-17,850.57,investment_income,in,Counterparty_52,28181986.42,,
2025-07-17,2016.32,software_subscription,out,Counterparty_10,28179970.1,2025-06-03,2025-07-11
2025-07-17,1877.6,marketing_spend,out,Counterparty_62,28178092.5,2025-07-02,2025-07-30
2025-07-17,1864.17,marketing_spend,out,Counterparty_53,28176228.33,2025-06-25,2025-07-24
2025-07-17,7565.78,software_subscription,out,Counterparty_37,28168662.55,2025-06-03,2025-06-28
2025-07-18,676.83,payroll,out,Counterparty_81,28167985.72,2025-06-16,2025-07-12
2025-07-18,2450.58,tax_payment,out,Counterparty_94,28165535.14,2025-06-04,2025-07-02
2025-07-18,521.68,rent,out,Counterparty_72,28165013.46,2025-07-01,2025-08-01
2025-07-18,6629.93,investment_income,in,Counterparty_22,28171643.39,,
2025-07-18,3386.7,software_subscription,out,Counterparty_94,28168256.69,2025-06-15,2025-07-15
2025-07-18,1667.22,investment_income,in,Counterparty_54,28169923.91,,
2025-07-18,2238.46,asset_sale,in,Counterparty_69,28172162.37,,
2025-07-18,2314.22,customer_payment,in,Counterparty_37,28174476.59,,
2025-07-18,3581.66,utilities,out,Counterparty_11,28170894.93,2025-06-20,2025-07-18
2025-07-18,1112.17,investment_income,in,Counterparty_89,28172007.1,,
2025-07-18,2235.4,payroll,out,Counterparty_12,28169771.7,2025-06-12,2025-07-14
2025-07-18,771.27,software_subscription,out,Counterparty_87,28169000.43,2025-06-15,2025-07-13
2025-07-18,1434.36,utilities,out,Counterparty_30,28167566.07,2025-06-13,2025-07-14
2025-07-18,1875.78,marketing_spend,out,Counterparty_42,28165690.29,2025-06-26,2025-08-03
2025-07-18,2542.5,supplier_payment,out,Counterparty_40,28163147.79,2025-06-27,2025-07-25
2025-07-18,1019.74,customer_payment,in,Counterparty_84,28164167.53,,
2025-07-18,1986.8,payroll,out,Counterparty_58,28162180.73,2025-06-07,2025-07-07
2025-07-18,1198.65,payroll,out,Counterparty_33,28160982.08,2025-06-20,2025-07-24
2025-07-18,2633.76,rent,out,Counterparty_43,28158348.32,2025-07-01,2025-08-05
2025-07-18,7559.74,software_subscription,out,Counterparty_7,28150788.58,2025-06-28,2025-08-03
2025-07-18,887.51,utilities,out,Counterparty_38,28149901.07,2025-06-15,2025-07-20
2025-07-18,4763.4,tax_payment,out,Counterparty_52,28145137.67,2025-06-05,2025-07-01
2025-07-18,1575.54,loan_repayment,out,Counterparty_73,28143562.13,2025-06-06,2025-07-05
2025-07-18,1093.21,loan_repayment,out,Counterparty_19,28142468.92,2025-06-14,2025-07-22
2025-07-18,922.33,credit,in,Counterparty_58,28143391.25,,
2025-07-18,7639.7,customer_payment,in,Counterparty_72,28151030.95,,
2025-07-18,2118.65,utilities,out,Counterparty_36,28148912.3,2025-06-26,2025-07-25
2025-07-18,987.04,marketing_spend,out,Counterparty_69,28147925.26,2025-06-27,2025-07-28
2025-07-18,105.12,asset_sale,in,Counterparty_17,28148030.38,,
2025-07-18,171.32,loan_repayment,out,Counterparty_14,28147859.06,2025-06-14,2025-07-15
2025-07-18,712.09,supplier_payment,out,Counterparty_57,28147146.97,2025-06-06,2025-07-03
2025-07-18,2836.39,loan_repayment,out,Counterparty_62,28144310.58,2025-06-07,2025-07-08
2025-07-18,6852.98,credit,in,Counterparty_18,28151163.56,,
2025-07-18,2407.18,marketing_spend,out,Counterparty_30,28148756.38,2025-06-11,2025-07-20
2025-07-18,8.53,loan_repayment,out,Counterparty_65,28148747.85,2025-06-29,2025-07-24
2025-07-18,1178.04,payroll,out,Counterparty_81,28147569.81,2025-06-07,2025-07-02
2025-07-18,530.97,marketing_spend,out,Counterparty_26,28147038.84,2025-06-05,2025-07-03
2025-07-18,3894.07,T&E,out,Counterparty_24,28143144.77,2025-06-29,2025-07-28
2025-07-18,640.2,marketing_spend,out,Counterparty_27,28142504.57,2025-06-25,2025-07-26
2025-07-18,6477.37,credit,in,Counterparty_71,28148981.94,,
2025-07-18,7139.4,payroll,out,Counterparty_14,28141842.54,2025-06-05,2025-07-03
2025-07-18,2892.28,utilities,out,Counterparty_66,28138950.26,2025-07-03,2025-08-01
2025-07-18,1685.83,refund,in,Counterparty_69,28140636.09,,
2025-07-18,118.17,payroll,out,Counterparty_62,28140517.92,2025-06-10,2025-07-12
2025-07-18,3132.51,supplier_payment,out,Counterparty_54,28137385.41,2025-07-03,2025-08-04
2025-07-18,4731.78,utilities,out,Counterparty_44,28132653.63,2025-06-04,2025-07-06
2025-07-18,269.92,utilities,out,Counterparty_16,28132383.71,2025-06-08,2025-07-06
2025-07-18,1085.13,credit,in,Counterparty_77,28133468.84,,
2025-07-18,3492.21,payroll,out,Counterparty_59,28129976.63,2025-06-06,2025-07-03
2025-07-18,3506.91,tax_payment,out,Counterparty_34,28126469.72,2025-06-20,2025-07-16
2025-07-18,7845.33,customer_payment,in,Counterparty_90,28134315.05,,
2025-07-18,2176.67,refund,in,Counterparty_98,28136491.72,,
2025-07-18,2904.69,T&E,out,Counterparty_91,28133587.03,2025-07-02,2025-07-30
2025-07-18,9042.71,rent,out,Counterparty_30,28124544.32,2025-06-27,2025-07-24
2025-07-18,2851.36,rent,out,Counterparty_43,28121692.96,2025-06-06,2025-07-13
2025-07-18,3711.9,payroll,out,Counterparty_71,28117981.06,2025-06-14,2025-07-23
2025-07-18,2165.36,credit,in,Counterparty_27,28120146.42,,
2025-07-18,191.1,customer_payment,in,Counterparty_43,28120337.52,,
2025-07-18,6214.67,credit,in,Counterparty_3,28126552.19,,
2025-07-19,7385.52,investment_income,in,Counterparty_40,28133937.71,,
2025-07-19,3494.91,refund,in,Counterparty_27,28137432.62,,
2025-07-19,169.17,customer_payment,in,Counterparty_32,28137601.79,,
2025-07-19,2456.51,rent,out,Counterparty_73,28135145.28,2025-06-07,2025-07-16
2025-07-19,2439.38,supplier_payment,out,Counterparty_30,28132705.9,2025-06-20,2025-07-29
2025-07-19,176.55,rent,out,Counterparty_70,28132529.35,2025-06-14,2025-07-18
2025-07-19,1424.15,marketing_spend,out,Counterparty_81,28131105.2,2025-06-16,2025-07-24
2025-07-19,5543.19,utilities,out,Counterparty_80,28125562.01,2025-06-18,2025-07-21
2025-07-19,2455.61,supplier_payment,out,Counterparty_19,28123106.4,2025-06-24,2025-07-19
2025-07-19,1357.94,customer_payment,in,Counterparty_71,28124464.34,,
2025-07-19,2030.14,marketing_spend,out,Counterparty_36,28122434.2,2025-06-15,2025-07-14
2025-07-19,1528.02,credit,in,Counterparty_40,28123962.22,,
2025-07-19,8658.22,customer_payment,in,Counterparty_20,28132620.44,,
2025-07-19,6527.33,credit,in,Counterparty_20,28139147.77,,
2025-07-19,698.44,utilities,out,Counterparty_79,28138449.33,2025-06-08,2025-07-03
2025-07-19,902.83,loan_repayment,out,Counterparty_96,28137546.5,2025-07-04,2025-08-08
2025-07-19,1789.86,payroll,out,Counterparty_49,28135756.64,2025-07-03,2025-08-05
2025-07-19,289.59,investment_income,in,Counterparty_58,28136046.23,,
2025-07-19,6506.11,customer_payment,in,Counterparty_89,28142552.34,,
2025-07-19,279.51,loan_repayment,out,Counterparty_63,28142272.83,2025-06-23,2025-07-21
2025-07-19,432.36,T&E,out,Counterparty_91,28141840.47,2025-06-27,2025-07-25
2025-07-19,1147.92,credit,in,Counterparty_86,28142988.39,,
2025-07-19,1669.33,refund,in,Counterparty_44,28144657.72,,
2025-07-19,953.11,rent,out,Counterparty_42,28143704.61,2025-06-13,2025-07-16
2025-07-19,1205.32,utilities,out,Counterparty_87,28142499.29,2025-06-28,2025-07-31
2025-07-19,5614.02,credit,in,Counterparty_29,28148113.31,,
2025-07-19,2028.31,utilities,out,Counterparty_31,28146085.0,2025-06-28,2025-07-25
2025-07-19,1712.43,tax_payment,out,Counterparty_76,28144372.57,2025-06-16,2025-07-14
2025-07-19,9087.24,refund,in,Counterparty_3,28153459.81,,
2025-07-19,6077.61,credit,in,Counterparty_67,28159537.42,,
2025-07-19,1652.44,T&E,out,Counterparty_1,28157884.98,2025-06-20,2025-07-20
2025-07-19,5234.74,tax_payment,out,Counterparty_37,28152650.24,2025-06-29,2025-07-25
2025-07-19,2483.51,payroll,out,Counterparty_18,28150166.73,2025-06-15,2025-07-22
2025-07-19,2067.02,credit,in,Counterparty_26,28152233.75,,
2025-07-19,1821.93,asset_sale,in,Counterparty_84,28154055.68,,
2025-07-19,1957.8,investment_income,in,Counterparty_5,28156013.48,,
2025-07-19,151.62,marketing_spend,out,Counterparty_66,28155861.86,2025-06-17,2025-07-20
2025-07-19,341.78,investment_income,in,Counterparty_83,28156203.64,,
2025-07-19,620.47,credit,in,Counterparty_24,28156824.11,,
2025-07-19,1955.68,rent,out,Counterparty_4,28154868.43,2025-07-04,2025-08-01
2025-07-19,948.81,asset_sale,in,Counterparty_60,28155817.24,,
2025-07-19,192.4,rent,out,Counterparty_92,28155624.84,2025-06-20,2025-07-29
2025-07-19,2054.28,investment_income,in,Counterparty_63,28157679.12,,
2025-07-19,667.31,software_subscription,out,Counterparty_92,28157011.81,2025-06-23,2025-07-23
2025-07-19,3923.85,payroll,out,Counterparty_71,28153087.96,2025-06-28,2025-08-02
2025-07-19,6938.94,loan_repayment,out,Counterparty_1,28146149.02,2025-06-29,2025-08-06
2025-07-19,512.35,utilities,out,Counterparty_23,28145636.67,2025-06-15,2025-07-17
2025-07-19,2663.58,credit,in,Counterparty_96,28148300.25,,
2025-07-19,1473.2,rent,out,Counterparty_77,28146827.05,2025-06-08,2025-07-17
2025-07-20,2512.38,customer_payment,in,Counterparty_4,28149339.43,,
2025-07-20,1380.34,T&E,out,Counterparty_90,28147959.09,2025-06-25,2025-07-23
2025-07-20,15.8,supplier_payment,out,Counterparty_65,28147943.29,2025-07-04,2025-08-07
2025-07-20,3457.63,investment_income,in,Counterparty_54,28151400.92,,
2025-07-20,114.95,utilities,out,Counterparty_97,28151285.97,2025-06-08,2025-07-14
2025-07-20,2816.02,marketing_spend,out,Counterparty_62,28148469.95,2025-06-29,2025-08-01
2025-07-20,7186.17,utilities,out,Counterparty_48,28141283.78,2025-06-22,2025-07-19
2025-07-20,13296.52,investment_income,in,Counterparty_27,28154580.3,,
2025-07-20,3023.57,software_subscription,out,Counterparty_44,28151556.73,2025-06-24,2025-07-21
2025-07-20,105.67,payroll,out,Counterparty_33,28151451.06,2025-06-21,2025-07-24
2025-07-20,1253.04,rent,out,Counterparty_72,28150198.02,2025-06-28,2025-07-24
2025-07-20,3445.7,utilities,out,Counterparty_96,28146752.32,2025-06-09,2025-07-07
2025-07-20,184.24,payroll,out,Counterparty_24,28146568.08,2025-07-05,2025-08-07
2025-07-20,3656.01,software_subscription,out,Counterparty_39,28142912.07,2025-06-27,2025-08-05
2025-07-20,993.61,credit,in,Counterparty_99,28143905.68,,
2025-07-20,568.38,payroll,out,Counterparty_83,28143337.3,2025-06-07,2025-07-09
2025-07-20,2835.0,customer_payment,in,Counterparty_44,28146172.3,,
2025-07-20,6295.9,T&E,out,Counterparty_84,28139876.4,2025-06-24,2025-07-19
2025-07-20,1273.32,loan_repayment,out,Counterparty_47,28138603.08,2025-06-26,2025-07-25
2025-07-20,576.76,rent,out,Counterparty_11,28138026.32,2025-06-24,2025-07-21
2025-07-20,1842.53,tax_payment,out,Counterparty_19,28136183.79,2025-06-18,2025-07-20
2025-07-20,2049.49,loan_repayment,out,Counterparty_99,28134134.3,2025-06-24,2025-07-29
2025-07-20,787.45,supplier_payment,out,Counterparty_34,28133346.85,2025-07-03,2025-08-05
2025-07-20,1264.76,marketing_spend,out,Counterparty_98,28132082.09,2025-06-09,2025-07-18
2025-07-20,728.61,software_subscription,out,Counterparty_2,28131353.48,2025-06-26,2025-07-31
2025-07-20,3605.92,investment_income,in,Counterparty_21,28134959.4,,
2025-07-20,5186.93,marketing_spend,out,Counterparty_54,28129772.47,2025-07-04,2025-08-07
2025-07-20,365.61,credit,in,Counterparty_67,28130138.08,,
2025-07-20,4246.27,customer_payment,in,Counterparty_23,28134384.35,,
2025-07-20,5665.73,investment_income,in,Counterparty_95,28140050.08,,
2025-07-20,3826.71,customer_payment,in,Counterparty_16,28143876.79,,
2025-07-20,6710.16,marketing_spend,out,Counterparty_91,28137166.63,2025-06-26,2025-07-21
2025-07-20,3479.53,investment_income,in,Counterparty_45,28140646.16,,
2025-07-20,1879.83,supplier_payment,out,Counterparty_56,28138766.33,2025-06-11,2025-07-15
2025-07-20,15386.11,credit,in,Counterparty_46,28154152.44,,
2025-07-20,1253.29,T&E,out,Counterparty_11,28152899.15,2025-06-19,2025-07-23
2025-07-20,12858.77,refund,in,Counterparty_93,28165757.92,,
2025-07-20,3076.17,investment_income,in,Counterparty_85,28168834.09,,
2025-07-20,3928.72,loan_repayment,out,Counterparty_3,28164905.37,2025-06-26,2025-07-30
2025-07-20,8361.95,rent,out,Counterparty_33,28156543.42,2025-06-27,2025-07-29
2025-07-20,463.56,investment_income,in,Counterparty_13,28157006.98,,
2025-07-20,5415.43,T&E,out,Counterparty_58,28151591.55,2025-06-23,2025-08-01
2025-07-20,5706.54,investment_income,in,Counterparty_77,28157298.09,,
2025-07-20,2364.81,tax_payment,out,Counterparty_7,28154933.28,2025-06-18,2025-07-15
2025-07-20,2870.6,customer_payment,in,Counterparty_15,28157803.88,,
2025-07-20,762.37,loan_repayment,out,Counterparty_32,28157041.51,2025-06-15,2025-07-18
2025-07-20,82.53,customer_payment,in,Counterparty_48,28157124.04,,
2025-07-20,3728.58,credit,in,Counterparty_41,28160852.62,,
2025-07-20,7947.22,refund,in,Counterparty_85,28168799.84,,
2025-07-21,580.62,credit,in,Counterparty_81,28169380.46,,
2025-07-21,599.39,customer_payment,in,Counterparty_12,28169979.85,,
2025-07-21,2333.84,customer_payment,in,Counterparty_59,28172313.69,,
2025-07-21,611.35,software_subscription,out,Counterparty_55,28171702.34,2025-07-02,2025-08-06
2025-07-21,4350.34,marketing_spend,out,Counterparty_70,28167352.0,2025-06-25,2025-07-22
2025-07-21,859.26,investment_income,in,Counterparty_49,28168211.26,,
2025-07-21,4242.29,credit,in,Counterparty_18,28172453.55,,
2025-07-21,693.63,investment_income,in,Counterparty_34,28173147.18,,
2025-07-21,916.88,tax_payment,out,Counterparty_40,28172230.3,2025-06-24,2025-07-24
2025-07-21,1210.76,credit,in,Counterparty_65,28173441.06,,
2025-07-21,1329.6,supplier_payment,out,Counterparty_51,28172111.46,2025-06-13,2025-07-17
2025-07-21,4568.33,credit,in,Counterparty_67,28176679.79,,
2025-07-21,644.82,tax_payment,out,Counterparty_77,28176034.97,2025-06-16,2025-07-15
2025-07-21,58.0,investment_income,in,Counterparty_41,28176092.97,,
2025-07-21,4692.1,utilities,out,Counterparty_37,28171400.87,2025-06-24,2025-07-28
2025-07-21,932.87,payroll,out,Counterparty_71,28170468.0,2025-06-29,2025-07-26
2025-07-21,4905.79,software_subscription,out,Counterparty_77,28165562.21,2025-06-08,2025-07-15
2025-07-21,2387.85,software_subscription,out,Counterparty_14,28163174.36,2025-06-24,2025-08-02
2025-07-21,7664.43,T&E,out,Counterparty_19,28155509.93,2025-06-19,2025-07-25
2025-07-21,1856.7,supplier_payment,out,Counterparty_70,28153653.23,2025-06-29,2025-08-05
2025-07-21,3502.13,loan_repayment,out,Counterparty_77,28150151.1,2025-06-14,2025-07-22
2025-07-21,7887.01,investment_income,in,Counterparty_85,28158038.11,,
2025-07-21,507.78,rent,out,Counterparty_53,28157530.33,2025-06-17,2025-07-13
2025-07-21,2644.69,utilities,out,Counterparty_38,28154885.64,2025-06-27,2025-07-23
2025-07-21,1961.42,utilities,out,Counterparty_6,28152924.22,2025-06-28,2025-07-30
2025-07-21,696.64,supplier_payment,out,Counterparty_42,28152227.58,2025-06-21,2025-07-28
2025-07-21,2873.86,asset_sale,in,Counterparty_66,28155101.44,,
2025-07-21,4059.37,T&E,out,Counterparty_24,28151042.07,2025-06-24,2025-08-01
2025-07-21,21430.97,investment_income,in,Counterparty_89,28172473.04,,
2025-07-21,4494.44,payroll,out,Counterparty_45,28167978.6,2025-06-21,2025-07-19
2025-07-21,2299.16,payroll,out,Counterparty_17,28165679.44,2025-06-24,2025-07-19
2025-07-21,1266.45,T&E,out,Counterparty_38,28164412.99,2025-07-01,2025-08-09
2025-07-21,15679.49,customer_payment,in,Counterparty_75,28180092.48,,
2025-07-21,215.07,loan_repayment,out,Counterparty_14,28179877.41,2025-06-23,2025-07-25
2025-07-21,391.24,utilities,out,Counterparty_82,28179486.17,2025-06-23,2025-07-31
2025-07-21,1230.51,loan_repayment,out,Counterparty_23,28178255.66,2025-06-22,2025-07-26
2025-07-21,2760.13,marketing_spend,out,Counterparty_85,28175495.53,2025-07-03,2025-08-07
2025-07-21,3965.36,utilities,out,Counterparty_93,28171530.17,2025-06-21,2025-07-28
2025-07-21,1344.54,tax_payment,out,Counterparty_68,28170185.63,2025-06-11,2025-07-13
2025-07-21,4220.0,T&E,out,Counterparty_42,28165965.63,2025-06-18,2025-07-14
2025-07-21,1057.44,marketing_spend,out,Counterparty_2,28164908.19,2025-06-30,2025-07-28
2025-07-21,351.1,customer_payment,in,Counterparty_26,28165259.29,,
2025-07-21,3328.06,supplier_payment,out,Counterparty_28,28161931.23,2025-07-06,2025-08-04
2025-07-21,1082.16,utilities,out,Counterparty_36,28160849.07,2025-06-28,2025-08-04
2025-07-21,847.17,supplier_payment,out,Counterparty_90,28160001.9,2025-06-13,2025-07-10
2025-07-22,10558.38,T&E,out,Counterparty_51,28149443.52,2025-07-02,2025-08-03
2025-07-22,3514.37,investment_income,in,Counterparty_92,28152957.89,,
2025-07-22,343.85,rent,out,Counterparty_61,28152614.04,2025-07-06,2025-08-05
2025-07-22,683.14,investment_income,in,Counterparty_86,28153297.18,,
2025-07-22,10721.41,investment_income,in,Counterparty_76,28164018.59,,
2025-07-22,1572.34,refund,in,Counterparty_14,28165590.93,,
2025-07-22,7432.65,credit,in,Counterparty_28,28173023.58,,
2025-07-22,967.36,payroll,out,Counterparty_82,28172056.22,2025-06-26,2025-07-26
2025-07-22,967.55,T&E,out,Counterparty_94,28171088.67,2025-06-10,2025-07-15
2025-07-22,427.64,loan_repayment,out,Counterparty_64,28170661.03,2025-06-22,2025-07-17
2025-07-22,7264.04,customer_payment,in,Counterparty_49,28177925.07,,
2025-07-22,7468.21,loan_repayment,out,Counterparty_15,28170456.86,2025-07-03,2025-08-06
2025-07-22,2415.2,software_subscription,out,Counterparty_87,28168041.66,2025-06-22,2025-07-27
2025-07-22,1122.98,customer_payment,in,Counterparty_88,28169164.64,,
2025-07-22,1580.61,asset_sale,in,Counterparty_4,28170745.25,,
2025-07-22,469.23,asset_sale,in,Counterparty_80,28171214.48,,
2025-07-22,3988.77,loan_repayment,out,Counterparty_87,28167225.71,2025-06-30,2025-08-06
2025-07-22,3799.49,refund,in,Counterparty_24,28171025.2,,
2025-07-22,743.22,rent,out,Counterparty_91,28170281.98,2025-07-06,2025-08-09
2025-07-22,8078.68,asset_sale,in,Counterparty_43,28178360.66,,
2025-07-22,265.34,tax_payment,out,Counterparty_31,28178095.32,2025-06-16,2025-07-17
2025-07-22,2127.23,payroll,out,Counterparty_62,28175968.09,2025-06-10,2025-07-16
2025-07-22,1411.39,marketing_spend,out,Counterparty_97,28174556.7,2025-06-22,2025-07-21
2025-07-22,126.33,tax_payment,out,Counterparty_74,28174430.37,2025-06-20,2025-07-21
2025-07-22,12058.92,investment_income,in,Counterparty_75,28186489.29,,
2025-07-22,4183.47,investment_income,in,Counterparty_98,28190672.76,,
2025-07-22,1096.16,marketing_spend,out,Counterparty_52,28189576.6,2025-06-27,2025-07-26
2025-07-22,512.18,software_subscription,out,Counterparty_8,28189064.42,2025-06-22,2025-07-23
2025-07-22,7417.92,asset_sale,in,Counterparty_58,28196482.34,,
2025-07-22,5027.37,payroll,out,Counterparty_60,28191454.97,2025-06-23,2025-07-23
2025-07-22,4709.33,credit,in,Counterparty_80,28196164.3,,
2025-07-22,383.59,payroll,out,Counterparty_44,28195780.71,2025-06-29,2025-08-06
2025-07-22,484.57,customer_payment,in,Counterparty_60,28196265.28,,
2025-07-22,8307.44,credit,in,Counterparty_59,28204572.72,,
2025-07-22,1030.64,T&E,out,Counterparty_43,28203542.08,2025-06-16,2025-07-20
2025-07-22,437.78,software_subscription,out,Counterparty_91,28203104.3,2025-07-06,2025-08-01
2025-07-22,356.19,refund,in,Counterparty_6,28203460.49,,
2025-07-22,13444.49,investment_income,in,Counterparty_67,28216904.98,,
2025-07-22,1968.51,investment_income,in,Counterparty_51,28218873.49,,
2025-07-22,5416.27,credit,in,Counterparty_16,28224289.76,,
2025-07-22,5376.72,refund,in,Counterparty_91,28229666.48,,
2025-07-22,1160.36,customer_payment,in,Counterparty_54,28230826.84,,
2025-07-22,170.84,software_subscription,out,Counterparty_56,28230656.0,2025-06-25,2025-08-01
2025-07-22,468.67,T&E,out,Counterparty_9,28230187.33,2025-06-25,2025-08-03
2025-07-22,5829.11,refund,in,Counterparty_67,28236016.44,,
2025-07-22,395.83,software_subscription,out,Counterparty_39,28235620.61,2025-06-18,2025-07-17
2025-07-22,146.38,utilities,out,Counterparty_75,28235474.23,2025-06-24,2025-07-20
2025-07-22,3605.6,marketing_spend,out,Counterparty_1,28231868.63,2025-06-25,2025-07-23
2025-07-22,478.8,marketing_spend,out,Counterparty_86,28231389.83,2025-06-26,2025-07-31
2025-07-22,2006.62,refund,in,Counterparty_73,28233396.45,,
2025-07-22,275.19,customer_payment,in,Counterparty_34,28233671.64,,
2025-07-22,2202.14,software_subscription,out,Counterparty_3,28231469.5,2025-07-02,2025-07-30
2025-07-23,4754.66,refund,in,Counterparty_75,28236224.16,,
2025-07-23,1305.28,rent,out,Counterparty_72,28234918.88,2025-07-04,2025-08-01
2025-07-23,590.03,tax_payment,out,Counterparty_11,28234328.85,2025-06-23,2025-07-18
2025-07-23,5876.87,utilities,out,Counterparty_2,28228451.98,2025-06-17,2025-07-14
2025-07-23,403.58,T&E,out,Counterparty_86,28228048.4,2025-06-13,2025-07-14
2025-07-23,584.56,refund,in,Counterparty_38,28228632.96,,
2025-07-23,2375.58,utilities,out,Counterparty_40,28226257.38,2025-06-29,2025-07-28
2025-07-23,3248.82,investment_income,in,Counterparty_46,28229506.2,,
2025-07-23,11741.4,customer_payment,in,Counterparty_8,28241247.6,,
2025-07-23,137.21,customer_payment,in,Counterparty_30,28241384.81,,
2025-07-23,1675.65,supplier_payment,out,Counterparty_47,28239709.16,2025-07-05,2025-08-10
2025-07-23,1794.48,customer_payment,in,Counterparty_35,28241503.64,,
2025-07-23,633.64,refund,in,Counterparty_42,28242137.28,,
2025-07-23,471.02,marketing_spend,out,Counterparty_82,28241666.26,2025-06-26,2025-07-24
2025-07-23,5675.93,investment_income,in,Counterparty_23,28247342.19,,
2025-07-23,1131.83,loan_repayment,out,Counterparty_97,28246210.36,2025-06-24,2025-07-31
2025-07-23,251.2,marketing_spend,out,Counterparty_27,28245959.16,2025-07-02,2025-08-08
2025-07-23,474.42,software_subscription,out,Counterparty_59,28245484.74,2025-06-19,2025-07-24
2025-07-23,1418.53,loan_repayment,out,Counterparty_20,28244066.21,2025-07-05,2025-08-09
2025-07-23,9507.46,asset_sale,in,Counterparty_78,28253573.67,,
2025-07-23,3863.03,T&E,out,Counterparty_77,28249710.64,2025-06-15,2025-07-22
2025-07-23,2098.34,credit,in,Counterparty_53,28251808.98,,
2025-07-23,1615.9,utilities,out,Counterparty_88,28250193.08,2025-06-15,2025-07-16
2025-07-23,1271.16,tax_payment,out,Counterparty_38,28248921.92,2025-06-15,2025-07-15
2025-07-23,9222.73,rent,out,Counterparty_66,28239699.19,2025-06-15,2025-07-11
2025-07-23,1204.75,T&E,out,Counterparty_74,28238494.44,2025-06-23,2025-07-26
2025-07-23,9758.95,customer_payment,in,Counterparty_13,28248253.39,,
2025-07-23,701.16,utilities,out,Counterparty_52,28247552.23,2025-06-24,2025-07-20
2025-07-23,221.51,T&E,out,Counterparty_53,28247330.72,2025-07-02,2025-08-09
2025-07-23,2206.2,marketing_spend,out,Counterparty_46,28245124.52,2025-06-26,2025-07-21
2025-07-23,197.13,payroll,out,Counterparty_30,28244927.39,2025-06-19,2025-07-15
2025-07-23,2784.06,marketing_spend,out,Counterparty_55,28242143.33,2025-07-04,2025-08-05
2025-07-23,265.23,payroll,out,Counterparty_26,28241878.1,2025-06-17,2025-07-18
2025-07-23,2119.56,software_subscription,out,Counterparty_92,28239758.54,2025-06-11,2025-07-18
2025-07-23,30902.17,refund,in,Counterparty_35,28270660.71,,
2025-07-23,864.31,refund,in,Counterparty_93,28271525.02,,
2025-07-23,1876.11,rent,out,Counterparty_36,28269648.91,2025-06-16,2025-07-14
2025-07-23,89.89,asset_sale,in,Counterparty_69,28269738.8,,
2025-07-23,831.84,supplier_payment,out,Counterparty_42,28268906.96,2025-06-23,2025-07-31
2025-07-23,2556.87,rent,out,Counterparty_85,28266350.09,2025-06-18,2025-07-19
2025-07-23,3039.28,software_subscription,out,Counterparty_4,28263310.81,2025-06-12,2025-07-14
2025-07-23,17259.58,customer_payment,in,Counterparty_94,28280570.39,,
2025-07-23,4058.5,customer_payment,in,Counterparty_50,28284628.89,,
2025-07-23,255.55,marketing_spend,out,Counterparty_61,28284373.34,2025-06-21,2025-07-25
2025-07-23,3969.71,customer_payment,in,Counterparty_53,28288343.05,,
2025-07-23,1536.36,loan_repayment,out,Counterparty_34,28286806.69,2025-06-11,2025-07-06
2025-07-23,391.53,rent,out,Counterparty_48,28286415.16,2025-06-20,2025-07-21
2025-07-23,462.71,T&E,out,Counterparty_12,28285952.45,2025-06-26,2025-08-03
2025-07-23,11797.01,marketing_spend,out,Counterparty_44,28274155.44,2025-07-03,2025-07-29
2025-07-23,3383.43,supplier_payment,out,Counterparty_11,28270772.01,2025-06-17,2025-07-20
2025-07-23,40.03,T&E,out,Counterparty_87,28270731.98,2025-06-16,2025-07-20
2025-07-23,1610.47,rent,out,Counterparty_29,28269121.51,2025-06-12,2025-07-21
2025-07-23,345.45,utilities,out,Counterparty_80,28268776.06,2025-06-30,2025-07-28
2025-07-23,2672.29,loan_repayment,out,Counterparty_49,28266103.77,2025-07-07,2025-08-08
2025-07-23,3172.11,rent,out,Counterparty_80,28262931.66,2025-07-08,2025-08-12
2025-07-23,85.07,software_subscription,out,Counterparty_32,28262846.59,2025-06-26,2025-07-23
2025-07-23,4099.49,investment_income,in,Counterparty_19,28266946.08,,
2025-07-23,22.18,investment_income,in,Counterparty_8,28266968.26,,
2025-07-23,3214.93,asset_sale,in,Counterparty_50,28270183.19,,
2025-07-23,2861.38,utilities,out,Counterparty_15,28267321.81,2025-06-12,2025-07-08
2025-07-23,1842.64,asset_sale,in,Counterparty_98,28269164.45,,
2025-07-24,162.31,utilities,out,Counterparty_8,28269002.14,2025-06-19,2025-07-23
2025-07-24,6615.24,credit,in,Counterparty_55,28275617.38,,
2025-07-24,2811.93,software_subscription,out,Counterparty_97,28272805.45,2025-06-19,2025-07-23
2025-07-24,1270.08,payroll,out,Counterparty_37,28271535.37,2025-06-16,2025-07-11
2025-07-24,4478.64,investment_income,in,Counterparty_82,28276014.01,,
2025-07-24,2432.21,loan_repayment,out,Counterparty_95,28273581.8,2025-06-28,2025-07-30
2025-07-24,1682.57,payroll,out,Counterparty_18,28271899.23,2025-06-29,2025-08-06
2025-07-24,221.92,investment_income,in,Counterparty_42,28272121.15,,
2025-07-24,3542.71,rent,out,Counterparty_60,28268578.44,2025-06-29,2025-07-26
2025-07-24,7909.38,asset_sale,in,Counterparty_90,28276487.82,,
2025-07-24,1687.5,marketing_spend,out,Counterparty_89,28274800.32,2025-07-04,2025-07-31
2025-07-24,1250.62,tax_payment,out,Counterparty_24,28273549.7,2025-06-17,2025-07-17
2025-07-24,422.09,T&E,out,Counterparty_17,28273127.61,2025-07-06,2025-07-31
2025-07-24,2022.7,refund,in,Counterparty_8,28275150.31,,
2025-07-24,2878.48,asset_sale,in,Counterparty_4,28278028.79,,
2025-07-24,9206.32,refund,in,Counterparty_52,28287235.11,,
2025-07-24,1552.74,investment_income,in,Counterparty_13,28288787.85,,
2025-07-24,2241.71,T&E,out,Counterparty_37,28286546.14,2025-06-10,2025-07-09
2025-07-24,387.25,payroll,out,Counterparty_81,28286158.89,2025-06-13,2025-07-16
2025-07-24,2155.48,software_subscription,out,Counterparty_22,28284003.41,2025-06-10,2025-07-12
2025-07-24,2394.06,tax_payment,out,Counterparty_16,28281609.35,2025-06-23,2025-07-20
2025-07-24,3570.38,software_subscription,out,Counterparty_17,28278038.97,2025-07-04,2025-07-31
2025-07-24,1892.42,credit,in,Counterparty_41,28279931.39,,
2025-07-24,4708.09,refund,in,Counterparty_74,28284639.48,,
2025-07-24,9288.58,credit,in,Counterparty_54,28293928.06,,
2025-07-24,3682.01,supplier_payment,out,Counterparty_52,28290246.05,2025-06-28,2025-07-26
2025-07-24,3525.03,tax_payment,out,Counterparty_88,28286721.02,2025-06-20,2025-07-15
2025-07-24,3749.85,supplier_payment,out,Counterparty_16,28282971.17,2025-06-14,2025-07-18
2025-07-24,4143.47,customer_payment,in,Counterparty_48,28287114.64,,
2025-07-24,814.04,loan_repayment,out,Counterparty_6,28286300.6,2025-06-19,2025-07-16
2025-07-24,1266.3,software_subscription,out,Counterparty_88,28285034.3,2025-06-27,2025-08-01
2025-07-24,1324.91,marketing_spend,out,Counterparty_83,28283709.39,2025-06-10,2025-07-12
2025-07-24,3056.22,T&E,out,Counterparty_96,28280653.17,2025-06-28,2025-08-06
2025-07-24,1316.83,payroll,out,Counterparty_81,28279336.34,2025-07-06,2025-08-02
2025-07-24,73.04,T&E,out,Counterparty_90,28279263.3,2025-06-11,2025-07-17
2025-07-24,4286.8,refund,in,Counterparty_41,28283550.1,,
2025-07-24,291.14,tax_payment,out,Counterparty_45,28283258.96,2025-06-23,2025-07-28
2025-07-24,1192.59,supplier_payment,out,Counterparty_95,28282066.37,2025-07-03,2025-07-31
2025-07-24,1355.12,tax_payment,out,Counterparty_1,28280711.25,2025-07-06,2025-08-14
2025-07-24,2891.78,supplier_payment,out,Counterparty_62,28277819.47,2025-06-10,2025-07-06
2025-07-24,4371.5,rent,out,Counterparty_16,28273447.97,2025-06-17,2025-07-16
2025-07-24,507.73,refund,in,Counterparty_94,28273955.7,,
2025-07-24,3670.62,investment_income,in,Counterparty_95,28277626.32,,
2025-07-24,707.63,rent,out,Counterparty_96,28276918.69,2025-07-02,2025-07-29
2025-07-24,3452.17,customer_payment,in,Counterparty_59,28280370.86,,
2025-07-24,11115.39,asset_sale,in,Counterparty_94,28291486.25,,
2025-07-24,294.77,utilities,out,Counterparty_28,28291191.48,2025-06-17,2025-07-12
2025-07-24,7569.81,asset_sale,in,Counterparty_82,28298761.29,,
2025-07-24,1859.88,asset_sale,in,Counterparty_95,28300621.17,,
2025-07-24,397.61,loan_repayment,out,Counterparty_66,28300223.56,2025-07-08,2025-08-06
2025-07-24,1281.55,rent,out,Counterparty_54,28298942.01,2025-06-18,2025-07-17
2025-07-24,95.36,credit,in,Counterparty_42,28299037.37,,
2025-07-24,397.77,loan_repayment,out,Counterparty_43,28298639.6,2025-06-19,2025-07-18
2025-07-24,7337.36,asset_sale,in,Counterparty_34,28305976.96,,
2025-07-24,58.43,tax_payment,out,Counterparty_41,28305918.53,2025-06-26,2025-07-29
2025-07-24,1098.2,payroll,out,Counterparty_46,28304820.33,2025-06-30,2025-07-28
2025-07-24,3367.62,investment_income,in,Counterparty_60,28308187.95,,
2025-07-24,237.48,loan_repayment,out,Counterparty_12,28307950.47,2025-07-03,2025-08-08
2025-07-24,2301.38,utilities,out,Counterparty_58,28305649.09,2025-07-03,2025-08-05
2025-07-24,480.68,asset_sale,in,Counterparty_31,28306129.77,,
2025-07-24,1438.96,marketing_spend,out,Counterparty_93,28304690.81,2025-06-22,2025-07-25
2025-07-25,1194.7,rent,out,Counterparty_18,28303496.11,2025-06-16,2025-07-20
2025-07-25,885.69,loan_repayment,out,Counterparty_40,28302610.42,2025-06-17,2025-07-20
2025-07-25,903.18,rent,out,Counterparty_16,28301707.24,2025-07-10,2025-08-06
2025-07-25,1051.77,software_subscription,out,Counterparty_82,28300655.47,2025-06-17,2025-07-23
2025-07-25,638.36,investment_income,in,Counterparty_49,28301293.83,,
2025-07-25,6804.6,loan_repayment,out,Counterparty_53,28294489.23,2025-06-20,2025-07-25
2025-07-25,1866.84,credit,in,Counterparty_7,28296356.07,,
2025-07-25,827.89,T&E,out,Counterparty_35,28295528.18,2025-07-05,2025-07-30
2025-07-25,3309.16,software_subscription,out,Counterparty_14,28292219.02,2025-06-28,2025-08-01
2025-07-25,2352.17,supplier_payment,out,Counterparty_80,28289866.85,2025-06-23,2025-07-25
2025-07-25,2551.33,credit,in,Counterparty_70,28292418.18,,
2025-07-25,952.17,supplier_payment,out,Counterparty_50,28291466.01,2025-06-16,2025-07-16
2025-07-25,1321.71,asset_sale,in,Counterparty_92,28292787.72,,
2025-07-25,379.6,loan_repayment,out,Counterparty_17,28292408.12,2025-07-01,2025-07-28
2025-07-25,1963.07,loan_repayment,out,Counterparty_40,28290445.05,2025-07-04,2025-07-31
2025-07-25,2725.89,refund,in,Counterparty_26,28293170.94,,
2025-07-25,2750.17,supplier_payment,out,Counterparty_15,28290420.77,2025-06-12,2025-07-16
2025-07-25,1879.33,payroll,out,Counterparty_88,28288541.44,2025-07-10,2025-08-04
2025-07-25,1360.06,tax_payment,out,Counterparty_27,28287181.38,2025-06-17,2025-07-20
2025-07-25,9465.57,asset_sale,in,Counterparty_78,28296646.95,,
2025-07-25,7361.33,tax_payment,out,Counterparty_53,28289285.62,2025-06-27,2025-08-02
2025-07-25,1138.62,credit,in,Counterparty_61,28290424.24,,
2025-07-25,1514.26,investment_income,in,Counterparty_60,28291938.5,,
2025-07-25,2123.04,utilities,out,Counterparty_18,28289815.46,2025-06-14,2025-07-22
2025-07-25,2023.4,customer_payment,in,Counterparty_43,28291838.86,,
2025-07-25,4682.47,T&E,out,Counterparty_89,28287156.39,2025-07-05,2025-07-31
2025-07-25,8193.13,rent,out,Counterparty_90,28278963.26,2025-06-19,2025-07-14
2025-07-25,939.12,software_subscription,out,Counterparty_47,28278024.14,2025-06-18,2025-07-17
2025-07-25,3960.77,payroll,out,Counterparty_11,28274063.37,2025-06-25,2025-07-30
2025-07-25,6685.94,marketing_spend,out,Counterparty_50,28267377.43,2025-07-10,2025-08-13
2025-07-25,7994.4,refund,in,Counterparty_44,28275371.83,,
2025-07-25,15970.55,investment_income,in,Counterparty_1,28291342.38,,
2025-07-25,3201.1,asset_sale,in,Counterparty_87,28294543.48,,
2025-07-25,412.62,tax_payment,out,Counterparty_72,28294130.86,2025-06-22,2025-07-24
2025-07-25,3550.29,loan_repayment,out,Counterparty_48,28290580.57,2025-06-24,2025-07-23
2025-07-25,7543.51,marketing_spend,out,Counterparty_23,28283037.06,2025-07-01,2025-07-31
2025-07-25,721.81,loan_repayment,out,Counterparty_40,28282315.25,2025-06-27,2025-07-29
2025-07-25,4037.81,tax_payment,out,Counterparty_77,28278277.44,2025-07-05,2025-08-06
2025-07-25,7380.43,software_subscription,out,Counterparty_96,28270897.01,2025-06-22,2025-07-17
2025-07-25,1015.49,refund,in,Counterparty_30,28271912.5,,
2025-07-25,2030.0,T&E,out,Counterparty_13,28269882.5,2025-06-29,2025-07-27
2025-07-25,1587.03,supplier_payment,out,Counterparty_76,28268295.47,2025-07-10,2025-08-09
2025-07-25,2613.86,loan_repayment,out,Counterparty_58,28265681.61,2025-06-17,2025-07-12
2025-07-25,942.33,loan_repayment,out,Counterparty_68,28264739.28,2025-06-17,2025-07-15
2025-07-25,1077.05,credit,in,Counterparty_80,28265816.33,,
2025-07-25,1143.29,marketing_spend,out,Counterparty_81,28264673.04,2025-06-25,2025-08-02
2025-07-25,873.27,investment_income,in,Counterparty_95,28265546.31,,
2025-07-25,1468.5,software_subscription,out,Counterparty_44,28264077.81,2025-06-17,2025-07-19
2025-07-25,11309.13,refund,in,Counterparty_35,28275386.94,,
2025-07-25,1519.58,supplier_payment,out,Counterparty_89,28273867.36,2025-07-04,2025-08-03
2025-07-25,348.76,software_subscription,out,Counterparty_5,28273518.6,2025-07-05,2025-08-02
2025-07-25,47.49,T&E,out,Counterparty_66,28273471.11,2025-06-13,2025-07-22
2025-07-25,29103.99,customer_payment,in,Counterparty_76,28302575.1,,
2025-07-25,2776.0,loan_repayment,out,Counterparty_55,28299799.1,2025-07-09,2025-08-16
2025-07-26,4666.67,payroll,out,Counterparty_82,28295132.43,2025-06-25,2025-07-25
2025-07-26,72.58,asset_sale,in,Counterparty_83,28295205.01,,
2025-07-26,139.16,customer_payment,in,Counterparty_95,28295344.17,,
2025-07-26,6424.93,loan_repayment,out,Counterparty_79,28288919.24,2025-07-06,2025-07-31
2025-07-26,11018.12,utilities,out,Counterparty_19,28277901.12,2025-07-09,2025-08-04
2025-07-26,993.72,refund,in,Counterparty_78,28278894.84,,
2025-07-26,10804.76,investment_income,in,Counterparty_91,28289699.6,,
2025-07-26,5549.39,investment_income,in,Counterparty_51,28295248.99,,
2025-07-26,1850.61,customer_payment,in,Counterparty_89,28297099.6,,
2025-07-26,4333.61,payroll,out,Counterparty_27,28292765.99,2025-07-06,2025-08-03
2025-07-26,8124.3,investment_income,in,Counterparty_19,28300890.29,,
2025-07-26,6909.11,utilities,out,Counterparty_13,28293981.18,2025-07-02,2025-08-01
2025-07-26,6327.21,loan_repayment,out,Counterparty_34,28287653.97,2025-06-21,2025-07-24
2025-07-26,6277.25,refund,in,Counterparty_65,28293931.22,,
2025-07-26,574.57,T&E,out,Counterparty_85,28293356.65,2025-07-04,2025-08-11
2025-07-26,5608.97,asset_sale,in,Counterparty_26,28298965.62,,
2025-07-26,967.33,T&E,out,Counterparty_14,28297998.29,2025-07-09,2025-08-04
2025-07-26,749.91,payroll,out,Counterparty_43,28297248.38,2025-06-16,2025-07-18
2025-07-26,2389.96,asset_sale,in,Counterparty_8,28299638.34,,
2025-07-26,44415.18,customer_payment,in,Counterparty_95,28344053.52,,
2025-07-26,3739.24,tax_payment,out,Counterparty_32,28340314.28,2025-06-23,2025-07-18
2025-07-26,1542.29,tax_payment,out,Counterparty_1,28338771.99,2025-06-13,2025-07-18
2025-07-26,6139.78,investment_income,in,Counterparty_46,28344911.77,,
2025-07-26,3736.82,rent,out,Counterparty_32,28341174.95,2025-07-09,2025-08-14
2025-07-26,1948.61,payroll,out,Counterparty_71,28339226.34,2025-07-05,2025-08-03
2025-07-26,96.62,marketing_spend,out,Counterparty_34,28339129.72,2025-06-16,2025-07-12
2025-07-26,568.75,utilities,out,Counterparty_16,28338560.97,2025-07-06,2025-08-04
2025-07-26,1402.03,credit,in,Counterparty_33,28339963.0,,
2025-07-26,3330.84,refund,in,Counterparty_74,28343293.84,,
2025-07-26,2126.31,asset_sale,in,Counterparty_47,28345420.15,,
2025-07-26,4277.52,utilities,out,Counterparty_68,28341142.63,2025-06-23,2025-07-30
2025-07-26,1550.34,credit,in,Counterparty_66,28342692.97,,
2025-07-26,2382.52,T&E,out,Counterparty_52,28340310.45,2025-07-05,2025-08-04
2025-07-26,2325.32,asset_sale,in,Counterparty_38,28342635.77,,
2025-07-26,1076.91,T&E,out,Counterparty_15,28341558.86,2025-06-14,2025-07-20
2025-07-26,2106.37,asset_sale,in,Counterparty_69,28343665.23,,
2025-07-26,7725.0,refund,in,Counterparty_27,28351390.23,,
2025-07-26,331.14,marketing_spend,out,Counterparty_58,28351059.09,2025-06-19,2025-07-19
2025-07-26,12999.17,credit,in,Counterparty_79,28364058.26,,
2025-07-26,205.56,marketing_spend,out,Counterparty_81,28363852.7,2025-06-30,2025-07-25
2025-07-26,1801.27,loan_repayment,out,Counterparty_20,28362051.43,2025-07-11,2025-08-13
2025-07-26,1026.97,supplier_payment,out,Counterparty_19,28361024.46,2025-07-11,2025-08-06
2025-07-26,3230.34,asset_sale,in,Counterparty_2,28364254.8,,
2025-07-26,1667.38,loan_repayment,out,Counterparty_38,28362587.42,2025-07-02,2025-07-27
2025-07-26,9481.75,asset_sale,in,Counterparty_10,28372069.17,,
2025-07-26,1806.68,tax_payment,out,Counterparty_71,28370262.49,2025-06-17,2025-07-18
2025-07-26,649.55,customer_payment,in,Counterparty_60,28370912.04,,
2025-07-26,1105.72,rent,out,Counterparty_4,28369806.32,2025-06-30,2025-07-31
2025-07-26,19903.51,credit,in,Counterparty_18,28389709.83,,
2025-07-26,1312.54,rent,out,Counterparty_66,28388397.29,2025-07-09,2025-08-06
2025-07-26,2443.38,marketing_spend,out,Counterparty_62,28385953.91,2025-06-13,2025-07-22
2025-07-26,1027.83,supplier_payment,out,Counterparty_15,28384926.08,2025-07-05,2025-07-30
2025-07-26,5630.8,asset_sale,in,Counterparty_97,28390556.88,,
2025-07-26,1983.92,software_subscription,out,Counterparty_95,28388572.96,2025-07-09,2025-08-12
2025-07-26,3906.97,supplier_payment,out,Counterparty_45,28384665.99,2025-06-21,2025-07-22
2025-07-26,172.64,credit,in,Counterparty_16,28384838.63,,
2025-07-26,540.16,customer_payment,in,Counterparty_8,28385378.79,,
2025-07-26,810.75,investment_income,in,Counterparty_75,28386189.54,,
2025-07-26,29.08,refund,in,Counterparty_43,28386218.62,,
2025-07-26,6972.98,customer_payment,in,Counterparty_96,28393191.6,,
2025-07-26,1576.99,rent,out,Counterparty_97,28391614.61,2025-07-05,2025-08-11
2025-07-27,245.51,marketing_spend,out,Counterparty_50,28391369.1,2025-06-18,2025-07-20
2025-07-27,3772.36,loan_repayment,out,Counterparty_68,28387596.74,2025-06-26,2025-07-23
2025-07-27,1032.82,software_subscription,out,Counterparty_6,28386563.92,2025-06-30,2025-08-04
2025-07-27,840.95,payroll,out,Counterparty_41,28385722.97,2025-07-04,2025-08-08
2025-07-27,3241.2,utilities,out,Counterparty_3,28382481.77,2025-07-10,2025-08-11
2025-07-27,1370.28,customer_payment,in,Counterparty_12,28383852.05,,
2025-07-27,209.74,supplier_payment,out,Counterparty_96,28383642.31,2025-06-30,2025-08-05
2025-07-27,2114.48,tax_payment,out,Counterparty_26,28381527.83,2025-06-13,2025-07-21
2025-07-27,375.2,refund,in,Counterparty_2,28381903.03,,
2025-07-27,191.03,utilities,out,Counterparty_63,28381712.0,2025-06-30,2025-08-06
2025-07-27,1918.68,credit,in,Counterparty_69,28383630.68,,
2025-07-27,3356.08,utilities,out,Counterparty_21,28380274.6,2025-07-09,2025-08-15
2025-07-27,3552.08,tax_payment,out,Counterparty_1,28376722.52,2025-06-22,2025-07-23
2025-07-27,578.97,tax_payment,out,Counterparty_19,28376143.55,2025-06-21,2025-07-16
2025-07-27,10640.35,utilities,out,Counterparty_68,28365503.2,2025-06-28,2025-07-26
2025-07-27,1146.89,investment_income,in,Counterparty_89,28366650.09,,
2025-07-27,2782.48,loan_repayment,out,Counterparty_30,28363867.61,2025-07-01,2025-07-26
2025-07-27,5966.0,customer_payment,in,Counterparty_47,28369833.61,,
2025-07-27,3470.76,customer_payment,in,Counterparty_45,28373304.37,,
2025-07-27,1932.55,rent,out,Counterparty_57,28371371.82,2025-07-10,2025-08-17
2025-07-27,3351.0,credit,in,Counterparty_67,28374722.82,,
2025-07-27,665.18,rent,out,Counterparty_51,28374057.64,2025-07-06,2025-08-03
2025-07-27,2920.82,credit,in,Counterparty_92,28376978.46,,
2025-07-27,21960.59,customer_payment,in,Counterparty_36,28398939.05,,
2025-07-27,8601.68,loan_repayment,out,Counterparty_44,28390337.37,2025-06-20,2025-07-23
2025-07-27,1193.39,loan_repayment,out,Counterparty_16,28389143.98,2025-07-03,2025-08-05
2025-07-27,218.13,tax_payment,out,Counterparty_79,28388925.85,2025-06-16,2025-07-13
2025-07-27,7372.64,customer_payment,in,Counterparty_14,28396298.49,,
2025-07-27,18954.27,customer_payment,in,Counterparty_58,28415252.76,,
2025-07-27,1653.05,marketing_spend,out,Counterparty_93,28413599.71,2025-06-26,2025-08-04
2025-07-27,2234.81,tax_payment,out,Counterparty_3,28411364.9,2025-07-10,2025-08-04
2025-07-27,1002.01,T&E,out,Counterparty_36,28410362.89,2025-06-26,2025-07-22
2025-07-27,3052.71,credit,in,Counterparty_26,28413415.6,,
2025-07-27,5064.28,loan_repayment,out,Counterparty_96,28408351.32,2025-06-29,2025-07-26
2025-07-27,8429.65,investment_income,in,Counterparty_72,28416780.97,,
2025-07-27,1679.96,customer_payment,in,Counterparty_81,28418460.93,,
2025-07-27,1778.34,asset_sale,in,Counterparty_32,28420239.27,,
2025-07-27,1566.85,supplier_payment,out,Counterparty_47,28418672.42,2025-06-23,2025-07-28
2025-07-27,2336.82,utilities,out,Counterparty_94,28416335.6,2025-06-27,2025-07-28
2025-07-27,2880.58,supplier_payment,out,Counterparty_70,28413455.02,2025-07-01,2025-08-05
2025-07-27,255.85,T&E,out,Counterparty_65,28413199.17,2025-07-11,2025-08-11
2025-07-27,2625.47,rent,out,Counterparty_75,28410573.7,2025-06-13,2025-07-14
2025-07-27,764.73,credit,in,Counterparty_82,28411338.43,,
2025-07-27,37.27,payroll,out,Counterparty_88,28411301.16,2025-06-28,2025-07-23
2025-07-27,4650.65,software_subscription,out,Counterparty_9,28406650.51,2025-06-14,2025-07-20
2025-07-27,1949.64,T&E,out,Counterparty_51,28404700.87,2025-06-17,2025-07-23
2025-07-27,2655.96,utilities,out,Counterparty_60,28402044.91,2025-07-05,2025-08-05
2025-07-27,1390.88,rent,out,Counterparty_89,28400654.03,2025-07-02,2025-08-03
2025-07-27,1196.41,software_subscription,out,Counterparty_73,28399457.62,2025-06-29,2025-07-24
2025-07-27,2391.75,tax_payment,out,Counterparty_65,28397065.87,2025-06-13,2025-07-18
2025-07-27,3319.42,loan_repayment,out,Counterparty_29,28393746.45,2025-06-25,2025-07-30
2025-07-27,10348.28,investment_income,in,Counterparty_51,28404094.73,,
2025-07-28,595.7,investment_income,in,Counterparty_95,28404690.43,,
2025-07-28,716.49,marketing_spend,out,Counterparty_38,28403973.94,2025-06-25,2025-07-31
2025-07-28,2558.19,credit,in,Counterparty_31,28406532.13,,
2025-07-28,1863.06,tax_payment,out,Counterparty_75,28404669.07,2025-06-17,2025-07-17
2025-07-28,4413.23,customer_payment,in,Counterparty_74,28409082.3,,
2025-07-28,3804.26,asset_sale,in,Counterparty_95,28412886.56,,
2025-07-28,5857.67,T&E,out,Counterparty_48,28407028.89,2025-06-15,2025-07-22
2025-07-28,3933.14,loan_repayment,out,Counterparty_70,28403095.75,2025-06-25,2025-07-26
2025-07-28,4700.28,software_subscription,out,Counterparty_4,28398395.47,2025-07-09,2025-08-08
2025-07-28,4974.08,credit,in,Counterparty_13,28403369.55,,
2025-07-28,1165.54,refund,in,Counterparty_43,28404535.09,,
2025-07-28,51.58,credit,in,Counterparty_30,28404586.67,,
2025-07-28,1700.41,loan_repayment,out,Counterparty_64,28402886.26,2025-06-26,2025-08-02
2025-07-28,4991.32,refund,in,Counterparty_23,28407877.58,,
2025-07-28,1778.68,marketing_spend,out,Counterparty_62,28406098.9,2025-07-04,2025-08-02
2025-07-28,3750.7,credit,in,Counterparty_8,28409849.6,,
2025-07-28,3415.84,marketing_spend,out,Counterparty_30,28406433.76,2025-07-02,2025-07-28
2025-07-28,361.44,payroll,out,Counterparty_38,28406072.32,2025-07-02,2025-07-29
2025-07-28,734.4,software_subscription,out,Counterparty_85,28405337.92,2025-06-30,2025-08-03
2025-07-28,5543.32,rent,out,Counterparty_56,28399794.6,2025-06-16,2025-07-12
2025-07-28,4081.77,payroll,out,Counterparty_33,28395712.83,2025-07-01,2025-08-09
2025-07-28,1543.63,utilities,out,Counterparty_70,28394169.2,2025-06-14,2025-07-23
2025-07-28,2543.98,credit,in,Counterparty_78,28396713.18,,
2025-07-28,10108.9,asset_sale,in,Counterparty_37,28406822.08,,
2025-07-28,1118.78,tax_payment,out,Counterparty_44,28405703.3,2025-07-13,2025-08-15
2025-07-28,748.51,marketing_spend,out,Counterparty_51,28404954.79,2025-07-12,2025-08-06
2025-07-28,6239.94,customer_payment,in,Counterparty_14,28411194.73,,
2025-07-28,1993.5,marketing_spend,out,Counterparty_32,28409201.23,2025-07-06,2025-08-09
2025-07-28,1303.72,marketing_spend,out,Counterparty_16,28407897.51,2025-07-10,2025-08-04
2025-07-28,480.35,loan_repayment,out,Counterparty_30,28407417.16,2025-06-20,2025-07-27
2025-07-28,133.63,marketing_spend,out,Counterparty_63,28407283.53,2025-07-11,2025-08-13
2025-07-28,1675.8,software_subscription,out,Counterparty_35,28405607.73,2025-06-20,2025-07-27
2025-07-28,2480.45,marketing_spend,out,Counterparty_83,28403127.28,2025-07-11,2025-08-10
2025-07-28,9143.98,T&E,out,Counterparty_52,28393983.3,2025-06-20,2025-07-27
2025-07-28,5861.31,T&E,out,Counterparty_32,28388121.99,2025-06-27,2025-07-26
2025-07-28,1076.99,marketing_spend,out,Counterparty_76,28387045.0,2025-06-18,2025-07-20
2025-07-28,3437.4,customer_payment,in,Counterparty_7,28390482.4,,
2025-07-28,2735.3,rent,out,Counterparty_34,28387747.1,2025-07-08,2025-08-11
2025-07-28,2100.34,supplier_payment,out,Counterparty_17,28385646.76,2025-06-29,2025-08-07
2025-07-28,4173.9,supplier_payment,out,Counterparty_1,28381472.86,2025-06-24,2025-08-01
2025-07-28,3106.53,investment_income,in,Counterparty_89,28384579.39,,
2025-07-28,494.4,marketing_spend,out,Counterparty_27,28384084.99,2025-06-23,2025-07-30
2025-07-28,1878.89,supplier_payment,out,Counterparty_74,28382206.1,2025-07-07,2025-08-10
2025-07-28,294.55,loan_repayment,out,Counterparty_38,28381911.55,2025-06-15,2025-07-20
2025-07-28,2276.58,T&E,out,Counterparty_5,28379634.97,2025-07-08,2025-08-15
2025-07-28,8647.81,asset_sale,in,Counterparty_56,28388282.78,,
2025-07-28,1862.52,refund,in,Counterparty_2,28390145.3,,
2025-07-28,12976.35,credit,in,Counterparty_31,28403121.65,,
2025-07-28,9955.26,asset_sale,in,Counterparty_49,28413076.91,,
2025-07-28,107.49,investment_income,in,Counterparty_99,28413184.4,,
2025-07-28,1271.89,investment_income,in,Counterparty_14,28414456.29,,
2025-07-28,798.24,customer_payment,in,Counterparty_44,28415254.53,,
2025-07-28,2105.6,utilities,out,Counterparty_42,28413148.93,2025-07-07,2025-08-15
2025-07-28,58.28,utilities,out,Counterparty_92,28413090.65,2025-07-05,2025-08-03
2025-07-28,171.33,T&E,out,Counterparty_28,28412919.32,2025-06-20,2025-07-26
2025-07-28,4387.53,asset_sale,in,Counterparty_84,28417306.85,,
2025-07-28,968.21,utilities,out,Counterparty_68,28416338.64,2025-07-04,2025-08-07
2025-07-28,86.2,supplier_payment,out,Counterparty_91,28416252.44,2025-07-10,2025-08-16
2025-07-28,6282.32,credit,in,Counterparty_71,28422534.76,,
2025-07-28,771.73,credit,in,Counterparty_77,28423306.49,,
2025-07-28,129.43,marketing_spend,out,Counterparty_38,28423177.06,2025-06-20,2025-07-24
2025-07-28,2119.1,customer_payment,in,Counterparty_92,28425296.16,,
2025-07-28,1222.89,customer_payment,in,Counterparty_34,28426519.05,,
2025-07-29,1651.38,customer_payment,in,Counterparty_89,28428170.43,,
2025-07-29,18.78,T&E,out,Counterparty_90,28428151.65,2025-06-28,2025-08-03
2025-07-29,2831.01,investment_income,in,Counterparty_47,28430982.66,,
2025-07-29,3470.95,credit,in,Counterparty_45,28434453.61,,
2025-07-29,173.16,software_subscription,out,Counterparty_57,28434280.45,2025-07-06,2025-08-11
2025-07-29,958.98,tax_payment,out,Counterparty_72,28433321.47,2025-06-23,2025-08-01
2025-07-29,1368.04,rent,out,Counterparty_62,28431953.43,2025-07-02,2025-08-01
2025-07-29,95.25,refund,in,Counterparty_90,28432048.68,,
2025-07-29,738.22,customer_payment,in,Counterparty_91,28432786.9,,
2025-07-29,3507.71,T&E,out,Counterparty_56,28429279.19,2025-06-24,2025-07-20
2025-07-29,4815.77,marketing_spend,out,Counterparty_91,28424463.42,2025-07-01,2025-08-04
2025-07-29,397.69,T&E,out,Counterparty_7,28424065.73,2025-07-06,2025-08-12
2025-07-29,3288.89,software_subscription,out,Counterparty_31,28420776.84,2025-07-09,2025-08-08
2025-07-29,1740.22,marketing_spend,out,Counterparty_48,28419036.62,2025-06-26,2025-08-01
2025-07-29,321.77,loan_repayment,out,Counterparty_21,28418714.85,2025-06-19,2025-07-16
2025-07-29,24430.69,credit,in,Counterparty_79,28443145.54,,
2025-07-29,7892.98,credit,in,Counterparty_82,28451038.52,,
2025-07-29,1743.45,payroll,out,Counterparty_89,28449295.07,2025-07-04,2025-08-03
2025-07-29,1364.34,software_subscription,out,Counterparty_39,28447930.73,2025-06-29,2025-08-02
2025-07-29,2056.75,utilities,out,Counterparty_53,28445873.98,2025-07-14,2025-08-19
2025-07-29,395.17,software_subscription,out,Counterparty_27,28445478.81,2025-06-26,2025-07-29
2025-07-29,7392.97,refund,in,Counterparty_5,28452871.78,,
2025-07-29,316.46,marketing_spend,out,Counterparty_11,28452555.32,2025-06-16,2025-07-22
2025-07-29,6821.15,marketing_spend,out,Counterparty_73,28445734.17,2025-07-01,2025-07-29
2025-07-29,3045.44,T&E,out,Counterparty_66,28442688.73,2025-06-23,2025-07-26
2025-07-29,14748.5,asset_sale,in,Counterparty_2,28457437.23,,
2025-07-29,164.31,loan_repayment,out,Counterparty_40,28457272.92,2025-07-13,2025-08-19
2025-07-29,1263.55,utilities,out,Counterparty_78,28456009.37,2025-07-14,2025-08-20
2025-07-29,1602.17,asset_sale,in,Counterparty_29,28457611.54,,
2025-07-29,845.55,utilities,out,Counterparty_89,28456765.99,2025-06-25,2025-07-23
2025-07-29,6120.07,credit,in,Counterparty_27,28462886.06,,
2025-07-29,313.42,customer_payment,in,Counterparty_56,28463199.48,,
2025-07-29,8159.75,investment_income,in,Counterparty_61,28471359.23,,
2025-07-29,6032.28,customer_payment,in,Counterparty_62,28477391.51,,
2025-07-29,963.23,tax_payment,out,Counterparty_31,28476428.28,2025-07-12,2025-08-15
2025-07-29,2559.93,refund,in,Counterparty_35,28478988.21,,
2025-07-29,899.91,utilities,out,Counterparty_78,28478088.3,2025-06-16,2025-07-16
2025-07-29,805.38,utilities,out,Counterparty_78,28477282.92,2025-07-04,2025-07-31
2025-07-29,50.58,refund,in,Counterparty_9,28477333.5,,
2025-07-29,1523.39,investment_income,in,Counterparty_43,28478856.89,,
2025-07-29,8223.27,credit,in,Counterparty_63,28487080.16,,
2025-07-29,2143.49,marketing_spend,out,Counterparty_65,28484936.67,2025-06-28,2025-07-24
2025-07-29,1521.0,loan_repayment,out,Counterparty_3,28483415.67,2025-06-15,2025-07-19
2025-07-29,815.82,customer_payment,in,Counterparty_35,28484231.49,,
2025-07-29,845.13,investment_income,in,Counterparty_32,28485076.62,,
2025-07-29,4863.26,customer_payment,in,Counterparty_43,28489939.88,,
2025-07-29,746.39,credit,in,Counterparty_11,28490686.27,,
2025-07-29,1424.99,marketing_spend,out,Counterparty_31,28489261.28,2025-06-30,2025-08-07
2025-07-29,1881.62,supplier_payment,out,Counterparty_17,28487379.66,2025-06-16,2025-07-12
2025-07-29,876.74,software_subscription,out,Counterparty_8,28486502.92,2025-07-14,2025-08-21
2025-07-29,4292.3,customer_payment,in,Counterparty_76,28490795.22,,
2025-07-29,3166.73,supplier_payment,out,Counterparty_77,28487628.49,2025-07-04,2025-08-04
2025-07-29,3453.31,refund,in,Counterparty_31,28491081.8,,
2025-07-29,1575.38,investment_income,in,Counterparty_42,28492657.18,,
2025-07-29,407.1,rent,out,Counterparty_37,28492250.08,2025-06-25,2025-08-03
2025-07-29,1259.67,software_subscription,out,Counterparty_92,28490990.41,2025-06-22,2025-07-20
2025-07-29,5088.73,credit,in,Counterparty_46,28496079.14,,
2025-07-29,1143.22,tax_payment,out,Counterparty_53,28494935.92,2025-06-30,2025-08-08
2025-07-29,5253.05,investment_income,in,Counterparty_13,28500188.97,,
2025-07-30,2819.29,refund,in,Counterparty_9,28503008.26,,
2025-07-30,2239.55,software_subscription,out,Counterparty_51,28500768.71,2025-06-18,2025-07-26
2025-07-30,20.37,asset_sale,in,Counterparty_55,28500789.08,,
2025-07-30,3.1,asset_sale,in,Counterparty_92,28500792.18,,
2025-07-30,1779.39,asset_sale,in,Counterparty_26,28502571.57,,
2025-07-30,12870.27,asset_sale,in,Counterparty_69,28515441.84,,
2025-07-30,6276.3,investment_income,in,Counterparty_65,28521718.14,,
2025-07-30,1378.34,software_subscription,out,Counterparty_87,28520339.8,2025-07-15,2025-08-10
2025-07-30,162.77,refund,in,Counterparty_63,28520502.57,,
2025-07-30,318.02,payroll,out,Counterparty_80,28520184.55,2025-06-25,2025-07-22
2025-07-30,3143.6,asset_sale,in,Counterparty_98,28523328.15,,
2025-07-30,107.56,marketing_spend,out,Counterparty_83,28523220.59,2025-06-29,2025-07-26
2025-07-30,5855.55,loan_repayment,out,Counterparty_85,28517365.04,2025-06-29,2025-08-07
2025-07-30,5793.52,investment_income,in,Counterparty_67,28523158.56,,
2025-07-30,3261.54,tax_payment,out,Counterparty_70,28519897.02,2025-06-23,2025-07-24
2025-07-30,2850.29,supplier_payment,out,Counterparty_84,28517046.73,2025-06-24,2025-07-27
2025-07-30,2785.63,tax_payment,out,Counterparty_36,28514261.1,2025-06-25,2025-07-24
2025-07-30,3540.02,loan_repayment,out,Counterparty_42,28510721.08,2025-07-05,2025-08-01
2025-07-30,3297.56,refund,in,Counterparty_70,28514018.64,,
2025-07-30,374.33,supplier_payment,out,Counterparty_55,28513644.31,2025-07-12,2025-08-13
2025-07-30,5452.5,tax_payment,out,Counterparty_13,28508191.81,2025-06-27,2025-07-31
2025-07-30,14590.21,asset_sale,in,Counterparty_1,28522782.02,,
2025-07-30,692.87,marketing_spend,out,Counterparty_83,28522089.15,2025-06-17,2025-07-13
2025-07-30,1798.51,customer_payment,in,Counterparty_12,28523887.66,,
2025-07-30,1088.21,tax_payment,out,Counterparty_24,28522799.45,2025-07-13,2025-08-13
2025-07-30,1828.3,asset_sale,in,Counterparty_80,28524627.75,,
2025-07-30,4317.31,refund,in,Counterparty_68,28528945.06,,
2025-07-30,1023.45,loan_repayment,out,Counterparty_17,28527921.61,2025-07-02,2025-07-30
2025-07-30,3529.21,marketing_spend,out,Counterparty_4,28524392.4,2025-07-14,2025-08-08
2025-07-30,1382.56,tax_payment,out,Counterparty_23,28523009.84,2025-06-18,2025-07-20
2025-07-30,2473.37,asset_sale,in,Counterparty_19,28525483.21,,
2025-07-30,2767.76,rent,out,Counterparty_10,28522715.45,2025-06-28,2025-08-05
2025-07-30,1243.44,T&E,out,Counterparty_21,28521472.01,2025-07-07,2025-08-12
2025-07-30,2821.35,customer_payment,in,Counterparty_39,28524293.36,,
2025-07-30,558.29,tax_payment,out,Counterparty_85,28523735.07,2025-06-18,2025-07-17
2025-07-30,4547.99,loan_repayment,out,Counterparty_44,28519187.08,2025-06-30,2025-07-28
2025-07-30,5934.47,software_subscription,out,Counterparty_76,28513252.61,2025-07-03,2025-07-29
2025-07-30,253.42,marketing_spend,out,Counterparty_3,28512999.19,2025-06-18,2025-07-19
2025-07-30,1243.66,marketing_spend,out,Counterparty_75,28511755.53,2025-06-28,2025-07-23
2025-07-30,791.12,loan_repayment,out,Counterparty_53,28510964.41,2025-07-03,2025-08-10
2025-07-30,983.4,rent,out,Counterparty_43,28509981.01,2025-06-21,2025-07-21
2025-07-30,151.61,investment_income,in,Counterparty_50,28510132.62,,
2025-07-30,2118.33,credit,in,Counterparty_24,28512250.95,,
2025-07-30,1382.99,utilities,out,Counterparty_56,28510867.96,2025-06-29,2025-07-31
2025-07-30,1759.15,tax_payment,out,Counterparty_25,28509108.81,2025-07-01,2025-08-04
2025-07-30,4731.26,customer_payment,in,Counterparty_45,28513840.07,,
2025-07-31,4130.02,software_subscription,out,Counterparty_75,28509710.05,2025-06-22,2025-07-17
2025-07-31,1385.07,payroll,out,Counterparty_77,28508324.98,2025-07-01,2025-07-29
2025-07-31,3596.68,payroll,out,Counterparty_12,28504728.3,2025-06-20,2025-07-22
2025-07-31,6205.81,tax_payment,out,Counterparty_26,28498522.49,2025-07-09,2025-08-11
2025-07-31,109.57,payroll,out,Counterparty_42,28498412.92,2025-07-15,2025-08-15
2025-07-31,127.56,asset_sale,in,Counterparty_17,28498540.48,,
2025-07-31,1391.7,utilities,out,Counterparty_62,28497148.78,2025-07-02,2025-08-04
2025-07-31,319.0,utilities,out,Counterparty_80,28496829.78,2025-07-12,2025-08-08
2025-07-31,917.07,supplier_payment,out,Counterparty_71,28495912.71,2025-06-25,2025-07-22
2025-07-31,570.38,software_subscription,out,Counterparty_32,28495342.33,2025-06-29,2025-07-27
2025-07-31,25611.38,asset_sale,in,Counterparty_91,28520953.71,,
2025-07-31,267.95,software_subscription,out,Counterparty_41,28520685.76,2025-07-01,2025-07-28
2025-07-31,9810.68,asset_sale,in,Counterparty_29,28530496.44,,
2025-07-31,1277.04,T&E,out,Counterparty_32,28529219.4,2025-07-08,2025-08-16
2025-07-31,2881.09,rent,out,Counterparty_42,28526338.31,2025-07-11,2025-08-14
2025-07-31,1256.98,loan_repayment,out,Counterparty_30,28525081.33,2025-07-15,2025-08-22
2025-07-31,292.88,loan_repayment,out,Counterparty_57,28524788.45,2025-07-04,2025-07-29
2025-07-31,2276.94,credit,in,Counterparty_85,28527065.39,,
2025-07-31,1844.15,payroll,out,Counterparty_65,28525221.24,2025-06-30,2025-07-25
2025-07-31,11107.91,refund,in,Counterparty_27,28536329.15,,
2025-07-31,478.02,rent,out,Counterparty_95,28535851.13,2025-06-19,2025-07-18
2025-07-31,5457.61,customer_payment,in,Counterparty_6,28541308.74,,
2025-07-31,1545.0,utilities,out,Counterparty_50,28539763.74,2025-07-09,2025-08-09
2025-07-31,2101.53,payroll,out,Counterparty_20,28537662.21,2025-06-24,2025-07-19
2025-07-31,4257.55,customer_payment,in,Counterparty_23,28541919.76,,
2025-07-31,1031.59,supplier_payment,out,Counterparty_17,28540888.17,2025-06-26,2025-07-31
2025-07-31,1080.22,marketing_spend,out,Counterparty_25,28539807.95,2025-07-09,2025-08-07
2025-07-31,78.6,software_subscription,out,Counterparty_65,28539729.35,2025-06-17,2025-07-15
2025-07-31,2679.92,investment_income,in,Counterparty_80,28542409.27,,
2025-07-31,3040.64,rent,out,Counterparty_1,28539368.63,2025-07-04,2025-07-29
2025-07-31,1110.04,rent,out,Counterparty_67,28538258.59,2025-06-17,2025-07-14
2025-07-31,2597.71,software_subscription,out,Counterparty_5,28535660.88,2025-07-11,2025-08-07
2025-07-31,21.7,rent,out,Counterparty_25,28535639.18,2025-06-24,2025-07-25
2025-07-31,3717.62,refund,in,Counterparty_44,28539356.8,,
2025-07-31,2363.64,investment_income,in,Counterparty_41,28541720.44,,
2025-07-31,426.37,utilities,out,Counterparty_35,28541294.07,2025-07-06,2025-08-08
2025-07-31,994.07,software_subscription,out,Counterparty_10,28540300.0,2025-07-11,2025-08-06
2025-07-31,3214.02,customer_payment,in,Counterparty_56,28543514.02,,
2025-07-31,1212.98,supplier_payment,out,Counterparty_22,28542301.04,2025-07-12,2025-08-14
2025-07-31,836.04,software_subscription,out,Counterparty_31,28541465.0,2025-06-18,2025-07-21
2025-07-31,1246.5,tax_payment,out,Counterparty_8,28540218.5,2025-07-04,2025-08-08
2025-07-31,1062.03,asset_sale,in,Counterparty_97,28541280.53,,
2025-07-31,4352.52,tax_payment,out,Counterparty_7,28536928.01,2025-07-07,2025-08-09
2025-07-31,2903.96,asset_sale,in,Counterparty_95,28539831.97,,
2025-07-31,6348.94,refund,in,Counterparty_76,28546180.91,,
2025-07-31,5994.94,asset_sale,in,Counterparty_41,28552175.85,,
2025-07-31,51.77,marketing_spend,out,Counterparty_75,28552124.08,2025-07-07,2025-08-01
2025-07-31,6971.38,supplier_payment,out,Counterparty_86,28545152.7,2025-07-04,2025-07-30
2025-07-31,10773.05,loan_repayment,out,Counterparty_52,28534379.65,2025-07-04,2025-08-03
2025-07-31,7811.18,customer_payment,in,Counterparty_52,28542190.83,,
2025-07-31,962.32,asset_sale,in,Counterparty_64,28543153.15,,
2025-07-31,222.76,asset_sale,in,Counterparty_42,28543375.91,,
2025-07-31,5414.27,payroll,out,Counterparty_2,28537961.64,2025-07-03,2025-08-06
