date,amount,category,in_out,counterparty,balance,invoice_date,due_date
2025-02-20,18810.44,investment_income,in,Counterparty_99,22272038.95,,
2025-02-20,68372.67,investment_income,in,Counterparty_5,22340411.62,,
2025-02-20,34845.09,asset_sale,in,Counterparty_25,22375256.71,,
2025-02-20,9782.76,investment_income,in,Counterparty_42,22385039.47,,
2025-02-20,19058.54,marketing_spend,out,Counterparty_29,22365980.93,2025-01-13,2025-02-13
2025-02-20,2298.1,investment_income,in,Counterparty_91,22368279.03,,
2025-02-20,34770.61,investment_income,in,Counterparty_12,22403049.64,,
2025-02-20,932.78,T&E,out,Counterparty_15,22402116.86,2025-01-31,2025-02-27
2025-02-20,13257.3,rent,out,Counterparty_63,22388859.56,2025-01-24,2025-03-02
2025-02-20,12872.25,payroll,out,Counterparty_42,22375987.31,2025-01-20,2025-02-19
2025-02-20,7086.01,investment_income,in,Counterparty_19,22383073.32,,
2025-02-20,7876.15,asset_sale,in,Counterparty_89,22390949.47,,
2025-02-20,31014.7,supplier_payment,out,Counterparty_24,22359934.77,2025-02-03,2025-03-04
2025-02-20,494.7,investment_income,in,Counterparty_45,22360429.47,,
2025-02-20,8068.78,customer_payment,in,Counterparty_39,22368498.25,,
2025-02-20,18849.94,refund,in,Counterparty_31,22387348.19,,
2025-02-20,12293.64,supplier_payment,out,Counterparty_4,22375054.55,2025-01-11,2025-02-17
2025-02-20,6893.14,refund,in,Counterparty_91,22381947.69,,
2025-02-20,18082.32,loan_repayment,out,Counterparty_84,22363865.37,2025-01-21,2025-02-22
2025-02-20,4835.87,software_subscription,out,Counterparty_25,22359029.5,2025-01-25,2025-02-20
2025-02-20,90736.6,credit,in,Counterparty_90,22449766.1,,
2025-02-20,3963.33,asset_sale,in,Counterparty_17,22453729.43,,
2025-02-20,3210.67,customer_payment,in,Counterparty_40,22456940.1,,
2025-02-20,29106.87,investment_income,in,Counterparty_51,22486046.97,,
2025-02-20,49146.5,asset_sale,in,Counterparty_95,22535193.47,,
2025-02-20,6582.06,T&E,out,Counterparty_32,22528611.41,2025-02-01,2025-03-11
2025-02-20,43762.53,tax_payment,out,Counterparty_20,22484848.88,2025-01-15,2025-02-15
2025-02-20,36693.35,customer_payment,in,Counterparty_74,22521542.23,,
2025-02-20,5421.03,supplier_payment,out,Counterparty_11,22516121.2,2025-01-29,2025-03-01
2025-02-20,24578.37,loan_repayment,out,Counterparty_51,22491542.83,2025-01-29,2025-03-08
2025-02-20,21345.11,payroll,out,Counterparty_73,22470197.72,2025-01-12,2025-02-06
2025-02-20,1440.79,tax_payment,out,Counterparty_11,22468756.93,2025-02-05,2025-03-02
2025-02-20,14631.07,software_subscription,out,Counterparty_16,22454125.86,2025-01-27,2025-03-02
2025-02-20,7813.83,investment_income,in,Counterparty_83,22461939.69,,
2025-02-20,6976.93,credit,in,Counterparty_84,22468916.62,,
2025-02-20,4119.77,marketing_spend,out,Counterparty_68,22464796.85,2025-01-10,2025-02-12
2025-02-21,1608.41,investment_income,in,Counterparty_76,22466405.26,,
2025-02-21,3615.72,loan_repayment,out,Counterparty_70,22462789.54,2025-01-29,2025-03-09
2025-02-21,10932.92,payroll,out,Counterparty_95,22451856.62,2025-01-17,2025-02-20
2025-02-21,11925.34,customer_payment,in,Counterparty_93,22463781.96,,
2025-02-21,9874.17,supplier_payment,out,Counterparty_68,22453907.79,2025-01-29,2025-02-24
2025-02-21,10491.21,T&E,out,Counterparty_36,22443416.58,2025-01-08,2025-02-04
2025-02-21,23006.39,investment_income,in,Counterparty_69,22466422.97,,
2025-02-21,3305.52,refund,in,Counterparty_66,22469728.49,,
2025-02-21,38982.35,asset_sale,in,Counterparty_86,22508710.84,,
2025-02-21,3402.48,supplier_payment,out,Counterparty_99,22505308.36,2025-02-06,2025-03-11
2025-02-21,3435.44,asset_sale,in,Counterparty_1,22508743.8,,
2025-02-21,20195.61,customer_payment,in,Counterparty_97,22528939.41,,
2025-02-21,3121.57,customer_payment,in,Counterparty_37,22532060.98,,
2025-02-21,15710.39,refund,in,Counterparty_92,22547771.37,,
2025-02-21,1800.58,payroll,out,Counterparty_44,22545970.79,2025-01-29,2025-03-01
2025-02-21,6991.12,refund,in,Counterparty_56,22552961.91,,
2025-02-21,16660.29,refund,in,Counterparty_27,22569622.2,,
2025-02-21,18564.61,asset_sale,in,Counterparty_48,22588186.81,,
2025-02-21,17254.16,payroll,out,Counterparty_58,22570932.65,2025-01-17,2025-02-23
2025-02-21,19522.37,utilities,out,Counterparty_19,22551410.28,2025-01-28,2025-02-23
2025-02-21,48948.02,refund,in,Counterparty_27,22600358.3,,
2025-02-21,35280.78,rent,out,Counterparty_85,22565077.52,2025-02-02,2025-03-10
2025-02-21,876.85,software_subscription,out,Counterparty_95,22564200.67,2025-01-10,2025-02-05
2025-02-21,6780.91,T&E,out,Counterparty_97,22557419.76,2025-01-30,2025-03-01
2025-02-21,7749.05,loan_repayment,out,Counterparty_84,22549670.71,2025-01-19,2025-02-19
2025-02-21,22153.63,investment_income,in,Counterparty_10,22571824.34,,
2025-02-21,16722.05,supplier_payment,out,Counterparty_37,22555102.29,2025-02-03,2025-03-04
2025-02-21,9609.84,rent,out,Counterparty_69,22545492.45,2025-01-27,2025-02-25
2025-02-21,2869.24,T&E,out,Counterparty_36,22542623.21,2025-01-30,2025-02-26
2025-02-21,29998.41,supplier_payment,out,Counterparty_24,22512624.8,2025-01-24,2025-03-02
2025-02-21,2297.95,software_subscription,out,Counterparty_8,22510326.85,2025-01-10,2025-02-18
2025-02-21,17957.51,loan_repayment,out,Counterparty_36,22492369.34,2025-01-17,2025-02-15
2025-02-21,27871.57,supplier_payment,out,Counterparty_71,22464497.77,2025-01-11,2025-02-07
2025-02-21,61999.6,marketing_spend,out,Counterparty_30,22402498.17,2025-01-09,2025-02-15
2025-02-21,306.6,tax_payment,out,Counterparty_52,22402191.57,2025-01-17,2025-02-13
2025-02-21,9708.08,asset_sale,in,Counterparty_10,22411899.65,,
2025-02-21,2195.63,refund,in,Counterparty_83,22414095.28,,
2025-02-21,18156.08,tax_payment,out,Counterparty_18,22395939.2,2025-01-09,2025-02-05
2025-02-21,5820.44,utilities,out,Counterparty_61,22390118.76,2025-01-23,2025-02-21
2025-02-21,1264.56,utilities,out,Counterparty_25,22388854.2,2025-01-20,2025-02-22
2025-02-21,1645.46,utilities,out,Counterparty_63,22387208.74,2025-02-03,2025-03-03
2025-02-21,27442.85,customer_payment,in,Counterparty_44,22414651.59,,
2025-02-21,17195.92,investment_income,in,Counterparty_18,22431847.51,,
2025-02-22,836.63,T&E,out,Counterparty_51,22431010.88,2025-02-07,2025-03-12
2025-02-22,31959.56,payroll,out,Counterparty_93,22399051.32,2025-02-03,2025-03-09
2025-02-22,14382.8,T&E,out,Counterparty_25,22384668.52,2025-01-17,2025-02-14
2025-02-22,29056.72,marketing_spend,out,Counterparty_66,22355611.8,2025-02-04,2025-03-05
2025-02-22,1746.58,asset_sale,in,Counterparty_67,22357358.38,,
2025-02-22,19127.34,tax_payment,out,Counterparty_97,22338231.04,2025-02-04,2025-03-01
2025-02-22,10075.72,software_subscription,out,Counterparty_11,22328155.32,2025-01-31,2025-03-10
2025-02-22,3227.95,payroll,out,Counterparty_94,22324927.37,2025-02-02,2025-03-08
2025-02-22,38127.94,supplier_payment,out,Counterparty_63,22286799.43,2025-01-31,2025-03-09
2025-02-22,22305.46,rent,out,Counterparty_48,22264493.97,2025-01-18,2025-02-24
2025-02-22,20309.21,tax_payment,out,Counterparty_13,22244184.76,2025-01-30,2025-03-02
2025-02-22,3575.85,payroll,out,Counterparty_63,22240608.91,2025-02-06,2025-03-06
2025-02-22,17170.52,software_subscription,out,Counterparty_78,22223438.39,2025-01-21,2025-02-19
2025-02-22,76667.04,investment_income,in,Counterparty_47,22300105.43,,
2025-02-22,4239.25,T&E,out,Counterparty_58,22295866.18,2025-01-21,2025-02-17
2025-02-22,4202.17,T&E,out,Counterparty_8,22291664.01,2025-01-25,2025-02-20
2025-02-22,815.05,loan_repayment,out,Counterparty_8,22290848.96,2025-02-07,2025-03-17
2025-02-22,612.42,marketing_spend,out,Counterparty_91,22290236.54,2025-01-25,2025-02-19
2025-02-22,11051.25,investment_income,in,Counterparty_1,22301287.79,,
2025-02-22,6579.98,software_subscription,out,Counterparty_30,22294707.81,2025-01-26,2025-02-20
2025-02-22,47342.57,T&E,out,Counterparty_16,22247365.24,2025-02-06,2025-03-12
2025-02-22,20950.12,customer_payment,in,Counterparty_65,22268315.36,,
2025-02-22,3024.93,T&E,out,Counterparty_90,22265290.43,2025-01-30,2025-02-24
2025-02-22,13399.01,asset_sale,in,Counterparty_66,22278689.44,,
2025-02-22,20674.31,rent,out,Counterparty_85,22258015.13,2025-02-06,2025-03-10
2025-02-22,10589.28,supplier_payment,out,Counterparty_9,22247425.85,2025-01-17,2025-02-20
2025-02-22,4344.99,utilities,out,Counterparty_4,22243080.86,2025-02-04,2025-03-15
2025-02-22,7888.28,software_subscription,out,Counterparty_87,22235192.58,2025-01-21,2025-02-18
2025-02-22,3676.5,marketing_spend,out,Counterparty_19,22231516.08,2025-02-07,2025-03-18
2025-02-22,2428.27,marketing_spend,out,Counterparty_67,22229087.81,2025-01-23,2025-03-02
2025-02-22,14106.74,utilities,out,Counterparty_3,22214981.07,2025-01-11,2025-02-17
2025-02-22,11836.34,tax_payment,out,Counterparty_96,22203144.73,2025-01-18,2025-02-22
2025-02-22,2952.56,marketing_spend,out,Counterparty_94,22200192.17,2025-02-05,2025-03-14
2025-02-22,45744.27,customer_payment,in,Counterparty_51,22245936.44,,
2025-02-22,28052.25,refund,in,Counterparty_21,22273988.69,,
2025-02-22,4269.28,utilities,out,Counterparty_48,22269719.41,2025-01-12,2025-02-07
2025-02-23,4477.38,customer_payment,in,Counterparty_58,22274196.79,,
2025-02-23,33622.81,marketing_spend,out,Counterparty_6,22240573.98,2025-01-10,2025-02-04
2025-02-23,38718.98,rent,out,Counterparty_12,22201855.0,2025-02-04,2025-03-12
2025-02-23,30783.14,tax_payment,out,Counterparty_64,22171071.86,2025-02-02,2025-03-06
2025-02-23,21925.68,refund,in,Counterparty_25,22192997.54,,
2025-02-23,20629.2,loan_repayment,out,Counterparty_95,22172368.34,2025-02-04,2025-03-02
2025-02-23,36837.41,refund,in,Counterparty_56,22209205.75,,
2025-02-23,22848.38,rent,out,Counterparty_3,22186357.37,2025-01-23,2025-02-21
2025-02-23,5056.74,investment_income,in,Counterparty_64,22191414.11,,
2025-02-23,16858.94,refund,in,Counterparty_78,22208273.05,,
2025-02-23,33953.26,T&E,out,Counterparty_12,22174319.79,2025-01-20,2025-02-28
2025-02-23,68.0,refund,in,Counterparty_42,22174387.79,,
2025-02-23,37249.35,rent,out,Counterparty_89,22137138.44,2025-02-04,2025-03-02
2025-02-23,2571.91,tax_payment,out,Counterparty_21,22134566.53,2025-02-06,2025-03-07
2025-02-23,11997.08,software_subscription,out,Counterparty_76,22122569.45,2025-01-18,2025-02-20
2025-02-23,6004.33,supplier_payment,out,Counterparty_37,22116565.12,2025-01-15,2025-02-20
2025-02-23,5677.57,software_subscription,out,Counterparty_96,22110887.55,2025-01-10,2025-02-09
2025-02-23,59359.89,marketing_spend,out,Counterparty_31,22051527.66,2025-01-13,2025-02-19
2025-02-23,36751.87,loan_repayment,out,Counterparty_65,22014775.79,2025-01-28,2025-03-02
2025-02-23,16548.15,utilities,out,Counterparty_67,21998227.64,2025-01-27,2025-02-27
2025-02-23,8096.82,loan_repayment,out,Counterparty_41,21990130.82,2025-01-24,2025-02-28
2025-02-23,1927.21,customer_payment,in,Counterparty_90,21992058.03,,
2025-02-23,18980.01,loan_repayment,out,Counterparty_34,21973078.02,2025-01-19,2025-02-19
2025-02-23,36622.89,tax_payment,out,Counterparty_78,21936455.13,2025-01-21,2025-02-24
2025-02-23,1519.32,customer_payment,in,Counterparty_25,21937974.45,,
2025-02-23,9628.08,customer_payment,in,Counterparty_77,21947602.53,,
2025-02-23,5486.46,refund,in,Counterparty_78,21953088.99,,
2025-02-23,4170.62,tax_payment,out,Counterparty_74,21948918.37,2025-01-12,2025-02-17
2025-02-23,45125.65,credit,in,Counterparty_49,21994044.02,,
2025-02-23,68329.11,refund,in,Counterparty_37,22062373.13,,
2025-02-23,29770.64,investment_income,in,Counterparty_40,22092143.77,,
2025-02-23,31416.1,credit,in,Counterparty_20,22123559.87,,
2025-02-23,6987.71,asset_sale,in,Counterparty_33,22130547.58,,
2025-02-23,1822.89,software_subscription,out,Counterparty_3,22128724.69,2025-01-21,2025-02-16
2025-02-23,9998.82,investment_income,in,Counterparty_17,22138723.51,,
2025-02-23,6052.67,software_subscription,out,Counterparty_97,22132670.84,2025-02-07,2025-03-10
2025-02-23,2893.91,investment_income,in,Counterparty_33,22135564.75,,
2025-02-23,4068.64,refund,in,Counterparty_36,22139633.39,,
2025-02-23,11844.74,credit,in,Counterparty_27,22151478.13,,
2025-02-23,10431.65,refund,in,Counterparty_30,22161909.78,,
2025-02-23,10166.76,rent,out,Counterparty_92,22151743.02,2025-01-12,2025-02-18
2025-02-23,7759.29,credit,in,Counterparty_29,22159502.31,,
2025-02-23,13494.52,investment_income,in,Counterparty_39,22172996.83,,
2025-02-24,5210.18,rent,out,Counterparty_10,22167786.65,2025-01-30,2025-03-05
2025-02-24,7092.85,customer_payment,in,Counterparty_46,22174879.5,,
2025-02-24,6707.28,asset_sale,in,Counterparty_43,22181586.78,,
2025-02-24,17645.02,investment_income,in,Counterparty_30,22199231.8,,
2025-02-24,23132.2,supplier_payment,out,Counterparty_47,22176099.6,2025-01-18,2025-02-16
2025-02-24,57704.54,investment_income,in,Counterparty_25,22233804.14,,
2025-02-24,88740.54,refund,in,Counterparty_37,22322544.68,,
2025-02-24,3399.72,investment_income,in,Counterparty_86,22325944.4,,
2025-02-24,8924.07,rent,out,Counterparty_42,22317020.33,2025-02-08,2025-03-16
2025-02-24,44793.37,software_subscription,out,Counterparty_21,22272226.96,2025-01-17,2025-02-11
2025-02-24,2204.88,tax_payment,out,Counterparty_51,22270022.08,2025-01-26,2025-02-22
2025-02-24,8959.98,utilities,out,Counterparty_31,22261062.1,2025-01-24,2025-03-03
2025-02-24,10012.63,supplier_payment,out,Counterparty_59,22251049.47,2025-01-17,2025-02-13
2025-02-24,36653.23,payroll,out,Counterparty_74,22214396.24,2025-01-11,2025-02-12
2025-02-24,27035.48,investment_income,in,Counterparty_18,22241431.72,,
2025-02-24,6363.28,tax_payment,out,Counterparty_56,22235068.44,2025-01-30,2025-02-28
2025-02-24,39027.82,utilities,out,Counterparty_17,22196040.62,2025-01-23,2025-02-27
2025-02-24,19015.83,rent,out,Counterparty_14,22177024.79,2025-01-29,2025-03-08
2025-02-24,24140.65,utilities,out,Counterparty_92,22152884.14,2025-01-30,2025-03-07
2025-02-24,2320.43,payroll,out,Counterparty_48,22150563.71,2025-01-13,2025-02-12
2025-02-24,3672.94,tax_payment,out,Counterparty_49,22146890.77,2025-01-23,2025-02-26
2025-02-24,14382.76,tax_payment,out,Counterparty_56,22132508.01,2025-01-18,2025-02-20
2025-02-24,2143.99,payroll,out,Counterparty_18,22130364.02,2025-02-05,2025-03-14
2025-02-24,17056.14,loan_repayment,out,Counterparty_41,22113307.88,2025-01-27,2025-02-23
2025-02-24,2245.44,marketing_spend,out,Counterparty_15,22111062.44,2025-01-23,2025-02-23
2025-02-24,16966.47,refund,in,Counterparty_32,22128028.91,,
2025-02-24,8993.44,marketing_spend,out,Counterparty_21,22119035.47,2025-01-22,2025-02-20
2025-02-24,10218.52,asset_sale,in,Counterparty_66,22129253.99,,
2025-02-24,4763.12,investment_income,in,Counterparty_25,22134017.11,,
2025-02-24,6651.53,supplier_payment,out,Counterparty_53,22127365.58,2025-01-12,2025-02-16
2025-02-24,719.58,utilities,out,Counterparty_43,22126646.0,2025-01-25,2025-02-19
2025-02-24,6850.9,refund,in,Counterparty_5,22133496.9,,
2025-02-24,544.67,software_subscription,out,Counterparty_85,22132952.23,2025-02-08,2025-03-13
2025-02-24,10343.84,tax_payment,out,Counterparty_74,22122608.39,2025-01-14,2025-02-21
2025-02-24,1845.12,marketing_spend,out,Counterparty_78,22120763.27,2025-01-26,2025-02-25
2025-02-24,1443.81,asset_sale,in,Counterparty_94,22122207.08,,
2025-02-24,38060.51,marketing_spend,out,Counterparty_16,22084146.57,2025-01-22,2025-02-22
2025-02-24,9496.32,loan_repayment,out,Counterparty_23,22074650.25,2025-02-09,2025-03-06
2025-02-24,734.42,utilities,out,Counterparty_96,22073915.83,2025-01-31,2025-03-09
2025-02-24,5397.69,refund,in,Counterparty_17,22079313.52,,
2025-02-24,31621.71,refund,in,Counterparty_80,22110935.23,,
2025-02-24,2958.72,supplier_payment,out,Counterparty_62,22107976.51,2025-01-17,2025-02-17
2025-02-24,16165.48,investment_income,in,Counterparty_99,22124141.99,,
2025-02-24,24546.5,asset_sale,in,Counterparty_13,22148688.49,,
2025-02-24,13469.4,loan_repayment,out,Counterparty_33,22135219.09,2025-01-25,2025-02-25
2025-02-24,3839.09,loan_repayment,out,Counterparty_34,22131380.0,2025-01-28,2025-02-25
2025-02-24,21416.67,credit,in,Counterparty_41,22152796.67,,
2025-02-25,13681.75,tax_payment,out,Counterparty_8,22139114.92,2025-02-04,2025-03-08
2025-02-25,55743.52,supplier_payment,out,Counterparty_69,22083371.4,2025-01-21,2025-03-01
2025-02-25,5557.71,loan_repayment,out,Counterparty_20,22077813.69,2025-01-12,2025-02-08
2025-02-25,1303.59,loan_repayment,out,Counterparty_31,22076510.1,2025-01-14,2025-02-11
2025-02-25,8159.4,T&E,out,Counterparty_36,22068350.7,2025-01-24,2025-02-27
2025-02-25,16317.02,tax_payment,out,Counterparty_69,22052033.68,2025-02-10,2025-03-18
2025-02-25,41697.98,T&E,out,Counterparty_12,22010335.7,2025-01-24,2025-02-19
2025-02-25,5004.89,supplier_payment,out,Counterparty_35,22005330.81,2025-02-06,2025-03-07
2025-02-25,6481.64,software_subscription,out,Counterparty_7,21998849.17,2025-02-02,2025-03-08
2025-02-25,20257.7,marketing_spend,out,Counterparty_30,21978591.47,2025-01-24,2025-02-22
2025-02-25,7786.41,loan_repayment,out,Counterparty_63,21970805.06,2025-01-26,2025-02-26
2025-02-25,8837.36,loan_repayment,out,Counterparty_2,21961967.7,2025-01-25,2025-02-26
2025-02-25,20563.97,software_subscription,out,Counterparty_91,21941403.73,2025-01-17,2025-02-24
2025-02-25,21173.33,payroll,out,Counterparty_82,21920230.4,2025-01-21,2025-02-28
2025-02-25,1993.35,marketing_spend,out,Counterparty_88,21918237.05,2025-02-06,2025-03-16
2025-02-25,29245.24,software_subscription,out,Counterparty_83,21888991.81,2025-01-16,2025-02-22
2025-02-25,2582.69,asset_sale,in,Counterparty_49,21891574.5,,
2025-02-25,24300.71,supplier_payment,out,Counterparty_36,21867273.79,2025-02-03,2025-03-13
2025-02-25,50726.85,payroll,out,Counterparty_99,21816546.94,2025-02-04,2025-03-10
2025-02-25,36781.28,loan_repayment,out,Counterparty_82,21779765.66,2025-01-19,2025-02-27
2025-02-25,10034.57,rent,out,Counterparty_13,21769731.09,2025-01-22,2025-02-17
2025-02-25,3144.14,tax_payment,out,Counterparty_29,21766586.95,2025-01-18,2025-02-23
2025-02-25,19118.23,refund,in,Counterparty_1,21785705.18,,
2025-02-25,70268.71,credit,in,Counterparty_35,21855973.89,,
2025-02-25,32854.98,asset_sale,in,Counterparty_7,21888828.87,,
2025-02-25,15133.53,utilities,out,Counterparty_76,21873695.34,2025-01-27,2025-03-05
2025-02-25,13252.64,refund,in,Counterparty_46,21886947.98,,
2025-02-25,34732.7,supplier_payment,out,Counterparty_35,21852215.28,2025-01-23,2025-02-22
2025-02-25,18501.71,T&E,out,Counterparty_98,21833713.57,2025-01-17,2025-02-22
2025-02-25,4908.89,asset_sale,in,Counterparty_4,21838622.46,,
2025-02-25,40762.64,credit,in,Counterparty_83,21879385.1,,
2025-02-25,13865.0,customer_payment,in,Counterparty_29,21893250.1,,
2025-02-25,44491.22,payroll,out,Counterparty_64,21848758.88,2025-02-08,2025-03-19
2025-02-25,13681.2,credit,in,Counterparty_63,21862440.08,,
2025-02-25,8486.97,asset_sale,in,Counterparty_23,21870927.05,,
2025-02-25,2992.44,rent,out,Counterparty_14,21867934.61,2025-01-21,2025-02-17
2025-02-25,2964.15,payroll,out,Counterparty_24,21864970.46,2025-02-02,2025-03-07
2025-02-25,53044.91,investment_income,in,Counterparty_65,21918015.37,,
2025-02-25,40206.68,software_subscription,out,Counterparty_26,21877808.69,2025-01-19,2025-02-23
2025-02-25,62877.69,payroll,out,Counterparty_54,21814931.0,2025-02-06,2025-03-05
2025-02-25,10934.38,T&E,out,Counterparty_25,21803996.62,2025-02-10,2025-03-10
2025-02-25,22232.02,payroll,out,Counterparty_21,21781764.6,2025-01-23,2025-02-20
2025-02-25,37296.48,supplier_payment,out,Counterparty_4,21744468.12,2025-02-10,2025-03-18
2025-02-25,720.51,marketing_spend,out,Counterparty_79,21743747.61,2025-01-21,2025-02-17
2025-02-26,32981.22,tax_payment,out,Counterparty_71,21710766.39,2025-01-20,2025-02-28
2025-02-26,13310.85,marketing_spend,out,Counterparty_41,21697455.54,2025-01-16,2025-02-23
2025-02-26,11929.99,customer_payment,in,Counterparty_73,21709385.53,,
2025-02-26,14351.59,rent,out,Counterparty_65,21695033.94,2025-01-27,2025-02-21
2025-02-26,13151.72,rent,out,Counterparty_17,21681882.22,2025-01-21,2025-02-17
2025-02-26,54124.52,customer_payment,in,Counterparty_75,21736006.74,,
2025-02-26,21748.28,credit,in,Counterparty_39,21757755.02,,
2025-02-26,53202.37,customer_payment,in,Counterparty_45,21810957.39,,
2025-02-26,15813.16,utilities,out,Counterparty_60,21795144.23,2025-01-19,2025-02-23
2025-02-26,1272.95,utilities,out,Counterparty_62,21793871.28,2025-02-09,2025-03-09
2025-02-26,14504.17,refund,in,Counterparty_5,21808375.45,,
2025-02-26,3680.94,utilities,out,Counterparty_76,21804694.51,2025-01-13,2025-02-16
2025-02-26,5724.6,refund,in,Counterparty_34,21810419.11,,
2025-02-26,23119.13,asset_sale,in,Counterparty_32,21833538.24,,
2025-02-26,10255.81,credit,in,Counterparty_19,21843794.05,,
2025-02-26,9759.05,asset_sale,in,Counterparty_85,21853553.1,,
2025-02-26,58171.57,refund,in,Counterparty_33,21911724.67,,
2025-02-26,30938.49,supplier_payment,out,Counterparty_37,21880786.18,2025-01-28,2025-02-25
2025-02-26,61461.07,refund,in,Counterparty_49,21942247.25,,
2025-02-26,23918.25,refund,in,Counterparty_98,21966165.5,,
2025-02-26,5612.36,customer_payment,in,Counterparty_23,21971777.86,,
2025-02-26,23802.74,investment_income,in,Counterparty_23,21995580.6,,
2025-02-26,2391.56,refund,in,Counterparty_24,21997972.16,,
2025-02-26,2879.84,payroll,out,Counterparty_61,21995092.32,2025-01-14,2025-02-15
2025-02-26,11835.34,software_subscription,out,Counterparty_98,21983256.98,2025-02-03,2025-03-05
2025-02-26,32668.57,refund,in,Counterparty_45,22015925.55,,
2025-02-26,19665.88,software_subscription,out,Counterparty_55,21996259.67,2025-02-05,2025-03-15
2025-02-26,3203.86,software_subscription,out,Counterparty_70,21993055.81,2025-01-24,2025-02-26
2025-02-26,27448.86,T&E,out,Counterparty_27,21965606.95,2025-02-03,2025-03-01
2025-02-26,5509.27,payroll,out,Counterparty_57,21960097.68,2025-02-09,2025-03-15
2025-02-26,14879.94,software_subscription,out,Counterparty_84,21945217.74,2025-02-04,2025-03-07
2025-02-26,31277.29,supplier_payment,out,Counterparty_31,21913940.45,2025-02-07,2025-03-09
2025-02-26,4853.31,software_subscription,out,Counterparty_81,21909087.14,2025-01-23,2025-02-26
2025-02-26,2577.6,utilities,out,Counterparty_59,21906509.54,2025-01-31,2025-03-08
2025-02-26,16575.64,supplier_payment,out,Counterparty_62,21889933.9,2025-01-24,2025-03-04
2025-02-26,4557.26,supplier_payment,out,Counterparty_5,21885376.64,2025-02-01,2025-03-12
2025-02-26,2142.18,tax_payment,out,Counterparty_48,21883234.46,2025-01-20,2025-02-15
2025-02-26,15117.54,loan_repayment,out,Counterparty_78,21868116.92,2025-01-26,2025-02-24
2025-02-26,74736.58,investment_income,in,Counterparty_60,21942853.5,,
2025-02-26,10948.98,refund,in,Counterparty_37,21953802.48,,
2025-02-26,13660.64,T&E,out,Counterparty_31,21940141.84,2025-01-23,2025-02-24
2025-02-26,45427.09,marketing_spend,out,Counterparty_67,21894714.75,2025-01-29,2025-03-01
2025-02-26,13475.13,credit,in,Counterparty_77,21908189.88,,
2025-02-26,4857.2,T&E,out,Counterparty_76,21903332.68,2025-02-11,2025-03-13
2025-02-26,24042.22,T&E,out,Counterparty_23,21879290.46,2025-01-26,2025-02-21
2025-02-26,2588.66,utilities,out,Counterparty_15,21876701.8,2025-01-28,2025-03-02
2025-02-26,79.6,investment_income,in,Counterparty_84,21876781.4,,
2025-02-26,793.58,software_subscription,out,Counterparty_46,21875987.82,2025-01-17,2025-02-15
2025-02-26,21775.05,refund,in,Counterparty_18,21897762.87,,
2025-02-26,1830.01,T&E,out,Counterparty_48,21895932.86,2025-01-29,2025-03-04
2025-02-26,15003.24,payroll,out,Counterparty_60,21880929.62,2025-01-13,2025-02-15
2025-02-26,13686.77,investment_income,in,Counterparty_46,21894616.39,,
2025-02-26,130.69,marketing_spend,out,Counterparty_20,21894485.7,2025-01-22,2025-02-24
2025-02-27,55325.63,marketing_spend,out,Counterparty_14,21839160.07,2025-01-31,2025-03-06
2025-02-27,433.89,software_subscription,out,Counterparty_40,21838726.18,2025-02-03,2025-03-03
2025-02-27,28790.08,payroll,out,Counterparty_40,21809936.1,2025-01-31,2025-02-26
2025-02-27,719.4,supplier_payment,out,Counterparty_56,21809216.7,2025-01-27,2025-03-02
2025-02-27,9094.44,tax_payment,out,Counterparty_16,21800122.26,2025-01-20,2025-02-22
2025-02-27,13464.87,payroll,out,Counterparty_76,21786657.39,2025-01-27,2025-02-26
2025-02-27,27243.42,software_subscription,out,Counterparty_66,21759413.97,2025-02-09,2025-03-20
2025-02-27,39708.45,loan_repayment,out,Counterparty_40,21719705.52,2025-01-17,2025-02-14
2025-02-27,4404.38,asset_sale,in,Counterparty_51,21724109.9,,
2025-02-27,4049.98,marketing_spend,out,Counterparty_17,21720059.92,2025-02-12,2025-03-18
2025-02-27,1035.34,customer_payment,in,Counterparty_34,21721095.26,,
2025-02-27,20683.29,credit,in,Counterparty_44,21741778.55,,
2025-02-27,27480.55,credit,in,Counterparty_91,21769259.1,,
2025-02-27,57634.56,asset_sale,in,Counterparty_32,21826893.66,,
2025-02-27,3746.4,investment_income,in,Counterparty_26,21830640.06,,
2025-02-27,8049.69,T&E,out,Counterparty_7,21822590.37,2025-01-30,2025-02-24
2025-02-27,6265.1,supplier_payment,out,Counterparty_18,21816325.27,2025-01-17,2025-02-25
2025-02-27,45504.97,loan_repayment,out,Counterparty_91,21770820.3,2025-01-14,2025-02-21
2025-02-27,6012.17,customer_payment,in,Counterparty_78,21776832.47,,
2025-02-27,31882.58,utilities,out,Counterparty_86,21744949.89,2025-02-01,2025-03-09
2025-02-27,10290.56,utilities,out,Counterparty_93,21734659.33,2025-01-20,2025-02-14
2025-02-27,30125.12,credit,in,Counterparty_1,21764784.45,,
2025-02-27,4002.96,payroll,out,Counterparty_15,21760781.49,2025-02-09,2025-03-14
2025-02-27,48058.55,marketing_spend,out,Counterparty_28,21712722.94,2025-02-06,2025-03-10
2025-02-27,40351.65,refund,in,Counterparty_57,21753074.59,,
2025-02-27,16933.72,refund,in,Counterparty_6,21770008.31,,
2025-02-27,23339.98,T&E,out,Counterparty_93,21746668.33,2025-01-24,2025-02-19
2025-02-27,13273.14,asset_sale,in,Counterparty_57,21759941.47,,
2025-02-27,13203.86,customer_payment,in,Counterparty_53,21773145.33,,
2025-02-27,13803.42,marketing_spend,out,Counterparty_47,21759341.91,2025-01-27,2025-02-28
2025-02-27,17684.45,rent,out,Counterparty_81,21741657.46,2025-02-09,2025-03-12
2025-02-27,1558.51,tax_payment,out,Counterparty_32,21740098.95,2025-02-12,2025-03-18
2025-02-27,18564.71,supplier_payment,out,Counterparty_28,21721534.24,2025-01-25,2025-02-24
2025-02-27,26232.02,payroll,out,Counterparty_85,21695302.22,2025-01-30,2025-03-05
2025-02-27,42366.22,payroll,out,Counterparty_47,21652936.0,2025-01-29,2025-02-27
2025-02-27,32397.54,refund,in,Counterparty_1,21685333.54,,
2025-02-27,11688.89,tax_payment,out,Counterparty_53,21673644.65,2025-02-01,2025-02-28
2025-02-27,7980.12,marketing_spend,out,Counterparty_99,21665664.53,2025-02-07,2025-03-09
2025-02-27,53654.46,marketing_spend,out,Counterparty_65,21612010.07,2025-01-27,2025-03-01
2025-02-28,14923.52,refund,in,Counterparty_87,21626933.59,,
2025-02-28,28185.0,credit,in,Counterparty_24,21655118.59,,
2025-02-28,6192.43,refund,in,Counterparty_22,21661311.02,,
2025-02-28,1152.07,supplier_payment,out,Counterparty_89,21660158.95,2025-01-23,2025-02-28
2025-02-28,107339.31,credit,in,Counterparty_49,21767498.26,,
2025-02-28,10575.07,credit,in,Counterparty_73,21778073.33,,
2025-02-28,3513.87,investment_income,in,Counterparty_69,21781587.2,,
2025-02-28,14822.15,investment_income,in,Counterparty_39,21796409.35,,
2025-02-28,19336.26,investment_income,in,Counterparty_29,21815745.61,,
2025-02-28,26976.86,asset_sale,in,Counterparty_26,21842722.47,,
2025-02-28,9934.16,supplier_payment,out,Counterparty_84,21832788.31,2025-01-27,2025-02-24
2025-02-28,3783.41,investment_income,in,Counterparty_19,21836571.72,,
2025-02-28,4532.27,payroll,out,Counterparty_17,21832039.45,2025-01-21,2025-02-22
2025-02-28,25013.04,investment_income,in,Counterparty_53,21857052.49,,
2025-02-28,6178.08,investment_income,in,Counterparty_98,21863230.57,,
2025-02-28,58811.44,asset_sale,in,Counterparty_77,21922042.01,,
2025-02-28,28052.0,credit,in,Counterparty_58,21950094.01,,
2025-02-28,18421.76,software_subscription,out,Counterparty_93,21931672.25,2025-01-20,2025-02-23
2025-02-28,1645.71,investment_income,in,Counterparty_70,21933317.96,,
2025-02-28,10383.94,supplier_payment,out,Counterparty_80,21922934.02,2025-01-30,2025-03-01
2025-02-28,8667.57,payroll,out,Counterparty_66,21914266.45,2025-01-16,2025-02-23
2025-02-28,99.75,utilities,out,Counterparty_87,21914166.7,2025-01-25,2025-02-20
2025-02-28,900.85,rent,out,Counterparty_31,21913265.85,2025-01-24,2025-02-19
2025-02-28,10343.5,utilities,out,Counterparty_17,21902922.35,2025-02-13,2025-03-20
2025-02-28,25645.54,software_subscription,out,Counterparty_8,21877276.81,2025-02-08,2025-03-09
2025-02-28,35001.83,supplier_payment,out,Counterparty_8,21842274.98,2025-02-10,2025-03-12
2025-02-28,3515.07,refund,in,Counterparty_71,21845790.05,,
2025-02-28,6299.09,utilities,out,Counterparty_87,21839490.96,2025-01-31,2025-03-08
2025-02-28,9328.3,investment_income,in,Counterparty_71,21848819.26,,
2025-02-28,22377.67,credit,in,Counterparty_70,21871196.93,,
2025-02-28,19699.73,credit,in,Counterparty_28,21890896.66,,
2025-02-28,25920.95,customer_payment,in,Counterparty_55,21916817.61,,
2025-02-28,23203.75,investment_income,in,Counterparty_29,21940021.36,,
2025-02-28,4065.04,asset_sale,in,Counterparty_59,21944086.4,,
2025-02-28,14251.54,T&E,out,Counterparty_84,21929834.86,2025-01-21,2025-03-01
2025-02-28,5520.86,loan_repayment,out,Counterparty_13,21924314.0,2025-02-13,2025-03-17
2025-02-28,10027.41,customer_payment,in,Counterparty_85,21934341.41,,
2025-03-01,1995.15,software_subscription,out,Counterparty_92,21932346.26,2025-01-28,2025-03-02
2025-03-01,5201.45,asset_sale,in,Counterparty_59,21937547.71,,
2025-03-01,5266.9,T&E,out,Counterparty_83,21932280.81,2025-02-02,2025-03-05
2025-03-01,1235.12,credit,in,Counterparty_93,21933515.93,,
2025-03-01,1489.93,credit,in,Counterparty_12,21935005.86,,
2025-03-01,630.43,refund,in,Counterparty_53,21935636.29,,
2025-03-01,4884.72,credit,in,Counterparty_15,21940521.01,,
2025-03-01,17024.78,tax_payment,out,Counterparty_99,21923496.23,2025-01-20,2025-02-20
2025-03-01,3009.59,tax_payment,out,Counterparty_6,21920486.64,2025-02-10,2025-03-21
2025-03-01,6803.42,tax_payment,out,Counterparty_79,21913683.22,2025-01-22,2025-02-26
2025-03-01,1334.34,refund,in,Counterparty_28,21915017.56,,
2025-03-01,10588.68,T&E,out,Counterparty_50,21904428.88,2025-01-25,2025-02-28
2025-03-01,3575.94,supplier_payment,out,Counterparty_41,21900852.94,2025-01-28,2025-02-23
2025-03-01,8221.57,supplier_payment,out,Counterparty_80,21892631.37,2025-01-28,2025-02-24
2025-03-01,9962.06,tax_payment,out,Counterparty_92,21882669.31,2025-01-21,2025-02-24
2025-03-01,7401.33,investment_income,in,Counterparty_42,21890070.64,,
2025-03-01,3248.93,refund,in,Counterparty_31,21893319.57,,
2025-03-01,8312.06,T&E,out,Counterparty_24,21885007.51,2025-01-28,2025-02-22
2025-03-01,1028.68,loan_repayment,out,Counterparty_25,21883978.83,2025-01-16,2025-02-18
2025-03-01,227.87,credit,in,Counterparty_2,21884206.7,,
2025-03-01,856.69,customer_payment,in,Counterparty_77,21885063.39,,
2025-03-01,1417.08,supplier_payment,out,Counterparty_32,21883646.31,2025-01-27,2025-03-04
2025-03-01,4144.09,utilities,out,Counterparty_83,21879502.22,2025-01-30,2025-02-24
2025-03-01,2258.5,credit,in,Counterparty_35,21881760.72,,
2025-03-01,1007.56,refund,in,Counterparty_89,21882768.28,,
2025-03-01,3166.39,tax_payment,out,Counterparty_79,21879601.89,2025-01-20,2025-02-21
2025-03-01,916.67,customer_payment,in,Counterparty_81,21880518.56,,
2025-03-01,1378.95,T&E,out,Counterparty_18,21879139.61,2025-01-18,2025-02-24
2025-03-01,13660.8,software_subscription,out,Counterparty_76,21865478.81,2025-02-06,2025-03-07
2025-03-01,7679.03,asset_sale,in,Counterparty_19,21873157.84,,
2025-03-01,434.77,credit,in,Counterparty_42,21873592.61,,
2025-03-01,272.47,T&E,out,Counterparty_38,21873320.14,2025-02-06,2025-03-06
2025-03-01,4762.73,customer_payment,in,Counterparty_76,21878082.87,,
2025-03-01,3530.59,utilities,out,Counterparty_55,21874552.28,2025-02-12,2025-03-11
2025-03-01,1138.33,investment_income,in,Counterparty_38,21875690.61,,
2025-03-01,11645.5,asset_sale,in,Counterparty_2,21887336.11,,
2025-03-01,4373.86,refund,in,Counterparty_8,21891709.97,,
2025-03-01,4953.94,supplier_payment,out,Counterparty_87,21886756.03,2025-02-03,2025-03-13
2025-03-01,515.48,credit,in,Counterparty_47,21887271.51,,
2025-03-01,5846.64,rent,out,Counterparty_62,21881424.87,2025-01-23,2025-02-25
2025-03-01,3747.56,software_subscription,out,Counterparty_14,21877677.31,2025-02-05,2025-03-08
2025-03-01,3426.88,asset_sale,in,Counterparty_94,21881104.19,,
2025-03-01,5395.66,payroll,out,Counterparty_94,21875708.53,2025-02-08,2025-03-16
2025-03-01,19083.53,software_subscription,out,Counterparty_82,21856625.0,2025-01-24,2025-02-18
2025-03-01,374.27,utilities,out,Counterparty_85,21856250.73,2025-02-14,2025-03-13
2025-03-01,5408.08,rent,out,Counterparty_18,21850842.65,2025-01-23,2025-02-22
2025-03-01,1026.32,loan_repayment,out,Counterparty_88,21849816.33,2025-02-04,2025-03-10
2025-03-01,2672.73,customer_payment,in,Counterparty_39,21852489.06,,
2025-03-01,16462.19,software_subscription,out,Counterparty_61,21836026.87,2025-01-30,2025-02-25
2025-03-01,2050.12,credit,in,Counterparty_1,21838076.99,,
2025-03-01,5457.4,rent,out,Counterparty_49,21832619.59,2025-01-24,2025-02-21
2025-03-01,115.16,software_subscription,out,Counterparty_12,21832504.43,2025-02-10,2025-03-12
2025-03-02,594.63,software_subscription,out,Counterparty_92,21831909.8,2025-01-18,2025-02-20
2025-03-02,116.38,rent,out,Counterparty_48,21831793.42,2025-01-30,2025-03-07
2025-03-02,94.31,tax_payment,out,Counterparty_21,21831699.11,2025-01-17,2025-02-21
2025-03-02,4298.33,investment_income,in,Counterparty_7,21835997.44,,
2025-03-02,1799.79,tax_payment,out,Counterparty_82,21834197.65,2025-01-21,2025-02-15
2025-03-02,3224.97,refund,in,Counterparty_57,21837422.62,,
2025-03-02,1038.34,tax_payment,out,Counterparty_23,21836384.28,2025-02-14,2025-03-16
2025-03-02,10199.41,credit,in,Counterparty_71,21846583.69,,
2025-03-02,610.6,payroll,out,Counterparty_61,21845973.09,2025-01-26,2025-03-06
2025-03-02,15624.05,loan_repayment,out,Counterparty_19,21830349.04,2025-02-03,2025-03-07
2025-03-02,15538.36,utilities,out,Counterparty_39,21814810.68,2025-02-06,2025-03-16
2025-03-02,3461.86,utilities,out,Counterparty_17,21811348.82,2025-01-19,2025-02-21
2025-03-02,11122.17,customer_payment,in,Counterparty_82,21822470.99,,
2025-03-02,84.49,software_subscription,out,Counterparty_82,21822386.5,2025-01-24,2025-03-04
2025-03-02,9268.7,software_subscription,out,Counterparty_15,21813117.8,2025-01-24,2025-03-03
2025-03-02,354.12,software_subscription,out,Counterparty_16,21812763.68,2025-02-07,2025-03-05
2025-03-02,7682.0,customer_payment,in,Counterparty_24,21820445.68,,
2025-03-02,278.1,loan_repayment,out,Counterparty_61,21820167.58,2025-01-27,2025-03-06
2025-03-02,5019.67,credit,in,Counterparty_93,21825187.25,,
2025-03-02,2136.73,marketing_spend,out,Counterparty_15,21823050.52,2025-01-22,2025-02-18
2025-03-02,9256.35,customer_payment,in,Counterparty_72,21832306.87,,
2025-03-02,1181.9,credit,in,Counterparty_33,21833488.77,,
2025-03-02,4898.77,payroll,out,Counterparty_45,21828590.0,2025-02-14,2025-03-13
2025-03-02,950.16,loan_repayment,out,Counterparty_69,21827639.84,2025-02-13,2025-03-21
2025-03-02,12720.77,software_subscription,out,Counterparty_16,21814919.07,2025-01-24,2025-02-24
2025-03-02,2347.17,rent,out,Counterparty_2,21812571.9,2025-01-23,2025-02-25
2025-03-02,9542.6,supplier_payment,out,Counterparty_90,21803029.3,2025-02-01,2025-02-28
2025-03-02,10967.46,investment_income,in,Counterparty_28,21813996.76,,
2025-03-02,4770.21,refund,in,Counterparty_99,21818766.97,,
2025-03-02,1969.46,payroll,out,Counterparty_25,21816797.51,2025-02-13,2025-03-23
2025-03-02,5257.27,marketing_spend,out,Counterparty_41,21811540.24,2025-02-11,2025-03-22
2025-03-02,603.67,software_subscription,out,Counterparty_22,21810936.57,2025-01-17,2025-02-24
2025-03-02,1289.8,tax_payment,out,Counterparty_83,21809646.77,2025-02-03,2025-03-04
2025-03-02,4387.49,refund,in,Counterparty_97,21814034.26,,
2025-03-02,15549.92,investment_income,in,Counterparty_54,21829584.18,,
2025-03-02,12013.16,investment_income,in,Counterparty_53,21841597.34,,
2025-03-02,9248.65,customer_payment,in,Counterparty_93,21850845.99,,
2025-03-02,2537.3,marketing_spend,out,Counterparty_56,21848308.69,2025-02-05,2025-03-05
2025-03-02,1005.36,asset_sale,in,Counterparty_53,21849314.05,,
2025-03-02,4027.16,marketing_spend,out,Counterparty_20,21845286.89,2025-02-15,2025-03-22
2025-03-02,4378.26,tax_payment,out,Counterparty_82,21840908.63,2025-02-09,2025-03-09
2025-03-02,978.69,tax_payment,out,Counterparty_95,21839929.94,2025-02-10,2025-03-15
2025-03-02,2355.68,investment_income,in,Counterparty_24,21842285.62,,
2025-03-02,7017.92,refund,in,Counterparty_65,21849303.54,,
2025-03-03,1886.34,supplier_payment,out,Counterparty_6,21847417.2,2025-02-04,2025-03-09
2025-03-03,4575.73,credit,in,Counterparty_15,21851992.93,,
2025-03-03,5208.91,asset_sale,in,Counterparty_46,21857201.84,,
2025-03-03,1478.33,T&E,out,Counterparty_16,21855723.51,2025-02-05,2025-03-12
2025-03-03,2475.78,asset_sale,in,Counterparty_86,21858199.29,,
2025-03-03,17450.04,refund,in,Counterparty_5,21875649.33,,
2025-03-03,2032.47,rent,out,Counterparty_56,21873616.86,2025-02-03,2025-03-01
2025-03-03,3602.43,refund,in,Counterparty_85,21877219.29,,
2025-03-03,2279.44,loan_repayment,out,Counterparty_34,21874939.85,2025-01-26,2025-02-21
2025-03-03,1956.28,customer_payment,in,Counterparty_74,21876896.13,,
2025-03-03,1554.99,payroll,out,Counterparty_71,21875341.14,2025-01-31,2025-02-25
2025-03-03,4155.35,asset_sale,in,Counterparty_80,21879496.49,,
2025-03-03,212.79,marketing_spend,out,Counterparty_10,21879283.7,2025-02-02,2025-03-02
2025-03-03,1654.52,tax_payment,out,Counterparty_81,21877629.18,2025-01-18,2025-02-26
2025-03-03,11472.67,software_subscription,out,Counterparty_99,21866156.51,2025-01-18,2025-02-25
2025-03-03,3699.81,loan_repayment,out,Counterparty_57,21862456.7,2025-02-10,2025-03-11
2025-03-03,1625.97,credit,in,Counterparty_32,21864082.67,,
2025-03-03,4131.73,customer_payment,in,Counterparty_67,21868214.4,,
2025-03-03,523.44,credit,in,Counterparty_43,21868737.84,,
2025-03-03,16.48,investment_income,in,Counterparty_52,21868754.32,,
2025-03-03,9383.82,loan_repayment,out,Counterparty_16,21859370.5,2025-02-14,2025-03-19
2025-03-03,2547.34,asset_sale,in,Counterparty_40,21861917.84,,
2025-03-03,1695.9,investment_income,in,Counterparty_58,21863613.74,,
2025-03-03,12271.91,tax_payment,out,Counterparty_3,21851341.83,2025-02-11,2025-03-16
2025-03-03,1457.13,software_subscription,out,Counterparty_39,21849884.7,2025-02-14,2025-03-20
2025-03-03,807.58,rent,out,Counterparty_86,21849077.12,2025-02-16,2025-03-25
2025-03-03,1001.66,refund,in,Counterparty_15,21850078.78,,
2025-03-03,2859.42,investment_income,in,Counterparty_59,21852938.2,,
2025-03-03,1748.33,loan_repayment,out,Counterparty_91,21851189.87,2025-01-18,2025-02-22
2025-03-03,4688.32,rent,out,Counterparty_22,21846501.55,2025-01-20,2025-02-27
2025-03-03,2742.46,customer_payment,in,Counterparty_85,21849244.01,,
2025-03-03,14583.31,refund,in,Counterparty_25,21863827.32,,
2025-03-03,3925.58,asset_sale,in,Counterparty_58,21867752.9,,
2025-03-03,3236.91,payroll,out,Counterparty_10,21864515.99,2025-01-19,2025-02-26
2025-03-03,6513.03,investment_income,in,Counterparty_70,21871029.02,,
2025-03-03,3493.0,refund,in,Counterparty_26,21874522.02,,
2025-03-03,3506.5,software_subscription,out,Counterparty_15,21871015.52,2025-02-05,2025-03-04
2025-03-03,374.88,investment_income,in,Counterparty_50,21871390.4,,
2025-03-04,1220.79,marketing_spend,out,Counterparty_62,21870169.61,2025-01-23,2025-03-01
2025-03-04,1182.33,utilities,out,Counterparty_73,21868987.28,2025-02-03,2025-03-09
2025-03-04,3362.33,asset_sale,in,Counterparty_68,21872349.61,,
2025-03-04,10936.57,T&E,out,Counterparty_27,21861413.04,2025-01-25,2025-02-26
2025-03-04,375.53,tax_payment,out,Counterparty_8,21861037.51,2025-01-20,2025-02-25
2025-03-04,332.35,rent,out,Counterparty_97,21860705.16,2025-01-23,2025-03-02
2025-03-04,727.33,marketing_spend,out,Counterparty_77,21859977.83,2025-02-16,2025-03-27
2025-03-04,1777.84,T&E,out,Counterparty_20,21858199.99,2025-01-23,2025-02-21
2025-03-04,8952.04,credit,in,Counterparty_89,21867152.03,,
2025-03-04,4080.01,investment_income,in,Counterparty_75,21871232.04,,
2025-03-04,8028.23,rent,out,Counterparty_88,21863203.81,2025-02-10,2025-03-15
2025-03-04,505.43,utilities,out,Counterparty_1,21862698.38,2025-01-30,2025-03-10
2025-03-04,2358.0,supplier_payment,out,Counterparty_13,21860340.38,2025-01-28,2025-03-02
2025-03-04,6135.86,software_subscription,out,Counterparty_38,21854204.52,2025-01-30,2025-03-08
2025-03-04,906.24,supplier_payment,out,Counterparty_29,21853298.28,2025-02-05,2025-03-07
2025-03-04,7019.0,credit,in,Counterparty_95,21860317.28,,
2025-03-04,9177.58,payroll,out,Counterparty_73,21851139.7,2025-02-08,2025-03-05
2025-03-04,994.3,payroll,out,Counterparty_4,21850145.4,2025-02-02,2025-03-10
2025-03-04,16.8,software_subscription,out,Counterparty_22,21850128.6,2025-01-24,2025-03-02
2025-03-04,2379.21,payroll,out,Counterparty_61,21847749.39,2025-01-30,2025-03-02
2025-03-04,8324.36,loan_repayment,out,Counterparty_47,21839425.03,2025-02-10,2025-03-13
2025-03-04,5130.94,credit,in,Counterparty_83,21844555.97,,
2025-03-04,6655.2,refund,in,Counterparty_33,21851211.17,,
2025-03-04,6947.54,utilities,out,Counterparty_26,21844263.63,2025-02-07,2025-03-10
2025-03-04,1097.32,investment_income,in,Counterparty_16,21845360.95,,
2025-03-04,1859.27,investment_income,in,Counterparty_14,21847220.22,,
2025-03-04,2370.97,T&E,out,Counterparty_45,21844849.25,2025-02-07,2025-03-15
2025-03-04,2406.46,marketing_spend,out,Counterparty_30,21842442.79,2025-02-17,2025-03-17
2025-03-04,683.36,payroll,out,Counterparty_12,21841759.43,2025-02-12,2025-03-09
2025-03-04,1849.73,asset_sale,in,Counterparty_30,21843609.16,,
2025-03-04,6980.44,rent,out,Counterparty_32,21836628.72,2025-02-16,2025-03-15
2025-03-04,3439.81,asset_sale,in,Counterparty_4,21840068.53,,
2025-03-04,6183.47,asset_sale,in,Counterparty_86,21846252.0,,
2025-03-04,4034.51,payroll,out,Counterparty_79,21842217.49,2025-01-28,2025-02-28
2025-03-04,236.52,rent,out,Counterparty_71,21841980.97,2025-02-09,2025-03-13
2025-03-04,4219.67,software_subscription,out,Counterparty_1,21837761.3,2025-02-09,2025-03-14
2025-03-04,2465.54,utilities,out,Counterparty_88,21835295.76,2025-01-28,2025-03-01
2025-03-04,3696.89,tax_payment,out,Counterparty_94,21831598.87,2025-02-07,2025-03-16
2025-03-04,2712.73,marketing_spend,out,Counterparty_94,21828886.14,2025-01-27,2025-02-28
2025-03-04,1307.8,customer_payment,in,Counterparty_86,21830193.94,,
2025-03-04,4018.56,software_subscription,out,Counterparty_95,21826175.38,2025-02-08,2025-03-13
2025-03-04,3077.88,T&E,out,Counterparty_38,21823097.5,2025-01-24,2025-02-27
2025-03-04,344.58,investment_income,in,Counterparty_9,21823442.08,,
2025-03-04,18294.72,customer_payment,in,Counterparty_33,21841736.8,,
2025-03-04,2718.34,credit,in,Counterparty_26,21844455.14,,
2025-03-04,11317.5,customer_payment,in,Counterparty_39,21855772.64,,
2025-03-04,4293.27,utilities,out,Counterparty_90,21851479.37,2025-02-07,2025-03-18
2025-03-04,897.74,credit,in,Counterparty_12,21852377.11,,
2025-03-04,2710.64,marketing_spend,out,Counterparty_84,21849666.47,2025-02-04,2025-03-04
2025-03-04,5776.33,utilities,out,Counterparty_90,21843890.14,2025-01-28,2025-02-24
2025-03-04,638.16,refund,in,Counterparty_66,21844528.3,,
2025-03-05,5730.8,utilities,out,Counterparty_3,21838797.5,2025-01-27,2025-03-05
2025-03-05,3593.86,supplier_payment,out,Counterparty_79,21835203.64,2025-02-05,2025-03-16
2025-03-05,22372.34,payroll,out,Counterparty_85,21812831.3,2025-01-29,2025-03-09
2025-03-05,6621.04,tax_payment,out,Counterparty_14,21806210.26,2025-02-14,2025-03-18
2025-03-05,3821.8,tax_payment,out,Counterparty_76,21802388.46,2025-02-12,2025-03-13
2025-03-05,3462.33,asset_sale,in,Counterparty_98,21805850.79,,
2025-03-05,4134.78,credit,in,Counterparty_5,21809985.57,,
2025-03-05,1761.43,refund,in,Counterparty_36,21811747.0,,
2025-03-05,4296.67,rent,out,Counterparty_59,21807450.33,2025-02-01,2025-03-02
2025-03-05,1829.38,refund,in,Counterparty_39,21809279.71,,
2025-03-05,6445.15,customer_payment,in,Counterparty_54,21815724.86,,
2025-03-05,32.89,refund,in,Counterparty_18,21815757.75,,
2025-03-05,103.2,rent,out,Counterparty_69,21815654.55,2025-02-01,2025-03-10
2025-03-05,4293.05,customer_payment,in,Counterparty_93,21819947.6,,
2025-03-05,4578.62,loan_repayment,out,Counterparty_34,21815368.98,2025-02-03,2025-03-07
2025-03-05,2167.5,loan_repayment,out,Counterparty_89,21813201.48,2025-01-21,2025-02-24
2025-03-05,4314.98,investment_income,in,Counterparty_9,21817516.46,,
2025-03-05,3448.66,supplier_payment,out,Counterparty_31,21814067.8,2025-01-20,2025-02-20
2025-03-05,10218.72,customer_payment,in,Counterparty_26,21824286.52,,
2025-03-05,28.47,asset_sale,in,Counterparty_63,21824314.99,,
2025-03-05,1559.96,customer_payment,in,Counterparty_48,21825874.95,,
2025-03-05,1896.87,T&E,out,Counterparty_85,21823978.08,2025-01-25,2025-02-23
2025-03-05,1255.79,credit,in,Counterparty_77,21825233.87,,
2025-03-05,5860.54,customer_payment,in,Counterparty_74,21831094.41,,
2025-03-05,122.09,customer_payment,in,Counterparty_45,21831216.5,,
2025-03-05,13387.88,tax_payment,out,Counterparty_97,21817828.62,2025-02-18,2025-03-19
2025-03-05,5980.93,investment_income,in,Counterparty_43,21823809.55,,
2025-03-05,491.64,rent,out,Counterparty_98,21823317.91,2025-01-28,2025-03-06
2025-03-05,3609.83,asset_sale,in,Counterparty_84,21826927.74,,
2025-03-05,5774.62,customer_payment,in,Counterparty_81,21832702.36,,
2025-03-05,2176.93,tax_payment,out,Counterparty_34,21830525.43,2025-02-11,2025-03-09
2025-03-05,6621.27,tax_payment,out,Counterparty_15,21823904.16,2025-01-31,2025-03-09
2025-03-05,80.34,payroll,out,Counterparty_62,21823823.82,2025-02-09,2025-03-08
2025-03-05,11955.89,asset_sale,in,Counterparty_25,21835779.71,,
2025-03-05,618.49,credit,in,Counterparty_96,21836398.2,,
2025-03-05,9927.4,customer_payment,in,Counterparty_81,21846325.6,,
2025-03-05,3056.53,rent,out,Counterparty_6,21843269.07,2025-01-26,2025-03-04
2025-03-05,2176.88,loan_repayment,out,Counterparty_76,21841092.19,2025-02-03,2025-03-09
2025-03-05,1451.03,investment_income,in,Counterparty_44,21842543.22,,
2025-03-05,3502.24,asset_sale,in,Counterparty_69,21846045.46,,
2025-03-05,2347.13,utilities,out,Counterparty_65,21843698.33,2025-01-29,2025-03-04
2025-03-05,1961.71,software_subscription,out,Counterparty_21,21841736.62,2025-02-03,2025-03-01
2025-03-06,3895.09,T&E,out,Counterparty_52,21837841.53,2025-02-12,2025-03-10
2025-03-06,2703.34,asset_sale,in,Counterparty_72,21840544.87,,
2025-03-06,4878.12,customer_payment,in,Counterparty_25,21845422.99,,
2025-03-06,9904.74,asset_sale,in,Counterparty_55,21855327.73,,
2025-03-06,11138.83,refund,in,Counterparty_44,21866466.56,,
2025-03-06,1671.85,rent,out,Counterparty_9,21864794.71,2025-01-24,2025-02-22
2025-03-06,9646.05,customer_payment,in,Counterparty_78,21874440.76,,
2025-03-06,6610.31,asset_sale,in,Counterparty_26,21881051.07,,
2025-03-06,2462.6,rent,out,Counterparty_27,21878588.47,2025-01-31,2025-02-26
2025-03-06,2342.87,utilities,out,Counterparty_56,21876245.6,2025-02-08,2025-03-12
2025-03-06,2560.96,credit,in,Counterparty_7,21878806.56,,
2025-03-06,7891.89,refund,in,Counterparty_74,21886698.45,,
2025-03-06,1951.17,customer_payment,in,Counterparty_3,21888649.62,,
2025-03-06,11894.04,asset_sale,in,Counterparty_41,21900543.66,,
2025-03-06,435.42,refund,in,Counterparty_57,21900979.08,,
2025-03-06,4396.78,refund,in,Counterparty_15,21905375.86,,
2025-03-06,1494.1,tax_payment,out,Counterparty_45,21903881.76,2025-02-02,2025-03-02
2025-03-06,3275.58,tax_payment,out,Counterparty_42,21900606.18,2025-02-13,2025-03-15
2025-03-06,3950.09,utilities,out,Counterparty_9,21896656.09,2025-01-21,2025-02-24
2025-03-06,59.65,investment_income,in,Counterparty_39,21896715.74,,
2025-03-06,7382.43,asset_sale,in,Counterparty_94,21904098.17,,
2025-03-06,23372.89,software_subscription,out,Counterparty_75,21880725.28,2025-01-25,2025-03-01
2025-03-06,3535.31,T&E,out,Counterparty_27,21877189.97,2025-01-31,2025-02-27
2025-03-06,2801.76,asset_sale,in,Counterparty_77,21879991.73,,
2025-03-06,3694.69,T&E,out,Counterparty_30,21876297.04,2025-01-30,2025-03-06
2025-03-06,1301.23,utilities,out,Counterparty_19,21874995.81,2025-02-01,2025-03-07
2025-03-06,16127.33,loan_repayment,out,Counterparty_10,21858868.48,2025-02-13,2025-03-12
2025-03-06,21104.3,rent,out,Counterparty_57,21837764.18,2025-02-01,2025-02-26
2025-03-06,6621.72,customer_payment,in,Counterparty_13,21844385.9,,
2025-03-06,876.9,marketing_spend,out,Counterparty_88,21843509.0,2025-02-18,2025-03-29
2025-03-06,4733.07,marketing_spend,out,Counterparty_95,21838775.93,2025-02-18,2025-03-19
2025-03-06,861.6,credit,in,Counterparty_91,21839637.53,,
2025-03-06,295.64,refund,in,Counterparty_48,21839933.17,,
2025-03-07,1302.4,software_subscription,out,Counterparty_35,21838630.77,2025-02-14,2025-03-22
2025-03-07,1814.3,software_subscription,out,Counterparty_15,21836816.47,2025-01-26,2025-02-22
2025-03-07,1361.33,supplier_payment,out,Counterparty_13,21835455.14,2025-01-25,2025-02-20
2025-03-07,8124.7,marketing_spend,out,Counterparty_34,21827330.44,2025-01-30,2025-03-06
2025-03-07,3050.81,credit,in,Counterparty_79,21830381.25,,
2025-03-07,3271.78,software_subscription,out,Counterparty_65,21827109.47,2025-02-13,2025-03-24
2025-03-07,5356.85,customer_payment,in,Counterparty_25,21832466.32,,
2025-03-07,136.42,utilities,out,Counterparty_88,21832329.9,2025-02-12,2025-03-12
2025-03-07,7015.34,T&E,out,Counterparty_99,21825314.56,2025-02-18,2025-03-23
2025-03-07,1677.6,rent,out,Counterparty_87,21823636.96,2025-02-16,2025-03-24
2025-03-07,6044.43,customer_payment,in,Counterparty_71,21829681.39,,
2025-03-07,572.2,rent,out,Counterparty_33,21829109.19,2025-01-25,2025-02-26
2025-03-07,209.79,utilities,out,Counterparty_17,21828899.4,2025-02-12,2025-03-09
2025-03-07,1947.53,asset_sale,in,Counterparty_38,21830846.93,,
2025-03-07,1727.94,refund,in,Counterparty_28,21832574.87,,
2025-03-07,1280.37,payroll,out,Counterparty_32,21831294.5,2025-02-19,2025-03-24
2025-03-07,4629.28,utilities,out,Counterparty_60,21826665.22,2025-02-05,2025-03-03
2025-03-07,2636.82,refund,in,Counterparty_25,21829302.04,,
2025-03-07,6618.82,investment_income,in,Counterparty_95,21835920.86,,
2025-03-07,6665.43,customer_payment,in,Counterparty_39,21842586.29,,
2025-03-07,3288.3,utilities,out,Counterparty_69,21839297.99,2025-01-26,2025-02-23
2025-03-07,7323.52,software_subscription,out,Counterparty_30,21831974.47,2025-02-12,2025-03-12
2025-03-07,347.89,utilities,out,Counterparty_50,21831626.58,2025-02-02,2025-03-08
2025-03-07,8366.95,asset_sale,in,Counterparty_63,21839993.53,,
2025-03-07,2241.55,loan_repayment,out,Counterparty_4,21837751.98,2025-02-06,2025-03-15
2025-03-07,2380.05,rent,out,Counterparty_29,21835371.93,2025-02-10,2025-03-17
2025-03-07,119.28,marketing_spend,out,Counterparty_33,21835252.65,2025-01-30,2025-03-08
2025-03-07,1165.14,investment_income,in,Counterparty_85,21836417.79,,
2025-03-07,3454.8,software_subscription,out,Counterparty_93,21832962.99,2025-02-08,2025-03-10
2025-03-07,5148.3,T&E,out,Counterparty_62,21827814.69,2025-02-15,2025-03-26
2025-03-07,3148.69,credit,in,Counterparty_52,21830963.38,,
2025-03-07,617.0,credit,in,Counterparty_44,21831580.38,,
2025-03-07,6024.33,rent,out,Counterparty_96,21825556.05,2025-02-06,2025-03-17
2025-03-07,1224.18,supplier_payment,out,Counterparty_50,21824331.87,2025-02-20,2025-03-30
2025-03-07,2191.25,software_subscription,out,Counterparty_96,21822140.62,2025-02-02,2025-03-03
2025-03-07,541.58,supplier_payment,out,Counterparty_41,21821599.04,2025-01-26,2025-03-05
2025-03-07,266.78,investment_income,in,Counterparty_11,21821865.82,,
2025-03-07,0.1,refund,in,Counterparty_49,21821865.92,,
2025-03-07,6841.73,credit,in,Counterparty_39,21828707.65,,
2025-03-07,1702.49,refund,in,Counterparty_49,21830410.14,,
2025-03-07,5208.3,rent,out,Counterparty_83,21825201.84,2025-02-17,2025-03-16
2025-03-07,3466.07,customer_payment,in,Counterparty_36,21828667.91,,
2025-03-07,1886.3,investment_income,in,Counterparty_29,21830554.21,,
2025-03-07,1897.48,rent,out,Counterparty_31,21828656.73,2025-02-18,2025-03-19
2025-03-07,1906.4,supplier_payment,out,Counterparty_83,21826750.33,2025-02-16,2025-03-18
2025-03-07,249.98,supplier_payment,out,Counterparty_67,21826500.35,2025-01-30,2025-03-09
2025-03-07,269.99,asset_sale,in,Counterparty_81,21826770.34,,
2025-03-07,4099.52,software_subscription,out,Counterparty_43,21822670.82,2025-02-12,2025-03-09
2025-03-07,1524.58,marketing_spend,out,Counterparty_36,21821146.24,2025-01-30,2025-03-07
2025-03-07,584.04,customer_payment,in,Counterparty_23,21821730.28,,
2025-03-07,4231.32,asset_sale,in,Counterparty_42,21825961.6,,
2025-03-07,3159.22,refund,in,Counterparty_49,21829120.82,,
2025-03-07,3909.63,investment_income,in,Counterparty_58,21833030.45,,
2025-03-07,3341.38,credit,in,Counterparty_48,21836371.83,,
2025-03-07,1266.75,customer_payment,in,Counterparty_21,21837638.58,,
2025-03-07,4410.56,payroll,out,Counterparty_25,21833228.02,2025-02-12,2025-03-21
2025-03-07,2726.19,supplier_payment,out,Counterparty_99,21830501.83,2025-01-26,2025-02-24
2025-03-07,2282.08,marketing_spend,out,Counterparty_26,21828219.75,2025-02-18,2025-03-25
2025-03-07,738.6,investment_income,in,Counterparty_58,21828958.35,,
2025-03-07,5623.74,credit,in,Counterparty_97,21834582.09,,
2025-03-08,1486.85,refund,in,Counterparty_30,21836068.94,,
2025-03-08,6045.73,software_subscription,out,Counterparty_52,21830023.21,2025-02-06,2025-03-06
2025-03-08,771.95,customer_payment,in,Counterparty_82,21830795.16,,
2025-03-08,3639.79,refund,in,Counterparty_70,21834434.95,,
2025-03-08,4749.33,marketing_spend,out,Counterparty_80,21829685.62,2025-02-13,2025-03-14
2025-03-08,1801.71,T&E,out,Counterparty_11,21827883.91,2025-02-01,2025-02-26
2025-03-08,2714.19,rent,out,Counterparty_52,21825169.72,2025-01-28,2025-03-01
2025-03-08,6618.13,credit,in,Counterparty_55,21831787.85,,
2025-03-08,305.62,investment_income,in,Counterparty_88,21832093.47,,
2025-03-08,878.83,credit,in,Counterparty_95,21832972.3,,
2025-03-08,7320.94,investment_income,in,Counterparty_29,21840293.24,,
2025-03-08,4881.32,refund,in,Counterparty_63,21845174.56,,
2025-03-08,260.83,refund,in,Counterparty_90,21845435.39,,
2025-03-08,3752.84,customer_payment,in,Counterparty_97,21849188.23,,
2025-03-08,2154.9,payroll,out,Counterparty_16,21847033.33,2025-02-17,2025-03-19
2025-03-08,144.11,investment_income,in,Counterparty_40,21847177.44,,
2025-03-08,10483.31,marketing_spend,out,Counterparty_36,21836694.13,2025-02-18,2025-03-29
2025-03-08,4652.46,credit,in,Counterparty_81,21841346.59,,
2025-03-08,19410.41,customer_payment,in,Counterparty_32,21860757.0,,
2025-03-08,98.43,asset_sale,in,Counterparty_53,21860855.43,,
2025-03-08,2556.28,refund,in,Counterparty_19,21863411.71,,
2025-03-08,7880.8,asset_sale,in,Counterparty_47,21871292.51,,
2025-03-08,423.76,investment_income,in,Counterparty_55,21871716.27,,
2025-03-08,299.73,refund,in,Counterparty_48,21872016.0,,
2025-03-08,2387.67,asset_sale,in,Counterparty_37,21874403.67,,
2025-03-08,1146.42,investment_income,in,Counterparty_41,21875550.09,,
2025-03-08,2501.2,asset_sale,in,Counterparty_52,21878051.29,,
2025-03-08,1186.66,T&E,out,Counterparty_28,21876864.63,2025-02-14,2025-03-18
2025-03-08,2143.02,refund,in,Counterparty_44,21879007.65,,
2025-03-08,4961.28,marketing_spend,out,Counterparty_11,21874046.37,2025-02-16,2025-03-26
2025-03-08,395.71,customer_payment,in,Counterparty_32,21874442.08,,
2025-03-08,1847.17,utilities,out,Counterparty_95,21872594.91,2025-02-06,2025-03-16
2025-03-08,4225.19,tax_payment,out,Counterparty_1,21868369.72,2025-01-25,2025-02-25
2025-03-08,2125.54,utilities,out,Counterparty_18,21866244.18,2025-02-03,2025-03-13
2025-03-08,2388.59,refund,in,Counterparty_16,21868632.77,,
2025-03-08,1235.73,customer_payment,in,Counterparty_75,21869868.5,,
2025-03-08,111.33,tax_payment,out,Counterparty_20,21869757.17,2025-02-10,2025-03-21
2025-03-08,7564.66,asset_sale,in,Counterparty_27,21877321.83,,
2025-03-08,3860.05,marketing_spend,out,Counterparty_12,21873461.78,2025-02-08,2025-03-18
2025-03-08,3646.21,software_subscription,out,Counterparty_86,21869815.57,2025-02-20,2025-03-24
2025-03-08,3892.6,loan_repayment,out,Counterparty_17,21865922.97,2025-02-08,2025-03-09
2025-03-08,3126.96,rent,out,Counterparty_38,21862796.01,2025-02-10,2025-03-21
2025-03-08,310.87,rent,out,Counterparty_14,21862485.14,2025-02-21,2025-03-21
2025-03-09,2641.5,marketing_spend,out,Counterparty_46,21859843.64,2025-02-12,2025-03-23
2025-03-09,6507.22,refund,in,Counterparty_73,21866350.86,,
2025-03-09,13534.45,utilities,out,Counterparty_59,21852816.41,2025-02-07,2025-03-17
2025-03-09,5547.13,asset_sale,in,Counterparty_70,21858363.54,,
2025-03-09,5134.46,refund,in,Counterparty_70,21863498.0,,
2025-03-09,3024.21,software_subscription,out,Counterparty_63,21860473.79,2025-02-13,2025-03-19
2025-03-09,1066.31,asset_sale,in,Counterparty_80,21861540.1,,
2025-03-09,12359.54,credit,in,Counterparty_26,21873899.64,,
2025-03-09,6873.48,refund,in,Counterparty_61,21880773.12,,
2025-03-09,2013.03,asset_sale,in,Counterparty_54,21882786.15,,
2025-03-09,784.5,utilities,out,Counterparty_43,21882001.65,2025-02-22,2025-03-22
2025-03-09,5766.66,customer_payment,in,Counterparty_14,21887768.31,,
2025-03-09,6925.62,tax_payment,out,Counterparty_5,21880842.69,2025-02-12,2025-03-09
2025-03-09,344.55,supplier_payment,out,Counterparty_28,21880498.14,2025-02-13,2025-03-16
2025-03-09,1774.23,investment_income,in,Counterparty_97,21882272.37,,
2025-03-09,6407.55,refund,in,Counterparty_70,21888679.92,,
2025-03-09,6659.81,customer_payment,in,Counterparty_71,21895339.73,,
2025-03-09,3113.65,credit,in,Counterparty_3,21898453.38,,
2025-03-09,1598.19,marketing_spend,out,Counterparty_38,21896855.19,2025-02-08,2025-03-06
2025-03-09,831.49,payroll,out,Counterparty_37,21896023.7,2025-01-27,2025-03-06
2025-03-09,1610.68,asset_sale,in,Counterparty_35,21897634.38,,
2025-03-09,6062.53,supplier_payment,out,Counterparty_42,21891571.85,2025-02-13,2025-03-11
2025-03-09,606.76,marketing_spend,out,Counterparty_13,21890965.09,2025-02-05,2025-03-13
2025-03-09,439.36,loan_repayment,out,Counterparty_11,21890525.73,2025-02-03,2025-03-14
2025-03-09,2394.66,customer_payment,in,Counterparty_68,21892920.39,,
2025-03-09,1141.06,refund,in,Counterparty_23,21894061.45,,
2025-03-09,2937.8,credit,in,Counterparty_98,21896999.25,,
2025-03-09,3291.89,supplier_payment,out,Counterparty_53,21893707.36,2025-02-01,2025-03-04
2025-03-09,6421.01,marketing_spend,out,Counterparty_18,21887286.35,2025-01-25,2025-02-27
2025-03-09,7253.62,rent,out,Counterparty_37,21880032.73,2025-02-09,2025-03-16
2025-03-09,1976.58,refund,in,Counterparty_43,21882009.31,,
2025-03-09,5137.95,refund,in,Counterparty_28,21887147.26,,
2025-03-09,5445.32,refund,in,Counterparty_21,21892592.58,,
2025-03-09,3499.01,investment_income,in,Counterparty_9,21896091.59,,
2025-03-09,3817.49,customer_payment,in,Counterparty_86,21899909.08,,
2025-03-09,357.86,software_subscription,out,Counterparty_86,21899551.22,2025-02-04,2025-03-14
2025-03-09,1803.08,marketing_spend,out,Counterparty_46,21897748.14,2025-02-06,2025-03-15
2025-03-09,10377.54,payroll,out,Counterparty_96,21887370.6,2025-02-16,2025-03-23
2025-03-09,237.87,customer_payment,in,Counterparty_33,21887608.47,,
2025-03-09,4525.36,customer_payment,in,Counterparty_97,21892133.83,,
2025-03-09,88.67,investment_income,in,Counterparty_86,21892222.5,,
2025-03-09,289.62,utilities,out,Counterparty_64,21891932.88,2025-02-02,2025-03-12
2025-03-09,1113.75,credit,in,Counterparty_84,21893046.63,,
2025-03-09,7820.94,investment_income,in,Counterparty_8,21900867.57,,
2025-03-09,2065.12,marketing_spend,out,Counterparty_24,21898802.45,2025-01-28,2025-02-24
2025-03-09,4768.36,tax_payment,out,Counterparty_28,21894034.09,2025-02-11,2025-03-10
2025-03-09,2429.86,customer_payment,in,Counterparty_33,21896463.95,,
2025-03-09,3366.76,customer_payment,in,Counterparty_60,21899830.71,,
2025-03-10,311.23,credit,in,Counterparty_4,21900141.94,,
2025-03-10,7129.95,supplier_payment,out,Counterparty_45,21893011.99,2025-01-30,2025-03-05
2025-03-10,1477.47,rent,out,Counterparty_59,21891534.52,2025-02-16,2025-03-15
2025-03-10,241.45,rent,out,Counterparty_24,21891293.07,2025-01-31,2025-03-03
2025-03-10,2227.7,investment_income,in,Counterparty_19,21893520.77,,
2025-03-10,8707.38,credit,in,Counterparty_61,21902228.15,,
2025-03-10,94.89,supplier_payment,out,Counterparty_57,21902133.26,2025-01-28,2025-02-24
2025-03-10,2426.73,T&E,out,Counterparty_58,21899706.53,2025-02-12,2025-03-15
2025-03-10,9117.96,refund,in,Counterparty_4,21908824.49,,
2025-03-10,1945.74,investment_income,in,Counterparty_23,21910770.23,,
2025-03-10,9005.74,loan_repayment,out,Counterparty_66,21901764.49,2025-02-01,2025-03-06
2025-03-10,4052.77,software_subscription,out,Counterparty_2,21897711.72,2025-02-19,2025-03-20
2025-03-10,10299.14,refund,in,Counterparty_96,21908010.86,,
2025-03-10,45.45,asset_sale,in,Counterparty_44,21908056.31,,
2025-03-10,3309.63,supplier_payment,out,Counterparty_74,21904746.68,2025-02-23,2025-03-28
2025-03-10,5243.14,supplier_payment,out,Counterparty_61,21899503.54,2025-02-09,2025-03-07
2025-03-10,1078.11,refund,in,Counterparty_67,21900581.65,,
2025-03-10,20186.22,loan_repayment,out,Counterparty_59,21880395.43,2025-01-25,2025-03-04
2025-03-10,191.74,asset_sale,in,Counterparty_59,21880587.17,,
2025-03-10,1336.43,T&E,out,Counterparty_95,21879250.74,2025-02-10,2025-03-07
2025-03-10,1937.21,credit,in,Counterparty_77,21881187.95,,
2025-03-10,1348.55,tax_payment,out,Counterparty_64,21879839.4,2025-01-25,2025-02-23
2025-03-10,2596.35,rent,out,Counterparty_99,21877243.05,2025-02-05,2025-03-08
2025-03-10,7030.28,investment_income,in,Counterparty_81,21884273.33,,
2025-03-10,5483.05,tax_payment,out,Counterparty_18,21878790.28,2025-01-25,2025-02-24
2025-03-10,2203.3,supplier_payment,out,Counterparty_13,21876586.98,2025-02-11,2025-03-22
2025-03-10,4753.0,rent,out,Counterparty_50,21871833.98,2025-01-30,2025-03-09
2025-03-10,5970.89,T&E,out,Counterparty_23,21865863.09,2025-02-02,2025-03-01
2025-03-10,3545.07,software_subscription,out,Counterparty_42,21862318.02,2025-02-19,2025-03-18
2025-03-10,124.93,payroll,out,Counterparty_56,21862193.09,2025-02-11,2025-03-14
2025-03-10,6048.02,asset_sale,in,Counterparty_86,21868241.11,,
2025-03-10,955.06,investment_income,in,Counterparty_92,21869196.17,,
2025-03-10,3661.03,tax_payment,out,Counterparty_35,21865535.14,2025-02-04,2025-03-12
2025-03-10,2355.57,asset_sale,in,Counterparty_31,21867890.71,,
2025-03-10,19773.98,supplier_payment,out,Counterparty_45,21848116.73,2025-02-14,2025-03-16
2025-03-10,450.32,refund,in,Counterparty_41,21848567.05,,
2025-03-10,3058.83,credit,in,Counterparty_61,21851625.88,,
2025-03-10,1405.32,refund,in,Counterparty_3,21853031.2,,
2025-03-10,1706.6,investment_income,in,Counterparty_67,21854737.8,,
2025-03-10,842.19,credit,in,Counterparty_51,21855579.99,,
2025-03-10,1352.6,tax_payment,out,Counterparty_97,21854227.39,2025-02-13,2025-03-24
2025-03-10,4175.4,supplier_payment,out,Counterparty_35,21850051.99,2025-02-18,2025-03-22
2025-03-11,12489.62,marketing_spend,out,Counterparty_60,21837562.37,2025-02-19,2025-03-21
2025-03-11,323.41,credit,in,Counterparty_97,21837885.78,,
2025-03-11,1341.86,asset_sale,in,Counterparty_83,21839227.64,,
2025-03-11,3125.81,asset_sale,in,Counterparty_72,21842353.45,,
2025-03-11,2550.07,rent,out,Counterparty_82,21839803.38,2025-02-23,2025-04-02
2025-03-11,7223.16,software_subscription,out,Counterparty_11,21832580.22,2025-02-09,2025-03-07
2025-03-11,2251.22,payroll,out,Counterparty_75,21830329.0,2025-01-27,2025-02-24
2025-03-11,387.81,investment_income,in,Counterparty_52,21830716.81,,
2025-03-11,14344.89,marketing_spend,out,Counterparty_17,21816371.92,2025-02-13,2025-03-20
2025-03-11,1436.28,payroll,out,Counterparty_28,21814935.64,2025-02-22,2025-03-20
2025-03-11,1010.26,T&E,out,Counterparty_89,21813925.38,2025-01-27,2025-03-03
2025-03-11,3450.56,supplier_payment,out,Counterparty_83,21810474.82,2025-02-09,2025-03-06
2025-03-11,2833.99,supplier_payment,out,Counterparty_11,21807640.83,2025-02-18,2025-03-17
2025-03-11,3812.6,credit,in,Counterparty_9,21811453.43,,
2025-03-11,6543.86,supplier_payment,out,Counterparty_64,21804909.57,2025-02-16,2025-03-18
2025-03-11,2750.2,asset_sale,in,Counterparty_30,21807659.77,,
2025-03-11,989.2,credit,in,Counterparty_87,21808648.97,,
2025-03-11,2894.32,marketing_spend,out,Counterparty_84,21805754.65,2025-02-07,2025-03-16
2025-03-11,22.77,supplier_payment,out,Counterparty_57,21805731.88,2025-02-09,2025-03-13
2025-03-11,136.4,asset_sale,in,Counterparty_11,21805868.28,,
2025-03-11,1586.52,marketing_spend,out,Counterparty_91,21804281.76,2025-02-08,2025-03-06
2025-03-11,4648.32,loan_repayment,out,Counterparty_1,21799633.44,2025-02-09,2025-03-14
2025-03-11,8397.83,investment_income,in,Counterparty_82,21808031.27,,
2025-03-11,417.78,asset_sale,in,Counterparty_25,21808449.05,,
2025-03-11,6882.91,loan_repayment,out,Counterparty_33,21801566.14,2025-02-11,2025-03-16
2025-03-11,1008.93,customer_payment,in,Counterparty_33,21802575.07,,
2025-03-11,1026.65,software_subscription,out,Counterparty_83,21801548.42,2025-02-01,2025-03-04
2025-03-11,1344.46,payroll,out,Counterparty_53,21800203.96,2025-01-26,2025-02-21
2025-03-11,806.63,refund,in,Counterparty_35,21801010.59,,
2025-03-11,4371.82,loan_repayment,out,Counterparty_96,21796638.77,2025-02-03,2025-03-11
2025-03-11,1873.36,payroll,out,Counterparty_56,21794765.41,2025-02-12,2025-03-15
2025-03-11,808.0,asset_sale,in,Counterparty_86,21795573.41,,
2025-03-11,3568.76,credit,in,Counterparty_66,21799142.17,,
2025-03-11,619.98,credit,in,Counterparty_18,21799762.15,,
2025-03-11,358.59,payroll,out,Counterparty_1,21799403.56,2025-01-27,2025-02-24
2025-03-11,1197.56,payroll,out,Counterparty_97,21798206.0,2025-02-04,2025-03-01
2025-03-11,1091.61,customer_payment,in,Counterparty_72,21799297.61,,
2025-03-11,2268.5,rent,out,Counterparty_25,21797029.11,2025-02-22,2025-03-29
2025-03-11,6285.86,customer_payment,in,Counterparty_97,21803314.97,,
2025-03-11,601.88,payroll,out,Counterparty_24,21802713.09,2025-02-22,2025-03-22
2025-03-11,1091.77,T&E,out,Counterparty_20,21801621.32,2025-02-12,2025-03-10
2025-03-11,3052.24,loan_repayment,out,Counterparty_62,21798569.08,2025-02-16,2025-03-24
2025-03-11,6363.23,payroll,out,Counterparty_18,21792205.85,2025-02-05,2025-03-04
2025-03-11,979.03,tax_payment,out,Counterparty_3,21791226.82,2025-02-02,2025-03-09
2025-03-11,1385.54,loan_repayment,out,Counterparty_28,21789841.28,2025-02-11,2025-03-09
2025-03-11,5392.91,asset_sale,in,Counterparty_58,21795234.19,,
2025-03-11,2193.38,customer_payment,in,Counterparty_46,21797427.57,,
2025-03-12,5135.79,utilities,out,Counterparty_49,21792291.78,2025-01-29,2025-03-01
2025-03-12,206.09,refund,in,Counterparty_41,21792497.87,,
2025-03-12,1265.93,refund,in,Counterparty_25,21793763.8,,
2025-03-12,343.82,customer_payment,in,Counterparty_91,21794107.62,,
2025-03-12,2841.93,credit,in,Counterparty_20,21796949.55,,
2025-03-12,3848.76,T&E,out,Counterparty_8,21793100.79,2025-02-23,2025-03-26
2025-03-12,1711.09,rent,out,Counterparty_86,21791389.7,2025-01-29,2025-03-09
2025-03-12,1358.62,asset_sale,in,Counterparty_1,21792748.32,,
2025-03-12,6117.1,utilities,out,Counterparty_40,21786631.22,2025-02-20,2025-03-28
2025-03-12,4414.11,payroll,out,Counterparty_36,21782217.11,2025-02-17,2025-03-23
2025-03-12,1724.03,utilities,out,Counterparty_9,21780493.08,2025-02-22,2025-03-30
2025-03-12,1844.01,T&E,out,Counterparty_90,21778649.07,2025-02-05,2025-03-12
2025-03-12,3686.45,supplier_payment,out,Counterparty_91,21774962.62,2025-02-08,2025-03-10
2025-03-12,14084.91,utilities,out,Counterparty_99,21760877.71,2025-01-27,2025-02-21
2025-03-12,126.92,T&E,out,Counterparty_12,21760750.79,2025-02-22,2025-04-02
2025-03-12,1755.1,loan_repayment,out,Counterparty_75,21758995.69,2025-02-04,2025-03-04
2025-03-12,11636.46,software_subscription,out,Counterparty_63,21747359.23,2025-02-09,2025-03-12
2025-03-12,6643.27,rent,out,Counterparty_66,21740715.96,2025-01-30,2025-02-24
2025-03-12,834.9,refund,in,Counterparty_60,21741550.86,,
2025-03-12,437.05,rent,out,Counterparty_88,21741113.81,2025-01-30,2025-03-02
2025-03-12,1361.3,credit,in,Counterparty_68,21742475.11,,
2025-03-12,6069.93,supplier_payment,out,Counterparty_19,21736405.18,2025-02-17,2025-03-21
2025-03-12,2643.28,refund,in,Counterparty_41,21739048.46,,
2025-03-12,13683.07,loan_repayment,out,Counterparty_34,21725365.39,2025-02-01,2025-03-03
2025-03-12,450.29,asset_sale,in,Counterparty_76,21725815.68,,
2025-03-12,17381.17,refund,in,Counterparty_76,21743196.85,,
2025-03-12,5548.9,refund,in,Counterparty_68,21748745.75,,
2025-03-12,422.93,loan_repayment,out,Counterparty_55,21748322.82,2025-02-03,2025-03-12
2025-03-12,3775.07,tax_payment,out,Counterparty_76,21744547.75,2025-02-08,2025-03-18
2025-03-12,1633.98,marketing_spend,out,Counterparty_76,21742913.77,2025-02-25,2025-03-25
2025-03-12,2082.27,supplier_payment,out,Counterparty_96,21740831.5,2025-01-28,2025-03-05
2025-03-12,1210.52,T&E,out,Counterparty_50,21739620.98,2025-02-01,2025-02-26
2025-03-12,1193.65,asset_sale,in,Counterparty_3,21740814.63,,
2025-03-12,5011.74,supplier_payment,out,Counterparty_76,21735802.89,2025-02-01,2025-03-02
2025-03-12,1872.21,rent,out,Counterparty_5,21733930.68,2025-02-22,2025-03-23
2025-03-12,5548.66,rent,out,Counterparty_9,21728382.02,2025-02-20,2025-03-23
2025-03-12,1064.63,asset_sale,in,Counterparty_54,21729446.65,,
2025-03-12,2055.34,asset_sale,in,Counterparty_18,21731501.99,,
2025-03-12,12.69,T&E,out,Counterparty_19,21731489.3,2025-02-10,2025-03-16
2025-03-12,4889.17,refund,in,Counterparty_45,21736378.47,,
2025-03-12,128.16,investment_income,in,Counterparty_67,21736506.63,,
2025-03-12,10976.42,credit,in,Counterparty_23,21747483.05,,
2025-03-12,4442.42,payroll,out,Counterparty_75,21743040.63,2025-01-29,2025-03-04
2025-03-12,979.86,supplier_payment,out,Counterparty_6,21742060.77,2025-02-13,2025-03-21
2025-03-12,1400.15,software_subscription,out,Counterparty_5,21740660.62,2025-02-25,2025-04-01
2025-03-12,3097.8,refund,in,Counterparty_83,21743758.42,,
2025-03-12,945.32,asset_sale,in,Counterparty_44,21744703.74,,
2025-03-12,835.09,asset_sale,in,Counterparty_46,21745538.83,,
2025-03-12,2589.47,utilities,out,Counterparty_81,21742949.36,2025-01-29,2025-02-23
2025-03-12,6000.22,T&E,out,Counterparty_34,21736949.14,2025-02-03,2025-03-11
2025-03-12,247.44,T&E,out,Counterparty_46,21736701.7,2025-02-04,2025-03-14
2025-03-12,6369.79,software_subscription,out,Counterparty_65,21730331.91,2025-02-05,2025-03-05
2025-03-12,7126.98,customer_payment,in,Counterparty_29,21737458.89,,
2025-03-12,302.73,customer_payment,in,Counterparty_63,21737761.62,,
2025-03-12,816.42,software_subscription,out,Counterparty_33,21736945.2,2025-01-31,2025-02-25
2025-03-12,5136.65,supplier_payment,out,Counterparty_25,21731808.55,2025-02-07,2025-03-08
2025-03-12,61.48,marketing_spend,out,Counterparty_87,21731747.07,2025-01-29,2025-02-24
2025-03-12,3711.66,credit,in,Counterparty_95,21735458.73,,
2025-03-12,2519.17,customer_payment,in,Counterparty_29,21737977.9,,
2025-03-12,300.25,investment_income,in,Counterparty_81,21738278.15,,
2025-03-12,2491.4,tax_payment,out,Counterparty_39,21735786.75,2025-02-04,2025-03-14
2025-03-13,1708.53,investment_income,in,Counterparty_5,21737495.28,,
2025-03-13,1543.04,refund,in,Counterparty_68,21739038.32,,
2025-03-13,1278.41,loan_repayment,out,Counterparty_33,21737759.91,2025-02-23,2025-03-26
2025-03-13,5560.94,refund,in,Counterparty_36,21743320.85,,
2025-03-13,1490.46,loan_repayment,out,Counterparty_50,21741830.39,2025-02-04,2025-03-04
2025-03-13,3008.6,utilities,out,Counterparty_75,21738821.79,2025-02-02,2025-03-09
2025-03-13,5925.43,investment_income,in,Counterparty_21,21744747.22,,
2025-03-13,130.09,customer_payment,in,Counterparty_8,21744877.31,,
2025-03-13,4428.99,refund,in,Counterparty_66,21749306.3,,
2025-03-13,17689.36,customer_payment,in,Counterparty_26,21766995.66,,
2025-03-13,16.09,credit,in,Counterparty_75,21767011.75,,
2025-03-13,7.1,asset_sale,in,Counterparty_83,21767018.85,,
2025-03-13,4626.8,customer_payment,in,Counterparty_41,21771645.65,,
2025-03-13,15476.15,customer_payment,in,Counterparty_76,21787121.8,,
2025-03-13,1661.48,T&E,out,Counterparty_83,21785460.32,2025-02-05,2025-03-08
2025-03-13,6002.07,utilities,out,Counterparty_34,21779458.25,2025-01-31,2025-02-25
2025-03-13,192.47,tax_payment,out,Counterparty_80,21779265.78,2025-02-21,2025-03-22
2025-03-13,13016.93,investment_income,in,Counterparty_27,21792282.71,,
2025-03-13,1855.61,investment_income,in,Counterparty_51,21794138.32,,
2025-03-13,1263.84,asset_sale,in,Counterparty_28,21795402.16,,
2025-03-13,816.91,T&E,out,Counterparty_35,21794585.25,2025-02-21,2025-03-22
2025-03-13,6462.3,payroll,out,Counterparty_51,21788122.95,2025-02-23,2025-03-31
2025-03-13,807.29,payroll,out,Counterparty_64,21787315.66,2025-02-04,2025-03-02
2025-03-13,8136.25,credit,in,Counterparty_22,21795451.91,,
2025-03-13,947.3,credit,in,Counterparty_18,21796399.21,,
2025-03-13,2284.71,customer_payment,in,Counterparty_79,21798683.92,,
2025-03-13,5667.4,T&E,out,Counterparty_94,21793016.52,2025-02-24,2025-04-02
2025-03-13,1090.51,loan_repayment,out,Counterparty_55,21791926.01,2025-01-31,2025-03-04
2025-03-13,2307.79,T&E,out,Counterparty_95,21789618.22,2025-02-09,2025-03-09
2025-03-13,940.01,marketing_spend,out,Counterparty_81,21788678.21,2025-02-26,2025-03-28
2025-03-13,3747.12,payroll,out,Counterparty_73,21784931.09,2025-02-14,2025-03-25
2025-03-13,2746.73,customer_payment,in,Counterparty_78,21787677.82,,
2025-03-13,1312.34,asset_sale,in,Counterparty_31,21788990.16,,
2025-03-13,2706.14,utilities,out,Counterparty_60,21786284.02,2025-01-29,2025-02-23
2025-03-13,576.4,investment_income,in,Counterparty_63,21786860.42,,
2025-03-13,7891.26,asset_sale,in,Counterparty_9,21794751.68,,
2025-03-13,6591.15,refund,in,Counterparty_19,21801342.83,,
2025-03-13,313.4,rent,out,Counterparty_87,21801029.43,2025-02-26,2025-04-04
2025-03-13,4279.93,payroll,out,Counterparty_56,21796749.5,2025-01-30,2025-02-28
2025-03-13,2058.16,tax_payment,out,Counterparty_10,21794691.34,2025-01-30,2025-03-09
2025-03-13,295.73,marketing_spend,out,Counterparty_96,21794395.61,2025-02-03,2025-03-10
2025-03-13,313.72,rent,out,Counterparty_75,21794081.89,2025-02-24,2025-03-25
2025-03-13,2901.57,supplier_payment,out,Counterparty_23,21791180.32,2025-02-14,2025-03-13
2025-03-13,3030.53,investment_income,in,Counterparty_98,21794210.85,,
2025-03-13,3457.87,asset_sale,in,Counterparty_57,21797668.72,,
2025-03-13,3367.33,payroll,out,Counterparty_87,21794301.39,2025-01-28,2025-02-27
2025-03-13,3027.37,refund,in,Counterparty_15,21797328.76,,
2025-03-13,6174.25,credit,in,Counterparty_39,21803503.01,,
2025-03-14,511.28,marketing_spend,out,Counterparty_25,21802991.73,2025-02-16,2025-03-25
2025-03-14,4296.16,utilities,out,Counterparty_98,21798695.57,2025-02-06,2025-03-10
2025-03-14,801.39,supplier_payment,out,Counterparty_72,21797894.18,2025-02-22,2025-03-19
2025-03-14,352.48,supplier_payment,out,Counterparty_74,21797541.7,2025-02-23,2025-03-30
2025-03-14,8148.01,utilities,out,Counterparty_78,21789393.69,2025-02-24,2025-03-31
2025-03-14,9580.61,refund,in,Counterparty_70,21798974.3,,
2025-03-14,1260.25,utilities,out,Counterparty_98,21797714.05,2025-01-30,2025-02-26
2025-03-14,3869.0,refund,in,Counterparty_4,21801583.05,,
2025-03-14,3476.54,supplier_payment,out,Counterparty_6,21798106.51,2025-02-26,2025-03-25
2025-03-14,4974.11,credit,in,Counterparty_67,21803080.62,,
2025-03-14,5907.73,supplier_payment,out,Counterparty_42,21797172.89,2025-02-05,2025-03-09
2025-03-14,1984.04,customer_payment,in,Counterparty_19,21799156.93,,
2025-03-14,7952.52,customer_payment,in,Counterparty_39,21807109.45,,
2025-03-14,356.78,T&E,out,Counterparty_61,21806752.67,2025-02-21,2025-03-25
2025-03-14,3281.48,tax_payment,out,Counterparty_71,21803471.19,2025-02-09,2025-03-06
2025-03-14,4233.84,refund,in,Counterparty_32,21807705.03,,
2025-03-14,737.51,investment_income,in,Counterparty_75,21808442.54,,
2025-03-14,887.2,customer_payment,in,Counterparty_60,21809329.74,,
2025-03-14,2281.9,customer_payment,in,Counterparty_13,21811611.64,,
2025-03-14,9536.62,investment_income,in,Counterparty_26,21821148.26,,
2025-03-14,2881.16,customer_payment,in,Counterparty_60,21824029.42,,
2025-03-14,2864.08,refund,in,Counterparty_90,21826893.5,,
2025-03-14,744.11,refund,in,Counterparty_21,21827637.61,,
2025-03-14,6092.57,credit,in,Counterparty_89,21833730.18,,
2025-03-14,2736.51,software_subscription,out,Counterparty_29,21830993.67,2025-02-24,2025-03-30
2025-03-14,12534.1,asset_sale,in,Counterparty_61,21843527.77,,
2025-03-14,5016.95,asset_sale,in,Counterparty_87,21848544.72,,
2025-03-14,3816.23,marketing_spend,out,Counterparty_1,21844728.49,2025-02-24,2025-03-25
2025-03-14,3680.83,investment_income,in,Counterparty_44,21848409.32,,
2025-03-14,6610.93,refund,in,Counterparty_79,21855020.25,,
2025-03-14,934.14,asset_sale,in,Counterparty_72,21855954.39,,
2025-03-14,4551.58,rent,out,Counterparty_73,21851402.81,2025-02-19,2025-03-27
2025-03-14,847.82,payroll,out,Counterparty_90,21850554.99,2025-02-14,2025-03-17
2025-03-14,439.97,customer_payment,in,Counterparty_16,21850994.96,,
2025-03-14,6019.55,investment_income,in,Counterparty_98,21857014.51,,
2025-03-14,3256.55,refund,in,Counterparty_9,21860271.06,,
2025-03-14,5404.29,supplier_payment,out,Counterparty_73,21854866.77,2025-02-21,2025-03-20
2025-03-14,4995.69,supplier_payment,out,Counterparty_34,21849871.08,2025-02-07,2025-03-09
2025-03-14,465.89,supplier_payment,out,Counterparty_77,21849405.19,2025-02-26,2025-04-05
2025-03-14,3463.41,rent,out,Counterparty_54,21845941.78,2025-02-17,2025-03-16
2025-03-14,8368.57,asset_sale,in,Counterparty_70,21854310.35,,
2025-03-14,4624.08,credit,in,Counterparty_79,21858934.43,,
2025-03-14,7286.38,refund,in,Counterparty_55,21866220.81,,
2025-03-14,4277.03,T&E,out,Counterparty_2,21861943.78,2025-02-14,2025-03-12
2025-03-14,674.56,software_subscription,out,Counterparty_24,21861269.22,2025-02-23,2025-03-28
2025-03-15,337.05,marketing_spend,out,Counterparty_25,21860932.17,2025-02-14,2025-03-25
2025-03-15,660.57,payroll,out,Counterparty_34,21860271.6,2025-02-20,2025-03-22
2025-03-15,19868.29,customer_payment,in,Counterparty_38,21880139.89,,
2025-03-15,5709.1,supplier_payment,out,Counterparty_98,21874430.79,2025-02-11,2025-03-13
2025-03-15,276.41,T&E,out,Counterparty_97,21874154.38,2025-02-16,2025-03-21
2025-03-15,1433.4,software_subscription,out,Counterparty_4,21872720.98,2025-02-20,2025-03-31
2025-03-15,2462.39,loan_repayment,out,Counterparty_70,21870258.59,2025-02-19,2025-03-21
2025-03-15,977.06,payroll,out,Counterparty_34,21869281.53,2025-02-15,2025-03-22
2025-03-15,3202.95,asset_sale,in,Counterparty_77,21872484.48,,
2025-03-15,2370.81,refund,in,Counterparty_16,21874855.29,,
2025-03-15,7434.36,refund,in,Counterparty_86,21882289.65,,
2025-03-15,2866.84,credit,in,Counterparty_47,21885156.49,,
2025-03-15,9748.37,asset_sale,in,Counterparty_66,21894904.86,,
2025-03-15,4319.42,investment_income,in,Counterparty_74,21899224.28,,
2025-03-15,21583.49,payroll,out,Counterparty_4,21877640.79,2025-02-27,2025-04-03
2025-03-15,11436.23,asset_sale,in,Counterparty_9,21889077.02,,
2025-03-15,469.27,utilities,out,Counterparty_64,21888607.75,2025-02-01,2025-03-12
2025-03-15,9186.01,credit,in,Counterparty_66,21897793.76,,
2025-03-15,2302.62,supplier_payment,out,Counterparty_49,21895491.14,2025-02-23,2025-04-01
2025-03-15,7530.96,utilities,out,Counterparty_66,21887960.18,2025-02-19,2025-03-22
2025-03-15,1440.03,software_subscription,out,Counterparty_42,21886520.15,2025-02-05,2025-03-08
2025-03-15,6736.07,customer_payment,in,Counterparty_24,21893256.22,,
2025-03-15,1062.43,asset_sale,in,Counterparty_77,21894318.65,,
2025-03-15,2388.99,asset_sale,in,Counterparty_89,21896707.64,,
2025-03-15,7905.66,credit,in,Counterparty_23,21904613.3,,
2025-03-15,1988.92,customer_payment,in,Counterparty_83,21906602.22,,
2025-03-15,6278.18,refund,in,Counterparty_20,21912880.4,,
2025-03-15,69.47,investment_income,in,Counterparty_80,21912949.87,,
2025-03-15,102.55,software_subscription,out,Counterparty_21,21912847.32,2025-02-24,2025-04-01
2025-03-15,1351.71,refund,in,Counterparty_6,21914199.03,,
2025-03-15,460.53,software_subscription,out,Counterparty_60,21913738.5,2025-02-23,2025-03-20
2025-03-15,1771.81,tax_payment,out,Counterparty_40,21911966.69,2025-02-01,2025-03-10
2025-03-15,4277.79,payroll,out,Counterparty_99,21907688.9,2025-02-16,2025-03-22
2025-03-15,4521.1,loan_repayment,out,Counterparty_28,21903167.8,2025-02-20,2025-03-21
2025-03-15,581.65,T&E,out,Counterparty_95,21902586.15,2025-02-02,2025-03-01
2025-03-15,2596.94,investment_income,in,Counterparty_56,21905183.09,,
2025-03-15,282.88,investment_income,in,Counterparty_57,21905465.97,,
2025-03-15,632.76,payroll,out,Counterparty_40,21904833.21,2025-02-03,2025-03-02
2025-03-15,6512.76,credit,in,Counterparty_50,21911345.97,,
2025-03-15,741.88,investment_income,in,Counterparty_34,21912087.85,,
2025-03-15,1931.41,utilities,out,Counterparty_68,21910156.44,2025-01-31,2025-03-10
2025-03-15,1379.09,payroll,out,Counterparty_82,21908777.35,2025-02-11,2025-03-10
2025-03-15,241.17,software_subscription,out,Counterparty_32,21908536.18,2025-02-24,2025-03-24
2025-03-16,1843.41,marketing_spend,out,Counterparty_52,21906692.77,2025-02-18,2025-03-27
2025-03-16,2434.35,utilities,out,Counterparty_42,21904258.42,2025-02-25,2025-03-26
2025-03-16,1232.2,T&E,out,Counterparty_27,21903026.22,2025-02-06,2025-03-15
2025-03-16,4278.61,supplier_payment,out,Counterparty_20,21898747.61,2025-02-12,2025-03-12
2025-03-16,267.01,tax_payment,out,Counterparty_72,21898480.6,2025-02-19,2025-03-20
2025-03-16,5300.41,marketing_spend,out,Counterparty_56,21893180.19,2025-02-03,2025-03-13
2025-03-16,369.64,tax_payment,out,Counterparty_69,21892810.55,2025-02-24,2025-03-24
2025-03-16,5812.31,rent,out,Counterparty_26,21886998.24,2025-02-05,2025-03-16
2025-03-16,6946.02,T&E,out,Counterparty_36,21880052.22,2025-02-01,2025-02-28
2025-03-16,7371.53,loan_repayment,out,Counterparty_52,21872680.69,2025-02-19,2025-03-18
2025-03-16,302.8,rent,out,Counterparty_22,21872377.89,2025-02-22,2025-03-26
2025-03-16,1201.26,rent,out,Counterparty_49,21871176.63,2025-02-08,2025-03-13
2025-03-16,657.47,loan_repayment,out,Counterparty_46,21870519.16,2025-02-28,2025-03-26
2025-03-16,280.32,utilities,out,Counterparty_93,21870238.84,2025-02-04,2025-03-04
2025-03-16,8071.78,utilities,out,Counterparty_20,21862167.06,2025-02-19,2025-03-17
2025-03-16,10016.49,payroll,out,Counterparty_28,21852150.57,2025-02-06,2025-03-05
2025-03-16,5729.05,marketing_spend,out,Counterparty_17,21846421.52,2025-02-25,2025-03-23
2025-03-16,2667.48,rent,out,Counterparty_36,21843754.04,2025-02-24,2025-03-31
2025-03-16,183.46,tax_payment,out,Counterparty_11,21843570.58,2025-02-16,2025-03-27
2025-03-16,478.08,utilities,out,Counterparty_91,21843092.5,2025-02-19,2025-03-19
2025-03-16,139.43,software_subscription,out,Counterparty_54,21842953.07,2025-02-25,2025-03-24
2025-03-16,225.09,payroll,out,Counterparty_72,21842727.98,2025-02-16,2025-03-15
2025-03-16,1996.72,software_subscription,out,Counterparty_15,21840731.26,2025-02-01,2025-03-09
2025-03-16,855.4,supplier_payment,out,Counterparty_18,21839875.86,2025-02-09,2025-03-06
2025-03-16,1280.26,supplier_payment,out,Counterparty_18,21838595.6,2025-02-26,2025-03-29
2025-03-16,1875.48,T&E,out,Counterparty_98,21836720.12,2025-02-22,2025-03-25
2025-03-16,1966.51,asset_sale,in,Counterparty_97,21838686.63,,
2025-03-16,1918.92,investment_income,in,Counterparty_12,21840605.55,,
2025-03-16,2508.8,asset_sale,in,Counterparty_51,21843114.35,,
2025-03-16,14758.13,asset_sale,in,Counterparty_76,21857872.48,,
2025-03-16,1941.94,investment_income,in,Counterparty_17,21859814.42,,
2025-03-16,2085.0,asset_sale,in,Counterparty_67,21861899.42,,
2025-03-16,969.44,utilities,out,Counterparty_59,21860929.98,2025-02-07,2025-03-10
2025-03-16,348.04,refund,in,Counterparty_72,21861278.02,,
2025-03-16,7208.34,customer_payment,in,Counterparty_58,21868486.36,,
2025-03-16,7427.2,credit,in,Counterparty_56,21875913.56,,
2025-03-16,10052.96,investment_income,in,Counterparty_22,21885966.52,,
2025-03-16,10746.28,credit,in,Counterparty_83,21896712.8,,
2025-03-16,1294.47,credit,in,Counterparty_46,21898007.27,,
2025-03-16,9250.29,asset_sale,in,Counterparty_62,21907257.56,,
2025-03-16,539.35,rent,out,Counterparty_8,21906718.21,2025-02-24,2025-03-28
2025-03-16,1130.95,investment_income,in,Counterparty_93,21907849.16,,
2025-03-16,17542.84,investment_income,in,Counterparty_39,21925392.0,,
2025-03-16,567.83,customer_payment,in,Counterparty_43,21925959.83,,
2025-03-16,1111.77,credit,in,Counterparty_42,21927071.6,,
2025-03-16,1967.28,investment_income,in,Counterparty_4,21929038.88,,
2025-03-16,166.46,customer_payment,in,Counterparty_92,21929205.34,,
2025-03-16,6495.8,refund,in,Counterparty_53,21935701.14,,
2025-03-16,5603.47,customer_payment,in,Counterparty_70,21941304.61,,
2025-03-16,7704.47,investment_income,in,Counterparty_95,21949009.08,,
2025-03-16,3055.19,customer_payment,in,Counterparty_28,21952064.27,,
2025-03-16,7251.81,investment_income,in,Counterparty_68,21959316.08,,
2025-03-16,3661.0,tax_payment,out,Counterparty_49,21955655.08,2025-02-16,2025-03-26
2025-03-16,2179.83,credit,in,Counterparty_88,21957834.91,,
2025-03-17,210.25,loan_repayment,out,Counterparty_68,21957624.66,2025-02-22,2025-03-31
2025-03-17,8802.17,customer_payment,in,Counterparty_95,21966426.83,,
2025-03-17,13020.74,utilities,out,Counterparty_2,21953406.09,2025-02-15,2025-03-23
2025-03-17,1559.08,customer_payment,in,Counterparty_78,21954965.17,,
2025-03-17,3736.5,refund,in,Counterparty_2,21958701.67,,
2025-03-17,9793.89,marketing_spend,out,Counterparty_25,21948907.78,2025-02-23,2025-03-29
2025-03-17,300.33,software_subscription,out,Counterparty_93,21948607.45,2025-02-26,2025-04-05
2025-03-17,2895.9,software_subscription,out,Counterparty_23,21945711.55,2025-02-08,2025-03-19
2025-03-17,10854.62,loan_repayment,out,Counterparty_47,21934856.93,2025-02-22,2025-03-25
2025-03-17,3535.09,investment_income,in,Counterparty_54,21938392.02,,
2025-03-17,3291.67,tax_payment,out,Counterparty_47,21935100.35,2025-02-22,2025-03-19
2025-03-17,42.17,asset_sale,in,Counterparty_8,21935142.52,,
2025-03-17,2289.59,supplier_payment,out,Counterparty_61,21932852.93,2025-02-01,2025-03-11
2025-03-17,6356.02,supplier_payment,out,Counterparty_81,21926496.91,2025-02-25,2025-03-31
2025-03-17,4436.96,investment_income,in,Counterparty_43,21930933.87,,
2025-03-17,3004.4,asset_sale,in,Counterparty_47,21933938.27,,
2025-03-17,158.14,T&E,out,Counterparty_51,21933780.13,2025-02-07,2025-03-16
2025-03-17,10463.56,credit,in,Counterparty_57,21944243.69,,
2025-03-17,7391.24,software_subscription,out,Counterparty_27,21936852.45,2025-02-21,2025-03-25
2025-03-17,524.41,customer_payment,in,Counterparty_2,21937376.86,,
2025-03-17,6050.38,asset_sale,in,Counterparty_96,21943427.24,,
2025-03-17,3290.86,investment_income,in,Counterparty_59,21946718.1,,
2025-03-17,2106.69,utilities,out,Counterparty_59,21944611.41,2025-02-07,2025-03-07
2025-03-17,3768.85,rent,out,Counterparty_37,21940842.56,2025-02-16,2025-03-17
2025-03-17,15640.01,refund,in,Counterparty_60,21956482.57,,
2025-03-17,1985.66,payroll,out,Counterparty_96,21954496.91,2025-03-02,2025-04-10
2025-03-18,12994.52,loan_repayment,out,Counterparty_1,21941502.39,2025-02-13,2025-03-21
2025-03-18,4009.19,utilities,out,Counterparty_95,21937493.2,2025-02-11,2025-03-18
2025-03-18,4940.64,tax_payment,out,Counterparty_91,21932552.56,2025-02-14,2025-03-21
2025-03-18,4708.87,utilities,out,Counterparty_26,21927843.69,2025-02-22,2025-03-24
2025-03-18,8445.99,software_subscription,out,Counterparty_99,21919397.7,2025-02-28,2025-04-08
2025-03-18,19686.15,refund,in,Counterparty_35,21939083.85,,
2025-03-18,3166.71,T&E,out,Counterparty_1,21935917.14,2025-02-26,2025-03-31
2025-03-18,4351.63,tax_payment,out,Counterparty_19,21931565.51,2025-02-07,2025-03-04
2025-03-18,3957.6,credit,in,Counterparty_29,21935523.11,,
2025-03-18,2913.21,investment_income,in,Counterparty_75,21938436.32,,
2025-03-18,706.72,payroll,out,Counterparty_18,21937729.6,2025-02-15,2025-03-18
2025-03-18,840.64,customer_payment,in,Counterparty_93,21938570.24,,
2025-03-18,4456.38,supplier_payment,out,Counterparty_59,21934113.86,2025-02-09,2025-03-17
2025-03-18,3379.53,credit,in,Counterparty_64,21937493.39,,
2025-03-18,131.45,payroll,out,Counterparty_64,21937361.94,2025-02-06,2025-03-07
2025-03-18,560.28,investment_income,in,Counterparty_87,21937922.22,,
2025-03-18,1554.12,investment_income,in,Counterparty_51,21939476.34,,
2025-03-18,3464.93,refund,in,Counterparty_6,21942941.27,,
2025-03-18,1393.02,marketing_spend,out,Counterparty_63,21941548.25,2025-02-18,2025-03-24
2025-03-18,3502.24,software_subscription,out,Counterparty_41,21938046.01,2025-02-07,2025-03-05
2025-03-18,3727.71,customer_payment,in,Counterparty_23,21941773.72,,
2025-03-18,10410.16,tax_payment,out,Counterparty_97,21931363.56,2025-02-11,2025-03-14
2025-03-18,3065.15,rent,out,Counterparty_25,21928298.41,2025-03-03,2025-04-07
2025-03-18,337.23,credit,in,Counterparty_79,21928635.64,,
2025-03-18,461.56,asset_sale,in,Counterparty_24,21929097.2,,
2025-03-18,7868.07,investment_income,in,Counterparty_35,21936965.27,,
2025-03-18,1309.94,rent,out,Counterparty_17,21935655.33,2025-02-07,2025-03-18
2025-03-18,12417.34,supplier_payment,out,Counterparty_46,21923237.99,2025-03-03,2025-04-07
2025-03-18,4875.93,rent,out,Counterparty_75,21918362.06,2025-02-24,2025-04-02
2025-03-18,6224.08,rent,out,Counterparty_17,21912137.98,2025-02-06,2025-03-11
2025-03-18,4528.92,payroll,out,Counterparty_21,21907609.06,2025-02-19,2025-03-18
2025-03-18,3342.78,tax_payment,out,Counterparty_44,21904266.28,2025-02-04,2025-03-12
2025-03-18,3944.99,software_subscription,out,Counterparty_63,21900321.29,2025-02-25,2025-04-03
2025-03-18,2214.04,investment_income,in,Counterparty_41,21902535.33,,
2025-03-18,501.7,asset_sale,in,Counterparty_35,21903037.03,,
2025-03-18,4744.26,payroll,out,Counterparty_79,21898292.77,2025-02-02,2025-03-02
2025-03-18,7512.16,marketing_spend,out,Counterparty_57,21890780.61,2025-02-16,2025-03-25
2025-03-18,3544.8,supplier_payment,out,Counterparty_94,21887235.81,2025-02-07,2025-03-18
2025-03-18,2476.09,loan_repayment,out,Counterparty_45,21884759.72,2025-02-15,2025-03-12
2025-03-18,686.65,T&E,out,Counterparty_35,21884073.07,2025-02-21,2025-03-20
2025-03-18,1714.53,credit,in,Counterparty_65,21885787.6,,
2025-03-18,9702.58,rent,out,Counterparty_19,21876085.02,2025-02-10,2025-03-11
2025-03-18,3488.97,investment_income,in,Counterparty_55,21879573.99,,
2025-03-18,6883.45,asset_sale,in,Counterparty_16,21886457.44,,
2025-03-18,3320.94,software_subscription,out,Counterparty_24,21883136.5,2025-02-11,2025-03-10
2025-03-18,2779.01,rent,out,Counterparty_99,21880357.49,2025-03-01,2025-04-09
2025-03-18,4541.24,tax_payment,out,Counterparty_20,21875816.25,2025-02-06,2025-03-13
2025-03-18,11563.56,supplier_payment,out,Counterparty_47,21864252.69,2025-02-23,2025-03-27
2025-03-19,873.24,T&E,out,Counterparty_52,21863379.45,2025-02-20,2025-03-21
2025-03-19,1176.75,investment_income,in,Counterparty_27,21864556.2,,
2025-03-19,781.15,loan_repayment,out,Counterparty_1,21863775.05,2025-02-06,2025-03-16
2025-03-19,7401.92,investment_income,in,Counterparty_45,21871176.97,,
2025-03-19,1978.58,payroll,out,Counterparty_66,21869198.39,2025-02-25,2025-03-29
2025-03-19,3023.58,utilities,out,Counterparty_71,21866174.81,2025-03-02,2025-03-31
2025-03-19,169.63,customer_payment,in,Counterparty_25,21866344.44,,
2025-03-19,3777.06,loan_repayment,out,Counterparty_9,21862567.38,2025-03-04,2025-04-10
2025-03-19,6892.07,payroll,out,Counterparty_29,21855675.31,2025-02-07,2025-03-07
2025-03-19,577.02,payroll,out,Counterparty_67,21855098.29,2025-02-07,2025-03-16
2025-03-19,1161.61,credit,in,Counterparty_73,21856259.9,,
2025-03-19,8319.37,supplier_payment,out,Counterparty_84,21847940.53,2025-02-13,2025-03-10
2025-03-19,3563.28,credit,in,Counterparty_21,21851503.81,,
2025-03-19,2755.85,customer_payment,in,Counterparty_72,21854259.66,,
2025-03-19,2425.54,supplier_payment,out,Counterparty_24,21851834.12,2025-02-22,2025-03-29
2025-03-19,610.69,software_subscription,out,Counterparty_12,21851223.43,2025-02-21,2025-03-18
2025-03-19,1566.49,utilities,out,Counterparty_89,21849656.94,2025-02-14,2025-03-16
2025-03-19,1691.06,supplier_payment,out,Counterparty_64,21847965.88,2025-02-09,2025-03-09
2025-03-19,1276.38,asset_sale,in,Counterparty_13,21849242.26,,
2025-03-19,1231.98,rent,out,Counterparty_40,21848010.28,2025-02-17,2025-03-14
2025-03-19,402.14,credit,in,Counterparty_62,21848412.42,,
2025-03-19,116.99,supplier_payment,out,Counterparty_72,21848295.43,2025-02-09,2025-03-11
2025-03-19,344.83,payroll,out,Counterparty_14,21847950.6,2025-02-24,2025-03-31
2025-03-19,154.67,T&E,out,Counterparty_44,21847795.93,2025-02-04,2025-03-08
2025-03-19,3591.37,refund,in,Counterparty_22,21851387.3,,
2025-03-19,973.47,supplier_payment,out,Counterparty_44,21850413.83,2025-02-22,2025-03-29
2025-03-19,2564.96,credit,in,Counterparty_55,21852978.79,,
2025-03-19,5824.9,asset_sale,in,Counterparty_6,21858803.69,,
2025-03-19,5487.59,tax_payment,out,Counterparty_6,21853316.1,2025-02-22,2025-03-24
2025-03-19,5530.77,marketing_spend,out,Counterparty_56,21847785.33,2025-02-04,2025-03-14
2025-03-19,2162.55,tax_payment,out,Counterparty_64,21845622.78,2025-02-18,2025-03-23
2025-03-19,9783.71,investment_income,in,Counterparty_4,21855406.49,,
2025-03-19,6147.17,refund,in,Counterparty_82,21861553.66,,
2025-03-19,5828.75,utilities,out,Counterparty_95,21855724.91,2025-02-17,2025-03-27
2025-03-19,1518.15,investment_income,in,Counterparty_21,21857243.06,,
2025-03-19,4012.79,refund,in,Counterparty_58,21861255.85,,
2025-03-19,3398.52,marketing_spend,out,Counterparty_72,21857857.33,2025-02-23,2025-04-02
2025-03-20,586.58,refund,in,Counterparty_31,21858443.91,,
2025-03-20,2189.18,refund,in,Counterparty_47,21860633.09,,
2025-03-20,1147.03,refund,in,Counterparty_5,21861780.12,,
2025-03-20,2148.43,utilities,out,Counterparty_3,21859631.69,2025-02-18,2025-03-24
2025-03-20,6006.7,payroll,out,Counterparty_20,21853624.99,2025-02-07,2025-03-17
2025-03-20,5644.01,customer_payment,in,Counterparty_33,21859269.0,,
2025-03-20,3731.9,marketing_spend,out,Counterparty_98,21855537.1,2025-02-23,2025-03-30
2025-03-20,2022.0,marketing_spend,out,Counterparty_89,21853515.1,2025-02-26,2025-04-03
2025-03-20,15609.92,rent,out,Counterparty_51,21837905.18,2025-02-11,2025-03-09
2025-03-20,999.09,refund,in,Counterparty_39,21838904.27,,
2025-03-20,7251.98,payroll,out,Counterparty_18,21831652.29,2025-03-02,2025-03-31
2025-03-20,329.47,customer_payment,in,Counterparty_38,21831981.76,,
2025-03-20,3107.76,customer_payment,in,Counterparty_87,21835089.52,,
2025-03-20,2570.95,payroll,out,Counterparty_38,21832518.57,2025-02-15,2025-03-23
2025-03-20,1167.33,T&E,out,Counterparty_41,21831351.24,2025-02-27,2025-04-02
2025-03-20,2204.48,supplier_payment,out,Counterparty_83,21829146.76,2025-02-16,2025-03-15
2025-03-20,11389.97,T&E,out,Counterparty_40,21817756.79,2025-03-02,2025-03-31
2025-03-20,9220.07,marketing_spend,out,Counterparty_88,21808536.72,2025-02-24,2025-03-22
2025-03-20,4270.56,payroll,out,Counterparty_7,21804266.16,2025-02-18,2025-03-29
2025-03-20,503.05,customer_payment,in,Counterparty_70,21804769.21,,
2025-03-20,1793.2,asset_sale,in,Counterparty_31,21806562.41,,
2025-03-20,10784.97,refund,in,Counterparty_53,21817347.38,,
2025-03-20,7158.11,investment_income,in,Counterparty_79,21824505.49,,
2025-03-20,4616.25,marketing_spend,out,Counterparty_93,21819889.24,2025-02-21,2025-03-31
2025-03-20,2912.74,payroll,out,Counterparty_91,21816976.5,2025-02-21,2025-03-21
2025-03-20,2712.34,loan_repayment,out,Counterparty_17,21814264.16,2025-02-08,2025-03-08
2025-03-20,372.73,supplier_payment,out,Counterparty_1,21813891.43,2025-02-11,2025-03-09
2025-03-20,3851.02,tax_payment,out,Counterparty_65,21810040.41,2025-03-02,2025-03-27
2025-03-20,726.55,utilities,out,Counterparty_83,21809313.86,2025-02-25,2025-03-26
2025-03-20,6276.93,payroll,out,Counterparty_41,21803036.93,2025-02-09,2025-03-16
2025-03-20,1353.37,software_subscription,out,Counterparty_73,21801683.56,2025-03-02,2025-04-06
2025-03-20,1184.33,tax_payment,out,Counterparty_89,21800499.23,2025-02-18,2025-03-17
2025-03-20,146.78,marketing_spend,out,Counterparty_20,21800352.45,2025-02-27,2025-04-07
2025-03-20,2586.62,refund,in,Counterparty_77,21802939.07,,
2025-03-20,1054.11,customer_payment,in,Counterparty_30,21803993.18,,
2025-03-20,3163.28,payroll,out,Counterparty_6,21800829.9,2025-02-15,2025-03-22
2025-03-20,14243.79,payroll,out,Counterparty_30,21786586.11,2025-02-10,2025-03-10
2025-03-20,4238.49,asset_sale,in,Counterparty_43,21790824.6,,
2025-03-20,184.43,T&E,out,Counterparty_65,21790640.17,2025-03-04,2025-04-03
2025-03-20,1453.32,marketing_spend,out,Counterparty_6,21789186.85,2025-02-28,2025-04-08
2025-03-20,6492.75,software_subscription,out,Counterparty_23,21782694.1,2025-02-12,2025-03-09
2025-03-20,5289.87,T&E,out,Counterparty_57,21777404.23,2025-02-15,2025-03-24
2025-03-20,4111.16,payroll,out,Counterparty_80,21773293.07,2025-02-22,2025-03-20
2025-03-20,2739.33,tax_payment,out,Counterparty_4,21770553.74,2025-02-06,2025-03-16
2025-03-20,1064.68,rent,out,Counterparty_29,21769489.06,2025-02-09,2025-03-17
2025-03-20,1803.11,marketing_spend,out,Counterparty_67,21767685.95,2025-02-22,2025-03-22
2025-03-21,422.88,credit,in,Counterparty_76,21768108.83,,
2025-03-21,6233.08,credit,in,Counterparty_58,21774341.91,,
2025-03-21,155.34,customer_payment,in,Counterparty_87,21774497.25,,
2025-03-21,331.35,utilities,out,Counterparty_7,21774165.9,2025-02-23,2025-03-26
2025-03-21,8259.48,credit,in,Counterparty_65,21782425.38,,
2025-03-21,4027.7,customer_payment,in,Counterparty_65,21786453.08,,
2025-03-21,2111.59,asset_sale,in,Counterparty_2,21788564.67,,
2025-03-21,3807.68,supplier_payment,out,Counterparty_72,21784756.99,2025-02-20,2025-03-21
2025-03-21,3015.63,refund,in,Counterparty_31,21787772.62,,
2025-03-21,20687.9,customer_payment,in,Counterparty_94,21808460.52,,
2025-03-21,627.21,customer_payment,in,Counterparty_38,21809087.73,,
2025-03-21,129.71,investment_income,in,Counterparty_33,21809217.44,,
2025-03-21,683.52,supplier_payment,out,Counterparty_49,21808533.92,2025-03-06,2025-04-13
2025-03-21,2448.2,loan_repayment,out,Counterparty_57,21806085.72,2025-03-06,2025-04-01
2025-03-21,1637.93,utilities,out,Counterparty_39,21804447.79,2025-02-17,2025-03-15
2025-03-21,2970.75,loan_repayment,out,Counterparty_76,21801477.04,2025-02-21,2025-03-21
2025-03-21,1846.71,tax_payment,out,Counterparty_29,21799630.33,2025-02-18,2025-03-15
2025-03-21,7448.13,supplier_payment,out,Counterparty_28,21792182.2,2025-02-18,2025-03-17
2025-03-21,463.28,supplier_payment,out,Counterparty_60,21791718.92,2025-02-26,2025-04-02
2025-03-21,66.81,software_subscription,out,Counterparty_19,21791652.11,2025-02-14,2025-03-11
2025-03-21,2919.02,credit,in,Counterparty_15,21794571.13,,
2025-03-21,1780.72,credit,in,Counterparty_38,21796351.85,,
2025-03-21,6269.41,refund,in,Counterparty_27,21802621.26,,
2025-03-21,6744.87,supplier_payment,out,Counterparty_8,21795876.39,2025-02-07,2025-03-08
2025-03-21,2559.59,marketing_spend,out,Counterparty_5,21793316.8,2025-02-13,2025-03-20
2025-03-21,3278.28,rent,out,Counterparty_87,21790038.52,2025-03-05,2025-04-06
2025-03-21,1811.56,refund,in,Counterparty_42,21791850.08,,
2025-03-21,7109.2,rent,out,Counterparty_72,21784740.88,2025-02-28,2025-04-08
2025-03-21,2151.02,supplier_payment,out,Counterparty_98,21782589.86,2025-02-17,2025-03-17
2025-03-21,7845.1,investment_income,in,Counterparty_80,21790434.96,,
2025-03-21,2843.39,investment_income,in,Counterparty_26,21793278.35,,
2025-03-21,2737.06,T&E,out,Counterparty_28,21790541.29,2025-02-23,2025-03-30
2025-03-21,2793.92,refund,in,Counterparty_72,21793335.21,,
2025-03-21,2538.02,investment_income,in,Counterparty_80,21795873.23,,
2025-03-21,6127.41,credit,in,Counterparty_50,21802000.64,,
2025-03-21,2683.88,customer_payment,in,Counterparty_59,21804684.52,,
2025-03-21,2017.51,customer_payment,in,Counterparty_67,21806702.03,,
2025-03-21,7564.28,payroll,out,Counterparty_49,21799137.75,2025-02-17,2025-03-28
2025-03-21,9558.07,investment_income,in,Counterparty_25,21808695.82,,
2025-03-21,4251.8,T&E,out,Counterparty_37,21804444.02,2025-02-20,2025-03-23
2025-03-21,4766.79,customer_payment,in,Counterparty_7,21809210.81,,
2025-03-21,2353.72,supplier_payment,out,Counterparty_15,21806857.09,2025-02-05,2025-03-15
2025-03-21,2872.1,asset_sale,in,Counterparty_39,21809729.19,,
2025-03-21,3729.3,customer_payment,in,Counterparty_96,21813458.49,,
2025-03-22,1386.6,refund,in,Counterparty_69,21814845.09,,
2025-03-22,4693.45,investment_income,in,Counterparty_3,21819538.54,,
2025-03-22,3375.76,software_subscription,out,Counterparty_3,21816162.78,2025-03-03,2025-04-08
2025-03-22,4287.9,marketing_spend,out,Counterparty_11,21811874.88,2025-03-03,2025-04-09
2025-03-22,532.29,refund,in,Counterparty_48,21812407.17,,
2025-03-22,4290.0,tax_payment,out,Counterparty_25,21808117.17,2025-02-28,2025-03-28
2025-03-22,637.76,investment_income,in,Counterparty_22,21808754.93,,
2025-03-22,361.39,asset_sale,in,Counterparty_8,21809116.32,,
2025-03-22,1376.55,investment_income,in,Counterparty_15,21810492.87,,
2025-03-22,3989.68,asset_sale,in,Counterparty_27,21814482.55,,
2025-03-22,1088.59,utilities,out,Counterparty_12,21813393.96,2025-03-07,2025-04-09
2025-03-22,723.08,refund,in,Counterparty_19,21814117.04,,
2025-03-22,1725.67,software_subscription,out,Counterparty_57,21812391.37,2025-02-22,2025-03-21
2025-03-22,4503.79,investment_income,in,Counterparty_89,21816895.16,,
2025-03-22,4449.13,supplier_payment,out,Counterparty_54,21812446.03,2025-02-18,2025-03-25
2025-03-22,4833.9,tax_payment,out,Counterparty_97,21807612.13,2025-02-23,2025-04-01
2025-03-22,4337.04,loan_repayment,out,Counterparty_59,21803275.09,2025-02-27,2025-03-29
2025-03-22,4377.41,investment_income,in,Counterparty_12,21807652.5,,
2025-03-22,3098.35,refund,in,Counterparty_20,21810750.85,,
2025-03-22,2787.88,rent,out,Counterparty_82,21807962.97,2025-03-04,2025-04-08
2025-03-22,2091.03,credit,in,Counterparty_94,21810054.0,,
2025-03-22,2182.65,tax_payment,out,Counterparty_97,21807871.35,2025-02-12,2025-03-22
2025-03-22,2055.94,refund,in,Counterparty_6,21809927.29,,
2025-03-22,22114.04,investment_income,in,Counterparty_68,21832041.33,,
2025-03-22,2221.12,refund,in,Counterparty_87,21834262.45,,
2025-03-22,5511.99,utilities,out,Counterparty_16,21828750.46,2025-02-26,2025-04-03
2025-03-22,1549.09,utilities,out,Counterparty_94,21827201.37,2025-02-14,2025-03-20
2025-03-22,6162.71,utilities,out,Counterparty_23,21821038.66,2025-03-07,2025-04-11
2025-03-22,2583.11,refund,in,Counterparty_1,21823621.77,,
2025-03-22,230.89,customer_payment,in,Counterparty_30,21823852.66,,
2025-03-22,3952.73,rent,out,Counterparty_9,21819899.93,2025-03-05,2025-04-12
2025-03-22,8434.29,rent,out,Counterparty_17,21811465.64,2025-03-07,2025-04-05
2025-03-22,2514.06,tax_payment,out,Counterparty_70,21808951.58,2025-03-02,2025-03-30
2025-03-22,200.14,rent,out,Counterparty_76,21808751.44,2025-02-17,2025-03-24
2025-03-22,8505.24,tax_payment,out,Counterparty_61,21800246.2,2025-02-16,2025-03-18
2025-03-22,1497.54,investment_income,in,Counterparty_3,21801743.74,,
2025-03-22,576.34,software_subscription,out,Counterparty_53,21801167.4,2025-02-06,2025-03-05
2025-03-22,354.96,tax_payment,out,Counterparty_37,21800812.44,2025-02-25,2025-03-24
2025-03-22,2164.86,customer_payment,in,Counterparty_44,21802977.3,,
2025-03-22,687.51,marketing_spend,out,Counterparty_10,21802289.79,2025-03-07,2025-04-08
2025-03-22,2157.12,investment_income,in,Counterparty_63,21804446.91,,
2025-03-22,13034.56,customer_payment,in,Counterparty_18,21817481.47,,
2025-03-22,2268.82,tax_payment,out,Counterparty_2,21815212.65,2025-02-25,2025-04-02
2025-03-22,7340.58,asset_sale,in,Counterparty_46,21822553.23,,
2025-03-22,14.57,rent,out,Counterparty_10,21822538.66,2025-02-20,2025-03-24
2025-03-22,7487.54,credit,in,Counterparty_55,21830026.2,,
2025-03-22,5101.44,tax_payment,out,Counterparty_43,21824924.76,2025-02-25,2025-03-31
2025-03-22,1477.77,investment_income,in,Counterparty_1,21826402.53,,
2025-03-22,10189.56,investment_income,in,Counterparty_3,21836592.09,,
2025-03-22,11156.3,loan_repayment,out,Counterparty_55,21825435.79,2025-02-21,2025-04-01
2025-03-22,9124.22,supplier_payment,out,Counterparty_23,21816311.57,2025-02-25,2025-03-22
2025-03-22,7720.77,T&E,out,Counterparty_60,21808590.8,2025-02-19,2025-03-20
2025-03-22,1387.54,T&E,out,Counterparty_53,21807203.26,2025-02-28,2025-04-07
2025-03-23,94.03,customer_payment,in,Counterparty_65,21807297.29,,
2025-03-23,12936.41,customer_payment,in,Counterparty_28,21820233.7,,
2025-03-23,4741.19,supplier_payment,out,Counterparty_2,21815492.51,2025-02-26,2025-03-26
2025-03-23,49.43,credit,in,Counterparty_41,21815541.94,,
2025-03-23,769.98,marketing_spend,out,Counterparty_86,21814771.96,2025-02-09,2025-03-20
2025-03-23,6240.75,asset_sale,in,Counterparty_62,21821012.71,,
2025-03-23,8028.05,credit,in,Counterparty_41,21829040.76,,
2025-03-23,5088.33,credit,in,Counterparty_84,21834129.09,,
2025-03-23,9357.04,loan_repayment,out,Counterparty_48,21824772.05,2025-02-12,2025-03-12
2025-03-23,7797.64,payroll,out,Counterparty_17,21816974.41,2025-02-16,2025-03-14
2025-03-23,1982.5,investment_income,in,Counterparty_85,21818956.91,,
2025-03-23,1651.23,credit,in,Counterparty_3,21820608.14,,
2025-03-23,7304.48,software_subscription,out,Counterparty_92,21813303.66,2025-02-16,2025-03-17
2025-03-23,6677.23,software_subscription,out,Counterparty_84,21806626.43,2025-02-20,2025-03-24
2025-03-23,8877.45,utilities,out,Counterparty_56,21797748.98,2025-02-24,2025-04-04
2025-03-23,1815.35,refund,in,Counterparty_64,21799564.33,,
2025-03-23,1416.89,investment_income,in,Counterparty_75,21800981.22,,
2025-03-23,1184.2,credit,in,Counterparty_98,21802165.42,,
2025-03-23,965.73,asset_sale,in,Counterparty_81,21803131.15,,
2025-03-23,431.08,investment_income,in,Counterparty_94,21803562.23,,
2025-03-23,216.33,refund,in,Counterparty_68,21803778.56,,
2025-03-23,9398.29,rent,out,Counterparty_73,21794380.27,2025-02-26,2025-04-01
2025-03-23,2041.29,payroll,out,Counterparty_94,21792338.98,2025-02-24,2025-03-30
2025-03-23,631.17,marketing_spend,out,Counterparty_7,21791707.81,2025-02-28,2025-04-07
2025-03-23,6141.29,T&E,out,Counterparty_85,21785566.52,2025-02-16,2025-03-19
2025-03-23,4087.0,credit,in,Counterparty_72,21789653.52,,
2025-03-23,58.21,asset_sale,in,Counterparty_6,21789711.73,,
2025-03-23,11179.37,T&E,out,Counterparty_31,21778532.36,2025-02-27,2025-03-24
2025-03-23,2594.85,asset_sale,in,Counterparty_53,21781127.21,,
2025-03-23,4043.68,asset_sale,in,Counterparty_15,21785170.89,,
2025-03-23,11225.96,tax_payment,out,Counterparty_47,21773944.93,2025-03-08,2025-04-12
2025-03-23,1488.66,customer_payment,in,Counterparty_10,21775433.59,,
2025-03-23,2822.97,marketing_spend,out,Counterparty_70,21772610.62,2025-02-15,2025-03-21
2025-03-23,3343.77,marketing_spend,out,Counterparty_4,21769266.85,2025-03-07,2025-04-05
2025-03-23,4486.41,utilities,out,Counterparty_53,21764780.44,2025-03-03,2025-04-03
2025-03-23,7929.1,loan_repayment,out,Counterparty_14,21756851.34,2025-02-20,2025-03-25
2025-03-23,5613.14,asset_sale,in,Counterparty_58,21762464.48,,
2025-03-23,3794.7,credit,in,Counterparty_1,21766259.18,,
2025-03-23,5244.27,refund,in,Counterparty_20,21771503.45,,
2025-03-23,6666.26,rent,out,Counterparty_12,21764837.19,2025-03-08,2025-04-07
2025-03-23,899.35,tax_payment,out,Counterparty_27,21763937.84,2025-02-27,2025-04-05
2025-03-23,3338.63,asset_sale,in,Counterparty_45,21767276.47,,
2025-03-23,3780.15,supplier_payment,out,Counterparty_93,21763496.32,2025-02-28,2025-04-04
2025-03-23,3982.95,T&E,out,Counterparty_90,21759513.37,2025-02-08,2025-03-11
2025-03-23,19022.7,payroll,out,Counterparty_15,21740490.67,2025-02-16,2025-03-13
2025-03-23,616.57,tax_payment,out,Counterparty_33,21739874.1,2025-02-10,2025-03-09
2025-03-23,4879.61,loan_repayment,out,Counterparty_21,21734994.49,2025-03-08,2025-04-12
2025-03-24,7662.77,T&E,out,Counterparty_21,21727331.72,2025-02-14,2025-03-21
2025-03-24,3968.56,loan_repayment,out,Counterparty_68,21723363.16,2025-02-23,2025-03-29
2025-03-24,1658.12,customer_payment,in,Counterparty_47,21725021.28,,
2025-03-24,2871.47,supplier_payment,out,Counterparty_93,21722149.81,2025-02-12,2025-03-20
2025-03-24,43.83,loan_repayment,out,Counterparty_27,21722105.98,2025-02-20,2025-03-28
2025-03-24,6605.67,utilities,out,Counterparty_10,21715500.31,2025-03-02,2025-04-03
2025-03-24,2195.82,marketing_spend,out,Counterparty_57,21713304.49,2025-02-20,2025-03-21
2025-03-24,340.95,tax_payment,out,Counterparty_3,21712963.54,2025-03-02,2025-03-27
2025-03-24,1818.76,investment_income,in,Counterparty_75,21714782.3,,
2025-03-24,1296.48,marketing_spend,out,Counterparty_97,21713485.82,2025-02-17,2025-03-15
2025-03-24,4784.66,asset_sale,in,Counterparty_58,21718270.48,,
2025-03-24,6628.59,T&E,out,Counterparty_75,21711641.89,2025-03-02,2025-03-30
2025-03-24,1375.25,refund,in,Counterparty_85,21713017.14,,
2025-03-24,695.74,software_subscription,out,Counterparty_41,21712321.4,2025-02-13,2025-03-20
2025-03-24,233.8,loan_repayment,out,Counterparty_54,21712087.6,2025-03-03,2025-04-01
2025-03-24,9502.79,software_subscription,out,Counterparty_33,21702584.81,2025-02-28,2025-04-08
2025-03-24,2576.22,supplier_payment,out,Counterparty_7,21700008.59,2025-03-05,2025-04-04
2025-03-24,1936.57,payroll,out,Counterparty_81,21698072.02,2025-03-07,2025-04-10
2025-03-24,3710.79,refund,in,Counterparty_33,21701782.81,,
2025-03-24,2956.14,refund,in,Counterparty_48,21704738.95,,
2025-03-24,2023.15,credit,in,Counterparty_76,21706762.1,,
2025-03-24,1679.03,rent,out,Counterparty_79,21705083.07,2025-02-11,2025-03-08
2025-03-24,464.37,loan_repayment,out,Counterparty_92,21704618.7,2025-02-12,2025-03-15
2025-03-24,5049.2,tax_payment,out,Counterparty_70,21699569.5,2025-03-01,2025-03-26
2025-03-24,2377.88,investment_income,in,Counterparty_69,21701947.38,,
2025-03-24,143.76,software_subscription,out,Counterparty_88,21701803.62,2025-03-03,2025-04-02
2025-03-24,3397.74,customer_payment,in,Counterparty_25,21705201.36,,
2025-03-24,1343.31,investment_income,in,Counterparty_97,21706544.67,,
2025-03-24,4305.33,customer_payment,in,Counterparty_9,21710850.0,,
2025-03-24,3855.05,refund,in,Counterparty_16,21714705.05,,
2025-03-24,9953.71,loan_repayment,out,Counterparty_27,21704751.34,2025-03-01,2025-03-28
2025-03-24,1464.2,asset_sale,in,Counterparty_69,21706215.54,,
2025-03-24,952.0,credit,in,Counterparty_86,21707167.54,,
2025-03-24,7740.35,asset_sale,in,Counterparty_52,21714907.89,,
2025-03-24,5428.78,utilities,out,Counterparty_45,21709479.11,2025-02-19,2025-03-17
2025-03-24,2697.18,customer_payment,in,Counterparty_80,21712176.29,,
2025-03-24,1676.25,customer_payment,in,Counterparty_46,21713852.54,,
2025-03-24,2464.31,credit,in,Counterparty_63,21716316.85,,
2025-03-24,7976.91,marketing_spend,out,Counterparty_20,21708339.94,2025-02-23,2025-03-20
2025-03-24,186.17,payroll,out,Counterparty_39,21708153.77,2025-02-15,2025-03-25
2025-03-24,3819.15,customer_payment,in,Counterparty_2,21711972.92,,
2025-03-24,5708.87,supplier_payment,out,Counterparty_18,21706264.05,2025-03-03,2025-04-06
2025-03-24,2531.73,credit,in,Counterparty_7,21708795.78,,
2025-03-24,240.63,asset_sale,in,Counterparty_72,21709036.41,,
2025-03-24,1468.99,software_subscription,out,Counterparty_1,21707567.42,2025-03-01,2025-03-26
2025-03-24,1602.27,refund,in,Counterparty_34,21709169.69,,
2025-03-24,17.07,T&E,out,Counterparty_81,21709152.62,2025-02-21,2025-03-20
2025-03-25,2620.57,asset_sale,in,Counterparty_91,21711773.19,,
2025-03-25,1864.64,marketing_spend,out,Counterparty_90,21709908.55,2025-03-06,2025-04-12
2025-03-25,533.58,investment_income,in,Counterparty_67,21710442.13,,
2025-03-25,87.2,T&E,out,Counterparty_39,21710354.93,2025-03-09,2025-04-13
2025-03-25,4343.92,marketing_spend,out,Counterparty_41,21706011.01,2025-03-02,2025-04-09
2025-03-25,3698.19,refund,in,Counterparty_14,21709709.2,,
2025-03-25,4364.42,marketing_spend,out,Counterparty_65,21705344.78,2025-02-26,2025-03-23
2025-03-25,5106.7,customer_payment,in,Counterparty_91,21710451.48,,
2025-03-25,2787.7,customer_payment,in,Counterparty_57,21713239.18,,
2025-03-25,23381.18,customer_payment,in,Counterparty_2,21736620.36,,
2025-03-25,3045.34,refund,in,Counterparty_23,21739665.7,,
2025-03-25,1684.86,payroll,out,Counterparty_47,21737980.84,2025-02-09,2025-03-10
2025-03-25,462.0,software_subscription,out,Counterparty_45,21737518.84,2025-02-26,2025-03-26
2025-03-25,670.25,rent,out,Counterparty_72,21736848.59,2025-02-12,2025-03-19
2025-03-25,7139.87,software_subscription,out,Counterparty_47,21729708.72,2025-02-14,2025-03-12
2025-03-25,446.52,T&E,out,Counterparty_53,21729262.2,2025-03-02,2025-03-31
2025-03-25,1587.25,payroll,out,Counterparty_87,21727674.95,2025-02-13,2025-03-19
2025-03-25,3887.53,marketing_spend,out,Counterparty_11,21723787.42,2025-02-24,2025-03-27
2025-03-25,3062.5,rent,out,Counterparty_87,21720724.92,2025-02-18,2025-03-28
2025-03-25,22039.44,loan_repayment,out,Counterparty_27,21698685.48,2025-02-09,2025-03-19
2025-03-25,1433.06,rent,out,Counterparty_30,21697252.42,2025-02-26,2025-04-04
2025-03-25,1585.02,supplier_payment,out,Counterparty_79,21695667.4,2025-03-01,2025-04-07
2025-03-25,749.04,loan_repayment,out,Counterparty_44,21694918.36,2025-02-22,2025-03-27
2025-03-25,3256.85,tax_payment,out,Counterparty_70,21691661.51,2025-02-18,2025-03-25
2025-03-25,983.08,T&E,out,Counterparty_81,21690678.43,2025-02-16,2025-03-21
2025-03-25,13302.66,investment_income,in,Counterparty_10,21703981.09,,
2025-03-25,5436.44,credit,in,Counterparty_3,21709417.53,,
2025-03-25,6264.76,utilities,out,Counterparty_50,21703152.77,2025-02-12,2025-03-20
2025-03-25,7009.87,investment_income,in,Counterparty_81,21710162.64,,
2025-03-25,964.7,tax_payment,out,Counterparty_87,21709197.94,2025-02-12,2025-03-17
2025-03-25,10229.0,loan_repayment,out,Counterparty_33,21698968.94,2025-02-28,2025-04-01
2025-03-25,9414.82,marketing_spend,out,Counterparty_34,21689554.12,2025-03-10,2025-04-13
2025-03-25,2284.99,investment_income,in,Counterparty_27,21691839.11,,
2025-03-25,3080.25,customer_payment,in,Counterparty_61,21694919.36,,
2025-03-25,2953.56,asset_sale,in,Counterparty_22,21697872.92,,
2025-03-25,3222.89,marketing_spend,out,Counterparty_62,21694650.03,2025-03-04,2025-04-04
2025-03-25,4020.07,tax_payment,out,Counterparty_10,21690629.96,2025-02-28,2025-04-08
2025-03-25,12256.78,customer_payment,in,Counterparty_50,21702886.74,,
2025-03-26,1193.13,software_subscription,out,Counterparty_26,21701693.61,2025-02-18,2025-03-22
2025-03-26,3218.85,credit,in,Counterparty_71,21704912.46,,
2025-03-26,7066.73,loan_repayment,out,Counterparty_75,21697845.73,2025-02-11,2025-03-19
2025-03-26,543.56,T&E,out,Counterparty_20,21697302.17,2025-03-10,2025-04-04
2025-03-26,9940.74,tax_payment,out,Counterparty_99,21687361.43,2025-02-19,2025-03-24
2025-03-26,3801.08,refund,in,Counterparty_22,21691162.51,,
2025-03-26,5026.77,payroll,out,Counterparty_79,21686135.74,2025-02-21,2025-03-27
2025-03-26,196.89,marketing_spend,out,Counterparty_8,21685938.85,2025-02-17,2025-03-27
2025-03-26,2812.69,refund,in,Counterparty_44,21688751.54,,
2025-03-26,2045.29,marketing_spend,out,Counterparty_66,21686706.25,2025-03-09,2025-04-12
2025-03-26,17627.23,software_subscription,out,Counterparty_81,21669079.02,2025-02-25,2025-03-24
2025-03-26,3401.07,credit,in,Counterparty_76,21672480.09,,
2025-03-26,784.83,rent,out,Counterparty_76,21671695.26,2025-03-10,2025-04-17
2025-03-26,1176.3,customer_payment,in,Counterparty_83,21672871.56,,
2025-03-26,3040.6,credit,in,Counterparty_24,21675912.16,,
2025-03-26,18330.47,refund,in,Counterparty_94,21694242.63,,
2025-03-26,1872.99,credit,in,Counterparty_35,21696115.62,,
2025-03-26,9027.08,tax_payment,out,Counterparty_34,21687088.54,2025-02-26,2025-03-23
2025-03-26,3580.22,payroll,out,Counterparty_91,21683508.32,2025-02-20,2025-03-26
2025-03-26,4049.65,credit,in,Counterparty_71,21687557.97,,
2025-03-26,304.88,rent,out,Counterparty_29,21687253.09,2025-03-02,2025-04-07
2025-03-26,14397.35,credit,in,Counterparty_47,21701650.44,,
2025-03-26,2243.99,payroll,out,Counterparty_25,21699406.45,2025-03-04,2025-04-08
2025-03-26,1929.51,T&E,out,Counterparty_1,21697476.94,2025-02-10,2025-03-07
2025-03-26,7904.59,asset_sale,in,Counterparty_82,21705381.53,,
2025-03-26,17347.66,software_subscription,out,Counterparty_67,21688033.87,2025-02-16,2025-03-14
2025-03-26,5873.92,investment_income,in,Counterparty_36,21693907.79,,
2025-03-26,5661.6,supplier_payment,out,Counterparty_70,21688246.19,2025-02-16,2025-03-16
2025-03-26,1951.65,T&E,out,Counterparty_31,21686294.54,2025-03-08,2025-04-07
2025-03-26,3582.42,asset_sale,in,Counterparty_54,21689876.96,,
2025-03-26,4045.29,refund,in,Counterparty_91,21693922.25,,
2025-03-26,6139.08,loan_repayment,out,Counterparty_21,21687783.17,2025-02-15,2025-03-22
2025-03-26,5312.1,software_subscription,out,Counterparty_5,21682471.07,2025-02-22,2025-03-26
2025-03-26,4778.0,credit,in,Counterparty_78,21687249.07,,
2025-03-26,4610.23,marketing_spend,out,Counterparty_16,21682638.84,2025-03-11,2025-04-11
2025-03-26,21096.56,investment_income,in,Counterparty_70,21703735.4,,
2025-03-26,178.37,investment_income,in,Counterparty_11,21703913.77,,
2025-03-26,536.77,customer_payment,in,Counterparty_32,21704450.54,,
2025-03-26,2667.76,supplier_payment,out,Counterparty_49,21701782.78,2025-02-20,2025-03-25
2025-03-26,6773.15,utilities,out,Counterparty_79,21695009.63,2025-03-06,2025-04-08
2025-03-26,1623.9,credit,in,Counterparty_66,21696633.53,,
2025-03-26,10039.0,customer_payment,in,Counterparty_41,21706672.53,,
2025-03-26,9825.05,credit,in,Counterparty_72,21716497.58,,
2025-03-26,3636.5,tax_payment,out,Counterparty_43,21712861.08,2025-03-10,2025-04-15
2025-03-27,13249.32,refund,in,Counterparty_60,21726110.4,,
2025-03-27,2292.75,investment_income,in,Counterparty_15,21728403.15,,
2025-03-27,1497.97,credit,in,Counterparty_51,21729901.12,,
2025-03-27,3468.01,customer_payment,in,Counterparty_72,21733369.13,,
2025-03-27,6886.0,asset_sale,in,Counterparty_68,21740255.13,,
2025-03-27,1270.76,credit,in,Counterparty_19,21741525.89,,
2025-03-27,2167.64,asset_sale,in,Counterparty_37,21743693.53,,
2025-03-27,2708.47,supplier_payment,out,Counterparty_40,21740985.06,2025-02-25,2025-03-25
2025-03-27,1239.24,loan_repayment,out,Counterparty_45,21739745.82,2025-02-20,2025-03-18
2025-03-27,90.34,marketing_spend,out,Counterparty_57,21739655.48,2025-02-18,2025-03-16
2025-03-27,334.62,refund,in,Counterparty_81,21739990.1,,
2025-03-27,5564.32,software_subscription,out,Counterparty_45,21734425.78,2025-03-07,2025-04-08
2025-03-27,3266.78,asset_sale,in,Counterparty_24,21737692.56,,
2025-03-27,3062.3,utilities,out,Counterparty_70,21734630.26,2025-03-08,2025-04-11
2025-03-27,1797.88,utilities,out,Counterparty_92,21732832.38,2025-02-27,2025-03-30
2025-03-27,3091.03,marketing_spend,out,Counterparty_89,21729741.35,2025-02-21,2025-03-27
2025-03-27,5878.79,software_subscription,out,Counterparty_39,21723862.56,2025-03-10,2025-04-16
2025-03-27,3016.33,customer_payment,in,Counterparty_95,21726878.89,,
2025-03-27,6335.08,utilities,out,Counterparty_1,21720543.81,2025-02-19,2025-03-16
2025-03-27,5219.96,supplier_payment,out,Counterparty_42,21715323.85,2025-02-26,2025-03-24
2025-03-27,4340.01,investment_income,in,Counterparty_82,21719663.86,,
2025-03-27,3533.19,asset_sale,in,Counterparty_17,21723197.05,,
2025-03-27,3584.87,marketing_spend,out,Counterparty_97,21719612.18,2025-03-01,2025-04-09
2025-03-27,3220.12,software_subscription,out,Counterparty_87,21716392.06,2025-03-11,2025-04-06
2025-03-27,9262.12,asset_sale,in,Counterparty_82,21725654.18,,
2025-03-27,192.17,utilities,out,Counterparty_1,21725462.01,2025-03-12,2025-04-11
2025-03-27,12946.96,loan_repayment,out,Counterparty_64,21712515.05,2025-02-24,2025-03-27
2025-03-27,950.65,loan_repayment,out,Counterparty_63,21711564.4,2025-03-03,2025-03-30
2025-03-27,1402.13,asset_sale,in,Counterparty_95,21712966.53,,
2025-03-27,370.05,customer_payment,in,Counterparty_45,21713336.58,,
2025-03-27,6957.95,credit,in,Counterparty_46,21720294.53,,
2025-03-27,7721.01,rent,out,Counterparty_29,21712573.52,2025-02-15,2025-03-23
2025-03-27,4072.43,software_subscription,out,Counterparty_20,21708501.09,2025-03-05,2025-04-12
2025-03-27,327.23,asset_sale,in,Counterparty_59,21708828.32,,
2025-03-27,7422.18,refund,in,Counterparty_81,21716250.5,,
2025-03-27,13499.97,customer_payment,in,Counterparty_86,21729750.47,,
2025-03-27,9894.96,customer_payment,in,Counterparty_58,21739645.43,,
2025-03-27,1199.65,payroll,out,Counterparty_89,21738445.78,2025-03-10,2025-04-05
2025-03-27,1707.99,customer_payment,in,Counterparty_49,21740153.77,,
2025-03-27,3892.23,loan_repayment,out,Counterparty_49,21736261.54,2025-03-09,2025-04-07
2025-03-27,9337.53,refund,in,Counterparty_87,21745599.07,,
2025-03-27,141.89,customer_payment,in,Counterparty_81,21745740.96,,
2025-03-27,2674.29,credit,in,Counterparty_35,21748415.25,,
2025-03-27,5413.21,tax_payment,out,Counterparty_21,21743002.04,2025-03-06,2025-04-10
2025-03-28,2877.53,customer_payment,in,Counterparty_24,21745879.57,,
2025-03-28,1007.2,loan_repayment,out,Counterparty_44,21744872.37,2025-02-22,2025-03-27
2025-03-28,402.29,payroll,out,Counterparty_86,21744470.08,2025-02-26,2025-03-26
2025-03-28,2740.83,refund,in,Counterparty_43,21747210.91,,
2025-03-28,76.2,refund,in,Counterparty_86,21747287.11,,
2025-03-28,1793.89,loan_repayment,out,Counterparty_47,21745493.22,2025-02-17,2025-03-19
2025-03-28,4548.03,rent,out,Counterparty_32,21740945.19,2025-03-01,2025-03-27
2025-03-28,15950.87,marketing_spend,out,Counterparty_56,21724994.32,2025-02-17,2025-03-19
2025-03-28,1858.57,T&E,out,Counterparty_42,21723135.75,2025-02-17,2025-03-18
2025-03-28,223.67,marketing_spend,out,Counterparty_39,21722912.08,2025-02-22,2025-03-20
2025-03-28,2094.19,investment_income,in,Counterparty_98,21725006.27,,
2025-03-28,2119.64,asset_sale,in,Counterparty_1,21727125.91,,
2025-03-28,2065.5,payroll,out,Counterparty_79,21725060.41,2025-03-06,2025-03-31
2025-03-28,3138.39,tax_payment,out,Counterparty_84,21721922.02,2025-02-22,2025-03-22
2025-03-28,1389.62,payroll,out,Counterparty_33,21720532.4,2025-03-12,2025-04-16
2025-03-28,2251.6,payroll,out,Counterparty_64,21718280.8,2025-03-04,2025-03-29
2025-03-28,5707.15,software_subscription,out,Counterparty_12,21712573.65,2025-03-12,2025-04-10
2025-03-28,2164.11,payroll,out,Counterparty_60,21710409.54,2025-03-13,2025-04-14
2025-03-28,4044.05,utilities,out,Counterparty_7,21706365.49,2025-02-13,2025-03-12
2025-03-28,1321.85,payroll,out,Counterparty_79,21705043.64,2025-03-06,2025-04-05
2025-03-28,6203.46,software_subscription,out,Counterparty_82,21698840.18,2025-02-27,2025-03-31
2025-03-28,2816.96,supplier_payment,out,Counterparty_85,21696023.22,2025-03-13,2025-04-17
2025-03-28,1509.2,T&E,out,Counterparty_86,21694514.02,2025-02-24,2025-03-29
2025-03-28,1460.75,asset_sale,in,Counterparty_27,21695974.77,,
2025-03-28,2506.5,loan_repayment,out,Counterparty_56,21693468.27,2025-02-20,2025-03-20
2025-03-28,2975.6,credit,in,Counterparty_98,21696443.87,,
2025-03-28,1389.43,refund,in,Counterparty_86,21697833.3,,
2025-03-28,3823.54,supplier_payment,out,Counterparty_3,21694009.76,2025-03-08,2025-04-07
2025-03-28,8100.19,supplier_payment,out,Counterparty_58,21685909.57,2025-02-20,2025-03-30
2025-03-28,9551.46,refund,in,Counterparty_32,21695461.03,,
2025-03-28,2081.65,loan_repayment,out,Counterparty_1,21693379.38,2025-02-26,2025-03-23
2025-03-28,13352.1,payroll,out,Counterparty_46,21680027.28,2025-02-27,2025-03-26
2025-03-28,3126.91,asset_sale,in,Counterparty_57,21683154.19,,
2025-03-28,1844.87,investment_income,in,Counterparty_23,21684999.06,,
2025-03-28,2227.73,credit,in,Counterparty_30,21687226.79,,
2025-03-28,3922.81,T&E,out,Counterparty_35,21683303.98,2025-02-16,2025-03-18
2025-03-28,7853.27,refund,in,Counterparty_95,21691157.25,,
2025-03-28,9555.25,refund,in,Counterparty_85,21700712.5,,
2025-03-28,3262.11,asset_sale,in,Counterparty_22,21703974.61,,
2025-03-28,14376.16,payroll,out,Counterparty_84,21689598.45,2025-03-05,2025-04-07
2025-03-28,2042.3,software_subscription,out,Counterparty_56,21687556.15,2025-03-01,2025-04-07
2025-03-28,50.3,refund,in,Counterparty_32,21687606.45,,
2025-03-28,221.53,investment_income,in,Counterparty_5,21687827.98,,
2025-03-28,3530.41,customer_payment,in,Counterparty_39,21691358.39,,
2025-03-28,11749.47,loan_repayment,out,Counterparty_98,21679608.92,2025-03-08,2025-04-08
2025-03-29,5213.25,refund,in,Counterparty_19,21684822.17,,
2025-03-29,6055.75,utilities,out,Counterparty_98,21678766.42,2025-02-21,2025-03-25
2025-03-29,1008.81,refund,in,Counterparty_63,21679775.23,,
2025-03-29,3568.4,tax_payment,out,Counterparty_33,21676206.83,2025-02-18,2025-03-18
2025-03-29,5810.75,payroll,out,Counterparty_34,21670396.08,2025-02-23,2025-04-01
2025-03-29,4439.25,software_subscription,out,Counterparty_34,21665956.83,2025-02-13,2025-03-24
2025-03-29,3174.68,asset_sale,in,Counterparty_51,21669131.51,,
2025-03-29,280.56,refund,in,Counterparty_5,21669412.07,,
2025-03-29,1162.45,T&E,out,Counterparty_22,21668249.62,2025-02-16,2025-03-24
2025-03-29,136.61,investment_income,in,Counterparty_74,21668386.23,,
2025-03-29,4907.12,credit,in,Counterparty_56,21673293.35,,
2025-03-29,5956.27,refund,in,Counterparty_96,21679249.62,,
2025-03-29,1776.55,tax_payment,out,Counterparty_82,21677473.07,2025-02-15,2025-03-22
2025-03-29,7637.15,customer_payment,in,Counterparty_54,21685110.22,,
2025-03-29,6808.54,credit,in,Counterparty_96,21691918.76,,
2025-03-29,5080.16,rent,out,Counterparty_62,21686838.6,2025-02-22,2025-03-19
2025-03-29,4910.94,marketing_spend,out,Counterparty_36,21681927.66,2025-03-08,2025-04-16
2025-03-29,8425.37,asset_sale,in,Counterparty_90,21690353.03,,
2025-03-29,4636.61,credit,in,Counterparty_37,21694989.64,,
2025-03-29,2312.22,rent,out,Counterparty_44,21692677.42,2025-02-13,2025-03-20
2025-03-29,12156.94,customer_payment,in,Counterparty_69,21704834.36,,
2025-03-29,629.29,tax_payment,out,Counterparty_74,21704205.07,2025-03-09,2025-04-12
2025-03-29,5172.4,supplier_payment,out,Counterparty_86,21699032.67,2025-03-11,2025-04-06
2025-03-29,2050.13,customer_payment,in,Counterparty_67,21701082.8,,
2025-03-29,722.07,T&E,out,Counterparty_1,21700360.73,2025-03-04,2025-04-09
2025-03-29,4173.21,asset_sale,in,Counterparty_71,21704533.94,,
2025-03-29,6070.67,T&E,out,Counterparty_23,21698463.27,2025-03-14,2025-04-17
2025-03-29,5184.26,investment_income,in,Counterparty_49,21703647.53,,
2025-03-29,4054.48,investment_income,in,Counterparty_62,21707702.01,,
2025-03-29,342.6,customer_payment,in,Counterparty_93,21708044.61,,
2025-03-29,1113.97,utilities,out,Counterparty_29,21706930.64,2025-02-25,2025-03-24
2025-03-29,4007.25,refund,in,Counterparty_77,21710937.89,,
2025-03-29,19789.38,software_subscription,out,Counterparty_44,21691148.51,2025-02-24,2025-03-31
2025-03-29,1029.69,investment_income,in,Counterparty_92,21692178.2,,
2025-03-29,5582.12,supplier_payment,out,Counterparty_64,21686596.08,2025-02-15,2025-03-23
2025-03-29,5273.65,loan_repayment,out,Counterparty_85,21681322.43,2025-02-23,2025-03-24
2025-03-29,2165.34,tax_payment,out,Counterparty_16,21679157.09,2025-03-09,2025-04-04
2025-03-29,1850.29,asset_sale,in,Counterparty_23,21681007.38,,
2025-03-29,222.19,loan_repayment,out,Counterparty_56,21680785.19,2025-03-03,2025-04-03
2025-03-30,14461.08,investment_income,in,Counterparty_62,21695246.27,,
2025-03-30,4117.38,supplier_payment,out,Counterparty_28,21691128.89,2025-03-06,2025-04-05
2025-03-30,1527.05,asset_sale,in,Counterparty_56,21692655.94,,
2025-03-30,8441.43,credit,in,Counterparty_20,21701097.37,,
2025-03-30,16412.62,tax_payment,out,Counterparty_22,21684684.75,2025-02-16,2025-03-27
2025-03-30,1913.68,investment_income,in,Counterparty_35,21686598.43,,
2025-03-30,7900.64,loan_repayment,out,Counterparty_63,21678697.79,2025-03-08,2025-04-13
2025-03-30,3241.64,refund,in,Counterparty_73,21681939.43,,
2025-03-30,8050.41,software_subscription,out,Counterparty_22,21673889.02,2025-02-23,2025-03-27
2025-03-30,1573.84,refund,in,Counterparty_73,21675462.86,,
2025-03-30,455.55,credit,in,Counterparty_18,21675918.41,,
2025-03-30,528.68,payroll,out,Counterparty_70,21675389.73,2025-03-10,2025-04-04
2025-03-30,266.39,credit,in,Counterparty_34,21675656.12,,
2025-03-30,1374.73,loan_repayment,out,Counterparty_99,21674281.39,2025-02-16,2025-03-23
2025-03-30,1233.82,investment_income,in,Counterparty_47,21675515.21,,
2025-03-30,174.87,marketing_spend,out,Counterparty_5,21675340.34,2025-03-12,2025-04-13
2025-03-30,255.63,refund,in,Counterparty_22,21675595.97,,
2025-03-30,717.68,asset_sale,in,Counterparty_99,21676313.65,,
2025-03-30,2494.54,refund,in,Counterparty_23,21678808.19,,
2025-03-30,7278.42,refund,in,Counterparty_7,21686086.61,,
2025-03-30,17829.7,refund,in,Counterparty_77,21703916.31,,
2025-03-30,8795.91,T&E,out,Counterparty_18,21695120.4,2025-03-11,2025-04-06
2025-03-30,1255.39,rent,out,Counterparty_10,21693865.01,2025-03-02,2025-04-06
2025-03-30,4261.44,supplier_payment,out,Counterparty_35,21689603.57,2025-03-11,2025-04-16
2025-03-30,5011.41,payroll,out,Counterparty_95,21684592.16,2025-02-22,2025-03-22
2025-03-30,6529.11,customer_payment,in,Counterparty_87,21691121.27,,
2025-03-30,2829.65,asset_sale,in,Counterparty_33,21693950.92,,
2025-03-30,1531.5,customer_payment,in,Counterparty_62,21695482.42,,
2025-03-30,61.82,tax_payment,out,Counterparty_26,21695420.6,2025-03-11,2025-04-18
2025-03-30,604.56,T&E,out,Counterparty_47,21694816.04,2025-02-27,2025-03-28
2025-03-30,1475.94,customer_payment,in,Counterparty_13,21696291.98,,
2025-03-30,1512.57,asset_sale,in,Counterparty_61,21697804.55,,
2025-03-30,5670.52,software_subscription,out,Counterparty_26,21692134.03,2025-02-19,2025-03-18
2025-03-30,6179.58,T&E,out,Counterparty_31,21685954.45,2025-03-02,2025-03-31
2025-03-30,612.87,asset_sale,in,Counterparty_97,21686567.32,,
2025-03-30,2611.99,software_subscription,out,Counterparty_83,21683955.33,2025-02-26,2025-03-23
2025-03-30,831.6,investment_income,in,Counterparty_93,21684786.93,,
2025-03-30,224.37,loan_repayment,out,Counterparty_1,21684562.56,2025-03-05,2025-04-06
2025-03-30,6327.07,payroll,out,Counterparty_68,21678235.49,2025-03-02,2025-04-09
2025-03-30,1630.07,T&E,out,Counterparty_1,21676605.42,2025-03-15,2025-04-13
2025-03-30,747.1,payroll,out,Counterparty_46,21675858.32,2025-02-19,2025-03-27
2025-03-30,3632.81,payroll,out,Counterparty_34,21672225.51,2025-03-14,2025-04-11
2025-03-30,1223.87,supplier_payment,out,Counterparty_68,21671001.64,2025-02-19,2025-03-30
2025-03-31,1102.94,investment_income,in,Counterparty_48,21672104.58,,
2025-03-31,2322.81,asset_sale,in,Counterparty_9,21674427.39,,
2025-03-31,7201.91,customer_payment,in,Counterparty_17,21681629.3,,
2025-03-31,609.17,tax_payment,out,Counterparty_8,21681020.13,2025-03-13,2025-04-10
2025-03-31,5708.7,utilities,out,Counterparty_35,21675311.43,2025-02-16,2025-03-13
2025-03-31,778.01,marketing_spend,out,Counterparty_54,21674533.42,2025-03-12,2025-04-06
2025-03-31,13133.37,rent,out,Counterparty_52,21661400.05,2025-02-16,2025-03-20
2025-03-31,3170.77,refund,in,Counterparty_88,21664570.82,,
2025-03-31,111.44,payroll,out,Counterparty_24,21664459.38,2025-02-17,2025-03-23
2025-03-31,14736.26,refund,in,Counterparty_31,21679195.64,,
2025-03-31,6932.65,asset_sale,in,Counterparty_32,21686128.29,,
2025-03-31,1365.28,payroll,out,Counterparty_20,21684763.01,2025-02-15,2025-03-15
2025-03-31,1461.11,T&E,out,Counterparty_6,21683301.9,2025-03-15,2025-04-14
2025-03-31,13324.17,payroll,out,Counterparty_54,21669977.73,2025-02-20,2025-03-23
2025-03-31,8970.79,utilities,out,Counterparty_51,21661006.94,2025-02-24,2025-04-01
2025-03-31,2454.44,supplier_payment,out,Counterparty_87,21658552.5,2025-02-25,2025-03-24
2025-03-31,947.35,refund,in,Counterparty_71,21659499.85,,
2025-03-31,7850.84,utilities,out,Counterparty_11,21651649.01,2025-02-22,2025-03-28
2025-03-31,608.09,tax_payment,out,Counterparty_91,21651040.92,2025-02-15,2025-03-24
2025-03-31,1627.41,refund,in,Counterparty_8,21652668.33,,
2025-03-31,3280.62,refund,in,Counterparty_31,21655948.95,,
2025-03-31,12099.71,asset_sale,in,Counterparty_48,21668048.66,,
2025-03-31,295.44,customer_payment,in,Counterparty_54,21668344.1,,
2025-03-31,8660.44,utilities,out,Counterparty_39,21659683.66,2025-03-08,2025-04-10
2025-03-31,242.04,marketing_spend,out,Counterparty_77,21659441.62,2025-03-03,2025-03-30
2025-03-31,4716.79,software_subscription,out,Counterparty_91,21654724.83,2025-02-16,2025-03-15
2025-03-31,1.59,refund,in,Counterparty_55,21654726.42,,
2025-03-31,16612.7,loan_repayment,out,Counterparty_26,21638113.72,2025-03-03,2025-04-07
2025-03-31,1073.39,customer_payment,in,Counterparty_37,21639187.11,,
2025-03-31,11002.46,refund,in,Counterparty_82,21650189.57,,
2025-03-31,1911.71,tax_payment,out,Counterparty_15,21648277.86,2025-02-20,2025-03-31
2025-03-31,1215.9,marketing_spend,out,Counterparty_52,21647061.96,2025-03-14,2025-04-12
2025-03-31,1068.51,asset_sale,in,Counterparty_98,21648130.47,,
2025-03-31,1755.18,T&E,out,Counterparty_54,21646375.29,2025-03-08,2025-04-05
2025-03-31,10900.81,payroll,out,Counterparty_90,21635474.48,2025-02-18,2025-03-25
2025-03-31,8835.35,payroll,out,Counterparty_89,21626639.13,2025-02-28,2025-03-30
2025-03-31,2489.61,software_subscription,out,Counterparty_18,21624149.52,2025-03-03,2025-04-04
2025-03-31,438.2,credit,in,Counterparty_94,21624587.72,,
2025-03-31,2980.29,tax_payment,out,Counterparty_95,21621607.43,2025-02-26,2025-03-25
2025-03-31,2836.15,asset_sale,in,Counterparty_24,21624443.58,,
2025-03-31,6679.0,credit,in,Counterparty_91,21631122.58,,
2025-03-31,17350.62,customer_payment,in,Counterparty_38,21648473.2,,
2025-03-31,18204.84,investment_income,in,Counterparty_76,21666678.04,,
2025-04-01,2431.35,utilities,out,Counterparty_71,21664246.69,2025-03-10,2025-04-10
2025-04-01,11630.91,software_subscription,out,Counterparty_8,21652615.78,2025-02-26,2025-03-24
2025-04-01,8721.38,tax_payment,out,Counterparty_90,21643894.4,2025-02-22,2025-03-24
2025-04-01,2419.39,utilities,out,Counterparty_19,21641475.01,2025-03-05,2025-04-09
2025-04-01,3785.58,T&E,out,Counterparty_63,21637689.43,2025-03-03,2025-04-06
2025-04-01,10365.72,loan_repayment,out,Counterparty_1,21627323.71,2025-03-01,2025-04-02
2025-04-01,7811.43,payroll,out,Counterparty_35,21619512.28,2025-02-24,2025-03-23
2025-04-01,2114.06,tax_payment,out,Counterparty_44,21617398.22,2025-02-24,2025-03-28
2025-04-01,271.74,supplier_payment,out,Counterparty_96,21617126.48,2025-03-06,2025-04-14
2025-04-01,3621.78,investment_income,in,Counterparty_85,21620748.26,,
2025-04-01,7894.84,utilities,out,Counterparty_42,21612853.42,2025-03-02,2025-04-06
2025-04-01,2836.63,tax_payment,out,Counterparty_67,21610016.79,2025-02-23,2025-03-29
2025-04-01,13430.04,utilities,out,Counterparty_25,21596586.75,2025-03-01,2025-04-03
2025-04-01,2755.79,loan_repayment,out,Counterparty_42,21593830.96,2025-02-19,2025-03-21
2025-04-01,691.92,T&E,out,Counterparty_77,21593139.04,2025-03-05,2025-04-06
2025-04-01,130.27,utilities,out,Counterparty_79,21593008.77,2025-03-17,2025-04-11
2025-04-01,3709.29,credit,in,Counterparty_41,21596718.06,,
2025-04-01,4101.17,software_subscription,out,Counterparty_58,21592616.89,2025-03-17,2025-04-24
2025-04-01,715.52,payroll,out,Counterparty_1,21591901.37,2025-02-20,2025-03-25
2025-04-01,1019.03,asset_sale,in,Counterparty_48,21592920.4,,
2025-04-01,1321.97,investment_income,in,Counterparty_27,21594242.37,,
2025-04-01,1699.77,investment_income,in,Counterparty_28,21595942.14,,
2025-04-01,4548.02,credit,in,Counterparty_4,21600490.16,,
2025-04-01,5190.73,customer_payment,in,Counterparty_96,21605680.89,,
2025-04-01,2498.99,asset_sale,in,Counterparty_88,21608179.88,,
2025-04-01,396.98,utilities,out,Counterparty_41,21607782.9,2025-03-14,2025-04-13
2025-04-01,891.22,credit,in,Counterparty_21,21608674.12,,
2025-04-01,280.34,investment_income,in,Counterparty_1,21608954.46,,
2025-04-01,107.0,refund,in,Counterparty_36,21609061.46,,
2025-04-01,383.31,asset_sale,in,Counterparty_29,21609444.77,,
2025-04-01,13864.9,investment_income,in,Counterparty_61,21623309.67,,
2025-04-01,1094.18,investment_income,in,Counterparty_31,21624403.85,,
2025-04-01,1458.27,rent,out,Counterparty_77,21622945.58,2025-02-19,2025-03-24
2025-04-01,436.58,rent,out,Counterparty_27,21622509.0,2025-03-12,2025-04-19
2025-04-01,12301.25,credit,in,Counterparty_87,21634810.25,,
2025-04-01,5137.4,asset_sale,in,Counterparty_99,21639947.65,,
2025-04-01,3879.2,utilities,out,Counterparty_45,21636068.45,2025-02-16,2025-03-26
2025-04-01,6200.63,software_subscription,out,Counterparty_44,21629867.82,2025-03-01,2025-04-03
2025-04-01,11880.92,supplier_payment,out,Counterparty_93,21617986.9,2025-03-13,2025-04-13
2025-04-02,3210.06,supplier_payment,out,Counterparty_90,21614776.84,2025-03-04,2025-04-02
2025-04-02,1510.46,customer_payment,in,Counterparty_20,21616287.3,,
2025-04-02,1423.68,refund,in,Counterparty_2,21617710.98,,
2025-04-02,801.74,marketing_spend,out,Counterparty_59,21616909.24,2025-03-12,2025-04-11
2025-04-02,7530.11,loan_repayment,out,Counterparty_62,21609379.13,2025-02-22,2025-03-23
2025-04-02,2390.91,credit,in,Counterparty_15,21611770.04,,
2025-04-02,6211.11,credit,in,Counterparty_9,21617981.15,,
2025-04-02,3175.06,refund,in,Counterparty_29,21621156.21,,
2025-04-02,461.77,credit,in,Counterparty_19,21621617.98,,
2025-04-02,423.93,investment_income,in,Counterparty_97,21622041.91,,
2025-04-02,861.66,asset_sale,in,Counterparty_58,21622903.57,,
2025-04-02,4799.12,supplier_payment,out,Counterparty_45,21618104.45,2025-02-27,2025-04-07
2025-04-02,1044.72,supplier_payment,out,Counterparty_59,21617059.73,2025-03-13,2025-04-07
2025-04-02,7086.45,investment_income,in,Counterparty_54,21624146.18,,
2025-04-02,4221.2,credit,in,Counterparty_90,21628367.38,,
2025-04-02,8338.65,supplier_payment,out,Counterparty_10,21620028.73,2025-03-14,2025-04-08
2025-04-02,1009.13,supplier_payment,out,Counterparty_52,21619019.6,2025-03-10,2025-04-05
2025-04-02,9315.41,supplier_payment,out,Counterparty_69,21609704.19,2025-03-01,2025-03-26
2025-04-02,2089.34,tax_payment,out,Counterparty_68,21607614.85,2025-02-26,2025-04-02
2025-04-02,1053.96,utilities,out,Counterparty_75,21606560.89,2025-03-13,2025-04-13
2025-04-02,8352.09,asset_sale,in,Counterparty_11,21614912.98,,
2025-04-02,2417.13,marketing_spend,out,Counterparty_14,21612495.85,2025-03-17,2025-04-24
2025-04-02,7904.5,supplier_payment,out,Counterparty_11,21604591.35,2025-02-17,2025-03-14
2025-04-02,7520.1,customer_payment,in,Counterparty_22,21612111.45,,
2025-04-02,2499.75,rent,out,Counterparty_59,21609611.7,2025-02-27,2025-04-04
2025-04-02,4992.99,refund,in,Counterparty_46,21614604.69,,
2025-04-02,3178.7,tax_payment,out,Counterparty_97,21611425.99,2025-02-26,2025-04-04
2025-04-02,679.56,investment_income,in,Counterparty_78,21612105.55,,
2025-04-02,294.26,supplier_payment,out,Counterparty_11,21611811.29,2025-02-23,2025-03-27
2025-04-02,5430.91,supplier_payment,out,Counterparty_34,21606380.38,2025-02-23,2025-03-26
2025-04-02,709.97,tax_payment,out,Counterparty_66,21605670.41,2025-03-10,2025-04-12
2025-04-02,3054.67,tax_payment,out,Counterparty_35,21602615.74,2025-02-21,2025-03-19
2025-04-02,11469.58,credit,in,Counterparty_87,21614085.32,,
2025-04-02,12240.9,utilities,out,Counterparty_19,21601844.42,2025-02-17,2025-03-16
2025-04-02,2221.5,marketing_spend,out,Counterparty_10,21599622.92,2025-02-22,2025-03-19
2025-04-02,6987.81,investment_income,in,Counterparty_84,21606610.73,,
2025-04-02,5061.66,asset_sale,in,Counterparty_60,21611672.39,,
2025-04-02,1088.08,tax_payment,out,Counterparty_4,21610584.31,2025-02-20,2025-03-29
2025-04-03,177.12,customer_payment,in,Counterparty_20,21610761.43,,
2025-04-03,578.34,investment_income,in,Counterparty_71,21611339.77,,
2025-04-03,352.01,asset_sale,in,Counterparty_52,21611691.78,,
2025-04-03,5471.7,supplier_payment,out,Counterparty_50,21606220.08,2025-03-06,2025-04-12
2025-04-03,8331.42,credit,in,Counterparty_17,21614551.5,,
2025-04-03,1454.01,payroll,out,Counterparty_48,21613097.49,2025-03-06,2025-04-02
2025-04-03,1365.36,utilities,out,Counterparty_95,21611732.13,2025-03-04,2025-03-31
2025-04-03,2344.91,tax_payment,out,Counterparty_38,21609387.22,2025-02-26,2025-04-03
2025-04-03,244.75,T&E,out,Counterparty_33,21609142.47,2025-03-11,2025-04-17
2025-04-03,5361.68,tax_payment,out,Counterparty_32,21603780.79,2025-03-16,2025-04-20
2025-04-03,1852.99,refund,in,Counterparty_14,21605633.78,,
2025-04-03,3658.73,rent,out,Counterparty_58,21601975.05,2025-02-28,2025-03-30
2025-04-03,981.14,T&E,out,Counterparty_97,21600993.91,2025-02-22,2025-04-01
2025-04-03,1268.07,tax_payment,out,Counterparty_22,21599725.84,2025-03-05,2025-04-12
2025-04-03,4951.98,rent,out,Counterparty_56,21594773.86,2025-03-19,2025-04-13
2025-04-03,4415.39,investment_income,in,Counterparty_69,21599189.25,,
2025-04-03,1673.34,investment_income,in,Counterparty_35,21600862.59,,
2025-04-03,1155.78,refund,in,Counterparty_59,21602018.37,,
2025-04-03,1474.35,supplier_payment,out,Counterparty_44,21600544.02,2025-03-05,2025-04-11
2025-04-03,1790.69,customer_payment,in,Counterparty_53,21602334.71,,
2025-04-03,3260.45,credit,in,Counterparty_40,21605595.16,,
2025-04-03,2162.04,rent,out,Counterparty_40,21603433.12,2025-02-24,2025-03-28
2025-04-03,4884.13,investment_income,in,Counterparty_57,21608317.25,,
2025-04-03,1626.99,software_subscription,out,Counterparty_74,21606690.26,2025-02-25,2025-03-28
2025-04-03,5353.72,utilities,out,Counterparty_69,21601336.54,2025-03-03,2025-04-11
2025-04-03,2993.76,utilities,out,Counterparty_69,21598342.78,2025-03-15,2025-04-16
2025-04-03,4948.34,loan_repayment,out,Counterparty_29,21593394.44,2025-02-19,2025-03-25
2025-04-03,2779.75,T&E,out,Counterparty_79,21590614.69,2025-03-16,2025-04-21
2025-04-03,2395.06,supplier_payment,out,Counterparty_61,21588219.63,2025-02-24,2025-03-31
2025-04-03,11182.41,customer_payment,in,Counterparty_1,21599402.04,,
2025-04-03,308.61,marketing_spend,out,Counterparty_78,21599093.43,2025-03-17,2025-04-12
2025-04-03,942.74,payroll,out,Counterparty_85,21598150.69,2025-03-15,2025-04-12
2025-04-03,2155.34,loan_repayment,out,Counterparty_7,21595995.35,2025-03-02,2025-04-09
2025-04-03,5275.33,customer_payment,in,Counterparty_47,21601270.68,,
2025-04-03,438.07,asset_sale,in,Counterparty_99,21601708.75,,
2025-04-04,5734.5,refund,in,Counterparty_72,21607443.25,,
2025-04-04,530.02,payroll,out,Counterparty_71,21606913.23,2025-03-15,2025-04-15
2025-04-04,3918.14,payroll,out,Counterparty_30,21602995.09,2025-03-20,2025-04-19
2025-04-04,2931.54,payroll,out,Counterparty_41,21600063.55,2025-02-21,2025-03-31
2025-04-04,1875.43,loan_repayment,out,Counterparty_76,21598188.12,2025-03-11,2025-04-12
2025-04-04,2690.12,asset_sale,in,Counterparty_9,21600878.24,,
2025-04-04,5519.15,customer_payment,in,Counterparty_31,21606397.39,,
2025-04-04,1889.04,investment_income,in,Counterparty_94,21608286.43,,
2025-04-04,415.45,customer_payment,in,Counterparty_5,21608701.88,,
2025-04-04,8120.46,T&E,out,Counterparty_83,21600581.42,2025-03-06,2025-04-11
2025-04-04,763.23,marketing_spend,out,Counterparty_31,21599818.19,2025-03-03,2025-04-04
2025-04-04,5042.92,loan_repayment,out,Counterparty_85,21594775.27,2025-03-02,2025-04-03
2025-04-04,2972.59,refund,in,Counterparty_32,21597747.86,,
2025-04-04,866.46,rent,out,Counterparty_24,21596881.4,2025-02-21,2025-03-29
2025-04-04,7085.93,refund,in,Counterparty_20,21603967.33,,
2025-04-04,2213.71,investment_income,in,Counterparty_41,21606181.04,,
2025-04-04,589.29,investment_income,in,Counterparty_32,21606770.33,,
2025-04-04,534.69,asset_sale,in,Counterparty_49,21607305.02,,
2025-04-04,357.71,credit,in,Counterparty_86,21607662.73,,
2025-04-04,8719.14,marketing_spend,out,Counterparty_60,21598943.59,2025-03-10,2025-04-17
2025-04-04,5990.35,software_subscription,out,Counterparty_60,21592953.24,2025-03-02,2025-04-08
2025-04-04,1492.43,loan_repayment,out,Counterparty_24,21591460.81,2025-03-04,2025-04-04
2025-04-04,6024.49,utilities,out,Counterparty_74,21585436.32,2025-02-27,2025-03-29
2025-04-04,10979.35,rent,out,Counterparty_25,21574456.97,2025-02-28,2025-03-25
2025-04-04,1848.8,loan_repayment,out,Counterparty_89,21572608.17,2025-03-14,2025-04-16
2025-04-04,4380.72,credit,in,Counterparty_84,21576988.89,,
2025-04-04,8974.97,asset_sale,in,Counterparty_42,21585963.86,,
2025-04-04,5697.89,utilities,out,Counterparty_70,21580265.97,2025-02-25,2025-04-01
2025-04-04,12445.09,customer_payment,in,Counterparty_2,21592711.06,,
2025-04-04,207.48,customer_payment,in,Counterparty_1,21592918.54,,
2025-04-04,3949.29,payroll,out,Counterparty_21,21588969.25,2025-03-01,2025-04-07
2025-04-04,4886.03,supplier_payment,out,Counterparty_74,21584083.22,2025-02-21,2025-04-01
2025-04-04,4645.25,rent,out,Counterparty_90,21579437.97,2025-02-21,2025-03-30
2025-04-04,1182.75,loan_repayment,out,Counterparty_79,21578255.22,2025-03-12,2025-04-11
2025-04-04,9535.46,credit,in,Counterparty_51,21587790.68,,
2025-04-04,4437.48,supplier_payment,out,Counterparty_43,21583353.2,2025-02-27,2025-03-25
2025-04-04,3412.99,customer_payment,in,Counterparty_42,21586766.19,,
2025-04-04,3238.33,marketing_spend,out,Counterparty_13,21583527.86,2025-02-28,2025-04-02
2025-04-04,18856.42,asset_sale,in,Counterparty_54,21602384.28,,
2025-04-04,4367.87,asset_sale,in,Counterparty_81,21606752.15,,
2025-04-04,6350.75,utilities,out,Counterparty_47,21600401.4,2025-03-05,2025-03-30
2025-04-05,1325.28,payroll,out,Counterparty_23,21599076.12,2025-03-21,2025-04-22
2025-04-05,4045.37,investment_income,in,Counterparty_31,21603121.49,,
2025-04-05,5075.53,investment_income,in,Counterparty_78,21608197.02,,
2025-04-05,1242.26,credit,in,Counterparty_3,21609439.28,,
2025-04-05,764.9,loan_repayment,out,Counterparty_57,21608674.38,2025-03-08,2025-04-11
2025-04-05,4444.38,tax_payment,out,Counterparty_23,21604230.0,2025-02-21,2025-03-21
2025-04-05,1052.85,investment_income,in,Counterparty_21,21605282.85,,
2025-04-05,3849.35,credit,in,Counterparty_1,21609132.2,,
2025-04-05,1444.64,credit,in,Counterparty_33,21610576.84,,
2025-04-05,2580.07,customer_payment,in,Counterparty_43,21613156.91,,
2025-04-05,940.71,refund,in,Counterparty_41,21614097.62,,
2025-04-05,8647.34,tax_payment,out,Counterparty_69,21605450.28,2025-02-24,2025-04-04
2025-04-05,2807.29,investment_income,in,Counterparty_19,21608257.57,,
2025-04-05,1258.91,supplier_payment,out,Counterparty_97,21606998.66,2025-02-25,2025-03-22
2025-04-05,8623.37,investment_income,in,Counterparty_76,21615622.03,,
2025-04-05,80.88,rent,out,Counterparty_8,21615541.15,2025-03-10,2025-04-16
2025-04-05,2480.6,loan_repayment,out,Counterparty_89,21613060.55,2025-02-28,2025-03-28
2025-04-05,1227.15,supplier_payment,out,Counterparty_21,21611833.4,2025-03-13,2025-04-10
2025-04-05,16477.95,payroll,out,Counterparty_82,21595355.45,2025-03-09,2025-04-14
2025-04-05,883.66,software_subscription,out,Counterparty_94,21594471.79,2025-02-22,2025-03-25
2025-04-05,1886.55,T&E,out,Counterparty_41,21592585.24,2025-03-15,2025-04-14
2025-04-05,3186.88,utilities,out,Counterparty_11,21589398.36,2025-03-09,2025-04-17
2025-04-05,1231.98,investment_income,in,Counterparty_3,21590630.34,,
2025-04-05,2093.12,utilities,out,Counterparty_8,21588537.22,2025-02-24,2025-03-22
2025-04-05,1938.54,investment_income,in,Counterparty_76,21590475.76,,
2025-04-05,462.26,investment_income,in,Counterparty_25,21590938.02,,
2025-04-05,4953.7,payroll,out,Counterparty_71,21585984.32,2025-03-19,2025-04-20
2025-04-05,4375.78,rent,out,Counterparty_61,21581608.54,2025-03-10,2025-04-17
2025-04-05,4946.21,customer_payment,in,Counterparty_81,21586554.75,,
2025-04-05,4552.77,loan_repayment,out,Counterparty_34,21582001.98,2025-02-21,2025-03-24
2025-04-05,7275.22,supplier_payment,out,Counterparty_96,21574726.76,2025-02-26,2025-04-06
2025-04-05,1887.7,utilities,out,Counterparty_19,21572839.06,2025-03-02,2025-03-28
2025-04-05,13058.52,rent,out,Counterparty_16,21559780.54,2025-03-19,2025-04-15
2025-04-05,19556.87,T&E,out,Counterparty_45,21540223.67,2025-02-21,2025-03-31
2025-04-05,2088.09,rent,out,Counterparty_23,21538135.58,2025-03-13,2025-04-16
2025-04-05,561.22,loan_repayment,out,Counterparty_13,21537574.36,2025-02-27,2025-04-06
2025-04-05,1744.15,T&E,out,Counterparty_74,21535830.21,2025-02-25,2025-03-27
2025-04-05,107.68,marketing_spend,out,Counterparty_88,21535722.53,2025-02-28,2025-04-03
2025-04-05,1259.04,tax_payment,out,Counterparty_50,21534463.49,2025-03-18,2025-04-25
2025-04-05,1318.14,asset_sale,in,Counterparty_70,21535781.63,,
2025-04-05,3057.22,tax_payment,out,Counterparty_31,21532724.41,2025-03-21,2025-04-27
2025-04-05,4635.0,T&E,out,Counterparty_54,21528089.41,2025-03-06,2025-04-04
2025-04-05,11071.41,asset_sale,in,Counterparty_8,21539160.82,,
2025-04-05,132.23,loan_repayment,out,Counterparty_31,21539028.59,2025-02-27,2025-04-07
2025-04-05,703.28,customer_payment,in,Counterparty_26,21539731.87,,
2025-04-05,440.23,asset_sale,in,Counterparty_45,21540172.1,,
2025-04-06,7105.16,investment_income,in,Counterparty_72,21547277.26,,
2025-04-06,536.95,customer_payment,in,Counterparty_39,21547814.21,,
2025-04-06,2762.46,investment_income,in,Counterparty_52,21550576.67,,
2025-04-06,2328.1,tax_payment,out,Counterparty_57,21548248.57,2025-03-01,2025-03-26
2025-04-06,497.83,payroll,out,Counterparty_59,21547750.74,2025-03-10,2025-04-13
2025-04-06,1979.46,utilities,out,Counterparty_52,21545771.28,2025-03-03,2025-04-03
2025-04-06,4319.34,asset_sale,in,Counterparty_73,21550090.62,,
2025-04-06,711.91,asset_sale,in,Counterparty_70,21550802.53,,
2025-04-06,9491.46,asset_sale,in,Counterparty_62,21560293.99,,
2025-04-06,3434.16,software_subscription,out,Counterparty_44,21556859.83,2025-03-01,2025-04-06
2025-04-06,255.21,investment_income,in,Counterparty_21,21557115.04,,
2025-04-06,7869.26,asset_sale,in,Counterparty_2,21564984.3,,
2025-04-06,1467.15,investment_income,in,Counterparty_96,21566451.45,,
2025-04-06,2040.61,payroll,out,Counterparty_2,21564410.84,2025-03-10,2025-04-18
2025-04-06,297.85,payroll,out,Counterparty_50,21564112.99,2025-02-26,2025-03-31
2025-04-06,808.23,refund,in,Counterparty_94,21564921.22,,
2025-04-06,2286.79,credit,in,Counterparty_56,21567208.01,,
2025-04-06,872.7,utilities,out,Counterparty_72,21566335.31,2025-03-06,2025-04-09
2025-04-06,3588.17,supplier_payment,out,Counterparty_61,21562747.14,2025-03-19,2025-04-13
2025-04-06,1009.02,asset_sale,in,Counterparty_48,21563756.16,,
2025-04-06,4746.21,refund,in,Counterparty_16,21568502.37,,
2025-04-06,3645.13,credit,in,Counterparty_23,21572147.5,,
2025-04-06,1323.44,investment_income,in,Counterparty_28,21573470.94,,
2025-04-06,1488.07,customer_payment,in,Counterparty_4,21574959.01,,
2025-04-06,1975.17,credit,in,Counterparty_34,21576934.18,,
2025-04-06,2734.06,credit,in,Counterparty_77,21579668.24,,
2025-04-06,155.0,supplier_payment,out,Counterparty_85,21579513.24,2025-02-27,2025-03-26
2025-04-06,1132.33,customer_payment,in,Counterparty_20,21580645.57,,
2025-04-06,782.27,refund,in,Counterparty_53,21581427.84,,
2025-04-06,3424.2,loan_repayment,out,Counterparty_66,21578003.64,2025-03-20,2025-04-17
2025-04-06,2956.78,credit,in,Counterparty_99,21580960.42,,
2025-04-06,2958.42,T&E,out,Counterparty_76,21578002.0,2025-02-27,2025-04-03
2025-04-06,12217.6,rent,out,Counterparty_81,21565784.4,2025-03-22,2025-04-17
2025-04-06,1193.7,loan_repayment,out,Counterparty_53,21564590.7,2025-03-06,2025-04-13
2025-04-07,3661.86,T&E,out,Counterparty_11,21560928.84,2025-03-13,2025-04-15
2025-04-07,2767.83,utilities,out,Counterparty_49,21558161.01,2025-02-23,2025-03-25
2025-04-07,3931.1,rent,out,Counterparty_59,21554229.91,2025-03-01,2025-03-31
2025-04-07,229.91,supplier_payment,out,Counterparty_64,21554000.0,2025-03-05,2025-03-31
2025-04-07,3482.01,investment_income,in,Counterparty_68,21557482.01,,
2025-04-07,2906.9,utilities,out,Counterparty_37,21554575.11,2025-03-23,2025-04-22
2025-04-07,2912.02,tax_payment,out,Counterparty_67,21551663.09,2025-03-01,2025-04-03
2025-04-07,11667.97,customer_payment,in,Counterparty_38,21563331.06,,
2025-04-07,3233.75,marketing_spend,out,Counterparty_74,21560097.31,2025-03-04,2025-04-12
2025-04-07,159.15,asset_sale,in,Counterparty_51,21560256.46,,
2025-04-07,1816.95,refund,in,Counterparty_56,21562073.41,,
2025-04-07,961.28,tax_payment,out,Counterparty_31,21561112.13,2025-03-07,2025-04-15
2025-04-07,2149.44,asset_sale,in,Counterparty_9,21563261.57,,
2025-04-07,239.07,tax_payment,out,Counterparty_3,21563022.5,2025-03-20,2025-04-18
2025-04-07,500.26,rent,out,Counterparty_42,21562522.24,2025-03-07,2025-04-01
2025-04-07,358.85,refund,in,Counterparty_39,21562881.09,,
2025-04-07,2720.86,utilities,out,Counterparty_95,21560160.23,2025-03-06,2025-04-07
2025-04-07,5826.62,rent,out,Counterparty_92,21554333.61,2025-02-23,2025-03-28
2025-04-07,1097.29,asset_sale,in,Counterparty_82,21555430.9,,
2025-04-07,1154.76,T&E,out,Counterparty_58,21554276.14,2025-03-13,2025-04-14
2025-04-07,3055.49,refund,in,Counterparty_81,21557331.63,,
2025-04-07,9719.6,asset_sale,in,Counterparty_14,21567051.23,,
2025-04-07,646.06,payroll,out,Counterparty_39,21566405.17,2025-03-23,2025-04-27
2025-04-07,5313.16,software_subscription,out,Counterparty_21,21561092.01,2025-03-15,2025-04-21
2025-04-07,3868.91,customer_payment,in,Counterparty_29,21564960.92,,
2025-04-07,233.34,tax_payment,out,Counterparty_92,21564727.58,2025-03-16,2025-04-20
2025-04-07,1164.33,T&E,out,Counterparty_18,21563563.25,2025-03-20,2025-04-22
2025-04-07,12226.48,customer_payment,in,Counterparty_95,21575789.73,,
2025-04-07,5092.28,credit,in,Counterparty_45,21580882.01,,
2025-04-07,1319.38,T&E,out,Counterparty_17,21579562.63,2025-02-22,2025-03-19
2025-04-07,2237.88,credit,in,Counterparty_49,21581800.51,,
2025-04-07,1540.79,marketing_spend,out,Counterparty_20,21580259.72,2025-02-28,2025-03-29
2025-04-07,5224.5,marketing_spend,out,Counterparty_75,21575035.22,2025-03-05,2025-04-02
2025-04-07,12925.82,tax_payment,out,Counterparty_6,21562109.4,2025-03-17,2025-04-18
2025-04-07,2484.78,software_subscription,out,Counterparty_46,21559624.62,2025-03-07,2025-04-07
2025-04-07,1242.04,customer_payment,in,Counterparty_70,21560866.66,,
2025-04-07,2813.47,asset_sale,in,Counterparty_5,21563680.13,,
2025-04-07,7538.88,tax_payment,out,Counterparty_12,21556141.25,2025-03-03,2025-04-02
2025-04-07,1114.59,payroll,out,Counterparty_71,21555026.66,2025-03-13,2025-04-17
2025-04-07,1276.02,customer_payment,in,Counterparty_22,21556302.68,,
2025-04-07,2521.7,supplier_payment,out,Counterparty_30,21553780.98,2025-03-07,2025-04-12
2025-04-07,2407.75,asset_sale,in,Counterparty_10,21556188.73,,
2025-04-07,2947.44,refund,in,Counterparty_82,21559136.17,,
2025-04-07,217.67,rent,out,Counterparty_7,21558918.5,2025-03-04,2025-04-08
2025-04-07,2662.24,asset_sale,in,Counterparty_88,21561580.74,,
2025-04-07,3053.4,investment_income,in,Counterparty_2,21564634.14,,
2025-04-07,3285.94,customer_payment,in,Counterparty_24,21567920.08,,
2025-04-07,330.84,customer_payment,in,Counterparty_39,21568250.92,,
2025-04-07,2094.73,refund,in,Counterparty_35,21570345.65,,
2025-04-07,2443.94,customer_payment,in,Counterparty_73,21572789.59,,
2025-04-07,1431.58,investment_income,in,Counterparty_45,21574221.17,,
2025-04-08,4468.0,utilities,out,Counterparty_89,21569753.17,2025-03-13,2025-04-14
2025-04-08,374.21,customer_payment,in,Counterparty_72,21570127.38,,
2025-04-08,8199.62,customer_payment,in,Counterparty_20,21578327.0,,
2025-04-08,3247.85,tax_payment,out,Counterparty_39,21575079.15,2025-02-23,2025-03-31
2025-04-08,1423.12,investment_income,in,Counterparty_10,21576502.27,,
2025-04-08,4842.02,tax_payment,out,Counterparty_19,21571660.25,2025-03-17,2025-04-17
2025-04-08,8515.29,investment_income,in,Counterparty_42,21580175.54,,
2025-04-08,4081.56,tax_payment,out,Counterparty_81,21576093.98,2025-02-28,2025-03-25
2025-04-08,4702.41,asset_sale,in,Counterparty_3,21580796.39,,
2025-04-08,11051.57,utilities,out,Counterparty_13,21569744.82,2025-02-25,2025-03-26
2025-04-08,300.03,refund,in,Counterparty_73,21570044.85,,
2025-04-08,6729.09,supplier_payment,out,Counterparty_79,21563315.76,2025-03-10,2025-04-12
2025-04-08,5195.93,payroll,out,Counterparty_82,21558119.83,2025-03-05,2025-04-05
2025-04-08,4433.43,customer_payment,in,Counterparty_71,21562553.26,,
2025-04-08,13833.84,utilities,out,Counterparty_3,21548719.42,2025-03-02,2025-04-04
2025-04-08,1789.24,asset_sale,in,Counterparty_74,21550508.66,,
2025-04-08,836.0,marketing_spend,out,Counterparty_13,21549672.66,2025-03-20,2025-04-22
2025-04-08,1827.37,investment_income,in,Counterparty_3,21551500.03,,
2025-04-08,2387.97,utilities,out,Counterparty_27,21549112.06,2025-03-19,2025-04-24
2025-04-08,3134.27,payroll,out,Counterparty_32,21545977.79,2025-03-13,2025-04-11
2025-04-08,417.38,loan_repayment,out,Counterparty_85,21545560.41,2025-03-09,2025-04-15
2025-04-08,9230.71,supplier_payment,out,Counterparty_57,21536329.7,2025-03-15,2025-04-22
2025-04-08,2435.34,supplier_payment,out,Counterparty_11,21533894.36,2025-03-08,2025-04-11
2025-04-08,1184.81,T&E,out,Counterparty_90,21532709.55,2025-03-15,2025-04-11
2025-04-08,2740.77,customer_payment,in,Counterparty_99,21535450.32,,
2025-04-08,4962.78,loan_repayment,out,Counterparty_52,21530487.54,2025-03-18,2025-04-12
2025-04-08,165.37,refund,in,Counterparty_98,21530652.91,,
2025-04-08,15606.9,T&E,out,Counterparty_6,21515046.01,2025-03-04,2025-04-06
2025-04-08,1959.46,tax_payment,out,Counterparty_31,21513086.55,2025-02-25,2025-03-26
2025-04-08,6179.0,marketing_spend,out,Counterparty_82,21506907.55,2025-03-13,2025-04-11
2025-04-08,8299.59,asset_sale,in,Counterparty_6,21515207.14,,
2025-04-08,887.64,credit,in,Counterparty_52,21516094.78,,
2025-04-09,2647.81,customer_payment,in,Counterparty_89,21518742.59,,
2025-04-09,2858.79,rent,out,Counterparty_47,21515883.8,2025-03-12,2025-04-14
2025-04-09,5806.18,rent,out,Counterparty_49,21510077.62,2025-03-24,2025-04-27
2025-04-09,6688.28,rent,out,Counterparty_68,21503389.34,2025-03-25,2025-04-19
2025-04-09,1149.09,customer_payment,in,Counterparty_61,21504538.43,,
2025-04-09,369.51,payroll,out,Counterparty_34,21504168.92,2025-03-02,2025-04-08
2025-04-09,1563.84,tax_payment,out,Counterparty_13,21502605.08,2025-03-17,2025-04-17
2025-04-09,1440.09,marketing_spend,out,Counterparty_95,21501164.99,2025-02-25,2025-03-24
2025-04-09,4525.42,tax_payment,out,Counterparty_55,21496639.57,2025-03-15,2025-04-18
2025-04-09,3086.05,investment_income,in,Counterparty_92,21499725.62,,
2025-04-09,2975.79,software_subscription,out,Counterparty_50,21496749.83,2025-03-08,2025-04-08
2025-04-09,2031.31,customer_payment,in,Counterparty_25,21498781.14,,
2025-04-09,626.32,investment_income,in,Counterparty_76,21499407.46,,
2025-04-09,7547.83,credit,in,Counterparty_3,21506955.29,,
2025-04-09,8305.02,asset_sale,in,Counterparty_58,21515260.31,,
2025-04-09,4353.09,asset_sale,in,Counterparty_30,21519613.4,,
2025-04-09,12941.21,refund,in,Counterparty_4,21532554.61,,
2025-04-09,2916.58,rent,out,Counterparty_41,21529638.03,2025-03-09,2025-04-05
2025-04-09,755.63,refund,in,Counterparty_6,21530393.66,,
2025-04-09,2650.16,marketing_spend,out,Counterparty_26,21527743.5,2025-03-12,2025-04-09
2025-04-09,3808.78,tax_payment,out,Counterparty_97,21523934.72,2025-03-14,2025-04-15
2025-04-09,127.54,customer_payment,in,Counterparty_67,21524062.26,,
2025-04-09,8511.75,investment_income,in,Counterparty_89,21532574.01,,
2025-04-09,4098.22,T&E,out,Counterparty_32,21528475.79,2025-03-04,2025-03-30
2025-04-09,9315.12,refund,in,Counterparty_91,21537790.91,,
2025-04-09,7561.87,supplier_payment,out,Counterparty_58,21530229.04,2025-03-22,2025-04-26
2025-04-09,8141.26,asset_sale,in,Counterparty_54,21538370.3,,
2025-04-09,1003.81,software_subscription,out,Counterparty_3,21537366.49,2025-03-23,2025-04-22
2025-04-09,4411.87,loan_repayment,out,Counterparty_20,21532954.62,2025-03-20,2025-04-20
2025-04-09,845.32,credit,in,Counterparty_32,21533799.94,,
2025-04-09,629.2,customer_payment,in,Counterparty_79,21534429.14,,
2025-04-09,3137.15,investment_income,in,Counterparty_32,21537566.29,,
2025-04-09,6599.66,loan_repayment,out,Counterparty_40,21530966.63,2025-03-18,2025-04-20
2025-04-09,155.05,investment_income,in,Counterparty_18,21531121.68,,
2025-04-09,2232.18,investment_income,in,Counterparty_49,21533353.86,,
2025-04-09,531.43,marketing_spend,out,Counterparty_49,21532822.43,2025-03-05,2025-03-31
2025-04-09,1484.97,customer_payment,in,Counterparty_12,21534307.4,,
2025-04-09,2597.2,software_subscription,out,Counterparty_18,21531710.2,2025-03-02,2025-04-05
2025-04-09,3420.68,asset_sale,in,Counterparty_54,21535130.88,,
2025-04-10,2594.94,asset_sale,in,Counterparty_7,21537725.82,,
2025-04-10,165.56,utilities,out,Counterparty_33,21537560.26,2025-03-10,2025-04-15
2025-04-10,6577.46,loan_repayment,out,Counterparty_91,21530982.8,2025-03-14,2025-04-09
2025-04-10,189.29,credit,in,Counterparty_96,21531172.09,,
2025-04-10,5929.82,marketing_spend,out,Counterparty_50,21525242.27,2025-03-17,2025-04-18
2025-04-10,636.21,investment_income,in,Counterparty_21,21525878.48,,
2025-04-10,9129.86,asset_sale,in,Counterparty_12,21535008.34,,
2025-04-10,964.82,refund,in,Counterparty_24,21535973.16,,
2025-04-10,1181.58,supplier_payment,out,Counterparty_95,21534791.58,2025-03-26,2025-04-24
2025-04-10,1776.55,credit,in,Counterparty_90,21536568.13,,
2025-04-10,7287.67,customer_payment,in,Counterparty_93,21543855.8,,
2025-04-10,6806.85,investment_income,in,Counterparty_52,21550662.65,,
2025-04-10,907.35,loan_repayment,out,Counterparty_46,21549755.3,2025-03-18,2025-04-19
2025-04-10,94.46,credit,in,Counterparty_21,21549849.76,,
2025-04-10,1208.52,refund,in,Counterparty_82,21551058.28,,
2025-04-10,1890.53,T&E,out,Counterparty_10,21549167.75,2025-03-16,2025-04-16
2025-04-10,3786.69,investment_income,in,Counterparty_19,21552954.44,,
2025-04-10,6893.68,loan_repayment,out,Counterparty_98,21546060.76,2025-03-09,2025-04-17
2025-04-10,4864.85,T&E,out,Counterparty_16,21541195.91,2025-03-13,2025-04-12
2025-04-10,6331.79,marketing_spend,out,Counterparty_88,21534864.12,2025-03-21,2025-04-21
2025-04-10,609.1,asset_sale,in,Counterparty_66,21535473.22,,
2025-04-10,1080.81,credit,in,Counterparty_57,21536554.03,,
2025-04-10,8767.25,T&E,out,Counterparty_55,21527786.78,2025-02-28,2025-03-26
2025-04-10,684.77,refund,in,Counterparty_43,21528471.55,,
2025-04-10,1451.3,refund,in,Counterparty_24,21529922.85,,
2025-04-10,671.74,refund,in,Counterparty_76,21530594.59,,
2025-04-10,4386.49,customer_payment,in,Counterparty_38,21534981.08,,
2025-04-10,6915.12,tax_payment,out,Counterparty_73,21528065.96,2025-02-27,2025-03-29
2025-04-10,423.34,T&E,out,Counterparty_97,21527642.62,2025-03-20,2025-04-16
2025-04-10,3723.65,marketing_spend,out,Counterparty_4,21523918.97,2025-03-26,2025-05-01
2025-04-10,376.22,refund,in,Counterparty_1,21524295.19,,
2025-04-10,2999.53,utilities,out,Counterparty_29,21521295.66,2025-02-28,2025-03-25
2025-04-10,1245.56,investment_income,in,Counterparty_98,21522541.22,,
2025-04-10,9.94,software_subscription,out,Counterparty_96,21522531.28,2025-03-14,2025-04-20
2025-04-10,16416.47,supplier_payment,out,Counterparty_84,21506114.81,2025-03-06,2025-04-04
2025-04-10,4639.04,investment_income,in,Counterparty_86,21510753.85,,
2025-04-10,4701.4,asset_sale,in,Counterparty_10,21515455.25,,
2025-04-10,2459.59,credit,in,Counterparty_76,21517914.84,,
2025-04-10,1195.05,asset_sale,in,Counterparty_22,21519109.89,,
2025-04-10,2123.0,rent,out,Counterparty_49,21516986.89,2025-03-06,2025-04-08
2025-04-10,1945.09,customer_payment,in,Counterparty_89,21518931.98,,
2025-04-10,3071.86,tax_payment,out,Counterparty_17,21515860.12,2025-02-25,2025-04-02
2025-04-10,522.27,rent,out,Counterparty_24,21515337.85,2025-02-26,2025-03-31
2025-04-10,3466.1,payroll,out,Counterparty_44,21511871.75,2025-03-10,2025-04-13
2025-04-10,5745.62,payroll,out,Counterparty_42,21506126.13,2025-03-13,2025-04-14
2025-04-10,2471.07,customer_payment,in,Counterparty_57,21508597.2,,
2025-04-10,10209.14,payroll,out,Counterparty_4,21498388.06,2025-02-28,2025-04-07
2025-04-10,1776.03,payroll,out,Counterparty_95,21496612.03,2025-03-05,2025-04-05
2025-04-10,435.74,investment_income,in,Counterparty_8,21497047.77,,
2025-04-10,4268.27,customer_payment,in,Counterparty_77,21501316.04,,
2025-04-10,429.78,supplier_payment,out,Counterparty_58,21500886.26,2025-03-03,2025-03-29
2025-04-11,4330.21,payroll,out,Counterparty_69,21496556.05,2025-03-04,2025-04-09
2025-04-11,2792.72,refund,in,Counterparty_38,21499348.77,,
2025-04-11,4004.56,rent,out,Counterparty_55,21495344.21,2025-03-10,2025-04-08
2025-04-11,16736.86,refund,in,Counterparty_83,21512081.07,,
2025-04-11,5060.75,supplier_payment,out,Counterparty_23,21507020.32,2025-03-13,2025-04-14
2025-04-11,51.9,rent,out,Counterparty_94,21506968.42,2025-03-20,2025-04-17
2025-04-11,4347.87,software_subscription,out,Counterparty_91,21502620.55,2025-03-08,2025-04-03
2025-04-11,2695.89,T&E,out,Counterparty_39,21499924.66,2025-03-19,2025-04-22
2025-04-11,19017.32,utilities,out,Counterparty_69,21480907.34,2025-02-28,2025-03-25
2025-04-11,4535.11,utilities,out,Counterparty_15,21476372.23,2025-03-24,2025-04-18
2025-04-11,9143.71,marketing_spend,out,Counterparty_37,21467228.52,2025-03-23,2025-04-19
2025-04-11,618.68,tax_payment,out,Counterparty_92,21466609.84,2025-03-01,2025-03-28
2025-04-11,1761.38,credit,in,Counterparty_7,21468371.22,,
2025-04-11,6339.4,asset_sale,in,Counterparty_28,21474710.62,,
2025-04-11,12397.73,investment_income,in,Counterparty_28,21487108.35,,
2025-04-11,1605.42,asset_sale,in,Counterparty_42,21488713.77,,
2025-04-11,2753.13,tax_payment,out,Counterparty_68,21485960.64,2025-03-27,2025-04-29
2025-04-11,395.38,refund,in,Counterparty_98,21486356.02,,
2025-04-11,9868.51,credit,in,Counterparty_2,21496224.53,,
2025-04-11,1353.13,software_subscription,out,Counterparty_43,21494871.4,2025-03-18,2025-04-26
2025-04-11,1822.69,tax_payment,out,Counterparty_34,21493048.71,2025-03-13,2025-04-13
2025-04-11,1739.63,credit,in,Counterparty_1,21494788.34,,
2025-04-11,3664.66,customer_payment,in,Counterparty_84,21498453.0,,
2025-04-11,1370.91,investment_income,in,Counterparty_12,21499823.91,,
2025-04-11,2144.2,refund,in,Counterparty_97,21501968.11,,
2025-04-11,999.62,marketing_spend,out,Counterparty_41,21500968.49,2025-03-14,2025-04-22
2025-04-11,7185.15,utilities,out,Counterparty_48,21493783.34,2025-03-04,2025-03-30
2025-04-11,879.65,refund,in,Counterparty_31,21494662.99,,
2025-04-11,740.96,refund,in,Counterparty_32,21495403.95,,
2025-04-11,1745.83,credit,in,Counterparty_93,21497149.78,,
2025-04-11,11105.04,asset_sale,in,Counterparty_32,21508254.82,,
2025-04-11,4852.72,credit,in,Counterparty_92,21513107.54,,
2025-04-11,5166.92,software_subscription,out,Counterparty_47,21507940.62,2025-03-04,2025-04-02
2025-04-11,2101.59,supplier_payment,out,Counterparty_19,21505839.03,2025-03-14,2025-04-17
2025-04-11,2161.74,tax_payment,out,Counterparty_20,21503677.29,2025-03-13,2025-04-11
2025-04-11,481.73,software_subscription,out,Counterparty_73,21503195.56,2025-03-08,2025-04-08
2025-04-11,3074.57,asset_sale,in,Counterparty_41,21506270.13,,
2025-04-11,526.9,T&E,out,Counterparty_18,21505743.23,2025-03-16,2025-04-16
2025-04-11,6580.61,asset_sale,in,Counterparty_30,21512323.84,,
2025-04-11,3022.15,investment_income,in,Counterparty_39,21515345.99,,
2025-04-11,4352.05,refund,in,Counterparty_78,21519698.04,,
2025-04-11,852.14,software_subscription,out,Counterparty_13,21518845.9,2025-03-03,2025-04-04
2025-04-11,802.99,refund,in,Counterparty_88,21519648.89,,
2025-04-11,607.07,asset_sale,in,Counterparty_66,21520255.96,,
2025-04-11,5122.16,marketing_spend,out,Counterparty_70,21515133.8,2025-03-21,2025-04-19
2025-04-11,157.13,rent,out,Counterparty_70,21514976.67,2025-03-13,2025-04-09
2025-04-11,1182.78,credit,in,Counterparty_62,21516159.45,,
2025-04-11,5348.11,payroll,out,Counterparty_87,21510811.34,2025-03-03,2025-04-05
2025-04-11,1914.5,customer_payment,in,Counterparty_18,21512725.84,,
2025-04-12,3517.98,T&E,out,Counterparty_62,21509207.86,2025-03-04,2025-03-30
2025-04-12,3308.42,customer_payment,in,Counterparty_48,21512516.28,,
2025-04-12,1014.09,asset_sale,in,Counterparty_98,21513530.37,,
2025-04-12,3902.05,marketing_spend,out,Counterparty_49,21509628.32,2025-03-05,2025-04-09
2025-04-12,10701.02,rent,out,Counterparty_4,21498927.3,2025-03-27,2025-05-02
2025-04-12,610.68,asset_sale,in,Counterparty_98,21499537.98,,
2025-04-12,1849.72,rent,out,Counterparty_63,21497688.26,2025-03-11,2025-04-07
2025-04-12,4390.32,loan_repayment,out,Counterparty_14,21493297.94,2025-03-07,2025-04-04
2025-04-12,13956.61,refund,in,Counterparty_52,21507254.55,,
2025-04-12,10866.34,supplier_payment,out,Counterparty_38,21496388.21,2025-03-02,2025-04-09
2025-04-12,2008.42,asset_sale,in,Counterparty_11,21498396.63,,
2025-04-12,199.96,software_subscription,out,Counterparty_81,21498196.67,2025-03-23,2025-04-29
2025-04-12,549.12,utilities,out,Counterparty_98,21497647.55,2025-03-20,2025-04-15
2025-04-12,4001.69,credit,in,Counterparty_32,21501649.24,,
2025-04-12,5862.06,customer_payment,in,Counterparty_44,21507511.3,,
2025-04-12,9240.06,rent,out,Counterparty_99,21498271.24,2025-03-18,2025-04-25
2025-04-12,7307.16,payroll,out,Counterparty_94,21490964.08,2025-02-28,2025-04-02
2025-04-12,362.75,supplier_payment,out,Counterparty_63,21490601.33,2025-03-28,2025-04-27
2025-04-12,1012.98,T&E,out,Counterparty_94,21489588.35,2025-03-14,2025-04-17
2025-04-12,88.49,software_subscription,out,Counterparty_60,21489499.86,2025-03-07,2025-04-05
2025-04-12,1587.4,rent,out,Counterparty_4,21487912.46,2025-03-12,2025-04-08
2025-04-12,6958.25,loan_repayment,out,Counterparty_45,21480954.21,2025-03-03,2025-03-30
2025-04-12,1155.67,customer_payment,in,Counterparty_22,21482109.88,,
2025-04-12,3753.96,supplier_payment,out,Counterparty_88,21478355.92,2025-03-10,2025-04-06
2025-04-12,1483.59,payroll,out,Counterparty_38,21476872.33,2025-02-27,2025-03-24
2025-04-12,6203.75,asset_sale,in,Counterparty_81,21483076.08,,
2025-04-12,442.77,investment_income,in,Counterparty_13,21483518.85,,
2025-04-12,4501.19,tax_payment,out,Counterparty_14,21479017.66,2025-03-05,2025-04-11
2025-04-12,1609.86,refund,in,Counterparty_38,21480627.52,,
2025-04-12,16619.05,refund,in,Counterparty_41,21497246.57,,
2025-04-12,2591.08,credit,in,Counterparty_1,21499837.65,,
2025-04-12,6450.38,marketing_spend,out,Counterparty_71,21493387.27,2025-03-09,2025-04-08
2025-04-12,1391.1,marketing_spend,out,Counterparty_81,21491996.17,2025-03-03,2025-04-07
2025-04-12,81.7,marketing_spend,out,Counterparty_8,21491914.47,2025-03-21,2025-04-19
2025-04-12,6690.82,investment_income,in,Counterparty_9,21498605.29,,
2025-04-12,4899.29,utilities,out,Counterparty_58,21493706.0,2025-03-03,2025-04-05
2025-04-12,7304.76,rent,out,Counterparty_64,21486401.24,2025-03-12,2025-04-14
2025-04-12,5137.67,tax_payment,out,Counterparty_24,21481263.57,2025-03-01,2025-04-09
2025-04-12,10703.18,investment_income,in,Counterparty_59,21491966.75,,
2025-04-12,133.98,tax_payment,out,Counterparty_82,21491832.77,2025-03-06,2025-04-09
2025-04-12,3538.49,T&E,out,Counterparty_8,21488294.28,2025-03-21,2025-04-18
2025-04-12,1111.05,investment_income,in,Counterparty_9,21489405.33,,
2025-04-12,1101.9,loan_repayment,out,Counterparty_43,21488303.43,2025-03-05,2025-04-13
2025-04-12,2180.33,investment_income,in,Counterparty_97,21490483.76,,
2025-04-12,4828.11,tax_payment,out,Counterparty_67,21485655.65,2025-03-20,2025-04-14
2025-04-12,89.37,customer_payment,in,Counterparty_90,21485745.02,,
2025-04-12,531.75,rent,out,Counterparty_33,21485213.27,2025-03-04,2025-04-01
2025-04-12,3398.76,credit,in,Counterparty_74,21488612.03,,
2025-04-12,2578.39,asset_sale,in,Counterparty_13,21491190.42,,
2025-04-12,2583.16,asset_sale,in,Counterparty_6,21493773.58,,
2025-04-12,1719.77,software_subscription,out,Counterparty_85,21492053.81,2025-03-07,2025-04-08
2025-04-12,5466.17,refund,in,Counterparty_29,21497519.98,,
2025-04-13,13213.3,utilities,out,Counterparty_87,21484306.68,2025-03-08,2025-04-08
2025-04-13,583.1,loan_repayment,out,Counterparty_37,21483723.58,2025-03-04,2025-04-06
2025-04-13,3546.15,software_subscription,out,Counterparty_69,21480177.43,2025-03-26,2025-04-22
2025-04-13,103.29,T&E,out,Counterparty_31,21480074.14,2025-03-29,2025-05-05
2025-04-13,11316.37,asset_sale,in,Counterparty_45,21491390.51,,
2025-04-13,2602.17,utilities,out,Counterparty_77,21488788.34,2025-03-02,2025-04-05
2025-04-13,2451.64,investment_income,in,Counterparty_84,21491239.98,,
2025-04-13,347.16,tax_payment,out,Counterparty_67,21490892.82,2025-03-07,2025-04-08
2025-04-13,2972.89,payroll,out,Counterparty_86,21487919.93,2025-03-08,2025-04-12
2025-04-13,842.37,loan_repayment,out,Counterparty_45,21487077.56,2025-03-18,2025-04-12
2025-04-13,5190.89,investment_income,in,Counterparty_41,21492268.45,,
2025-04-13,7843.11,loan_repayment,out,Counterparty_64,21484425.34,2025-03-05,2025-04-06
2025-04-13,5117.1,utilities,out,Counterparty_37,21479308.24,2025-03-14,2025-04-16
2025-04-13,2858.59,T&E,out,Counterparty_99,21476449.65,2025-03-05,2025-04-03
2025-04-13,212.41,refund,in,Counterparty_40,21476662.06,,
2025-04-13,27874.4,T&E,out,Counterparty_20,21448787.66,2025-03-14,2025-04-11
2025-04-13,10219.95,refund,in,Counterparty_1,21459007.61,,
2025-04-13,417.09,loan_repayment,out,Counterparty_87,21458590.52,2025-03-06,2025-04-04
2025-04-13,557.86,marketing_spend,out,Counterparty_76,21458032.66,2025-03-06,2025-04-14
2025-04-13,7563.87,investment_income,in,Counterparty_47,21465596.53,,
2025-04-13,3481.18,asset_sale,in,Counterparty_86,21469077.71,,
2025-04-13,1810.28,refund,in,Counterparty_71,21470887.99,,
2025-04-13,2088.98,credit,in,Counterparty_13,21472976.97,,
2025-04-13,3232.07,credit,in,Counterparty_9,21476209.04,,
2025-04-13,11022.96,asset_sale,in,Counterparty_61,21487232.0,,
2025-04-13,2672.05,investment_income,in,Counterparty_58,21489904.05,,
2025-04-13,5236.32,loan_repayment,out,Counterparty_86,21484667.73,2025-03-15,2025-04-17
2025-04-13,2005.44,marketing_spend,out,Counterparty_3,21482662.29,2025-03-14,2025-04-22
2025-04-13,6411.73,T&E,out,Counterparty_11,21476250.56,2025-03-10,2025-04-11
2025-04-13,1716.42,rent,out,Counterparty_80,21474534.14,2025-03-15,2025-04-11
2025-04-13,368.07,tax_payment,out,Counterparty_91,21474166.07,2025-03-08,2025-04-11
2025-04-13,3799.43,tax_payment,out,Counterparty_45,21470366.64,2025-03-11,2025-04-14
2025-04-13,4834.31,credit,in,Counterparty_29,21475200.95,,
2025-04-13,38.39,loan_repayment,out,Counterparty_61,21475162.56,2025-03-29,2025-04-24
2025-04-13,1798.89,rent,out,Counterparty_17,21473363.67,2025-03-11,2025-04-18
2025-04-13,7313.57,asset_sale,in,Counterparty_33,21480677.24,,
2025-04-13,11216.52,customer_payment,in,Counterparty_52,21491893.76,,
2025-04-13,759.27,refund,in,Counterparty_54,21492653.03,,
2025-04-13,1181.35,asset_sale,in,Counterparty_37,21493834.38,,
2025-04-14,1280.29,loan_repayment,out,Counterparty_11,21492554.09,2025-03-23,2025-04-23
2025-04-14,465.73,investment_income,in,Counterparty_35,21493019.82,,
2025-04-14,2955.27,asset_sale,in,Counterparty_53,21495975.09,,
2025-04-14,6504.22,utilities,out,Counterparty_82,21489470.87,2025-03-12,2025-04-10
2025-04-14,2051.26,loan_repayment,out,Counterparty_4,21487419.61,2025-03-05,2025-04-08
2025-04-14,15003.49,investment_income,in,Counterparty_2,21502423.1,,
2025-04-14,1698.52,rent,out,Counterparty_86,21500724.58,2025-03-25,2025-05-02
2025-04-14,540.64,payroll,out,Counterparty_58,21500183.94,2025-03-03,2025-04-06
2025-04-14,1406.07,rent,out,Counterparty_18,21498777.87,2025-03-15,2025-04-13
2025-04-14,1663.11,supplier_payment,out,Counterparty_31,21497114.76,2025-03-03,2025-04-09
2025-04-14,928.48,credit,in,Counterparty_9,21498043.24,,
2025-04-14,962.22,marketing_spend,out,Counterparty_39,21497081.02,2025-03-19,2025-04-14
2025-04-14,230.64,asset_sale,in,Counterparty_22,21497311.66,,
2025-04-14,3745.92,utilities,out,Counterparty_50,21493565.74,2025-03-01,2025-04-09
2025-04-14,7116.79,investment_income,in,Counterparty_79,21500682.53,,
2025-04-14,4153.57,refund,in,Counterparty_10,21504836.1,,
2025-04-14,4420.76,asset_sale,in,Counterparty_21,21509256.86,,
2025-04-14,4968.71,refund,in,Counterparty_80,21514225.57,,
2025-04-14,4546.08,payroll,out,Counterparty_7,21509679.49,2025-03-03,2025-04-05
2025-04-14,6315.77,tax_payment,out,Counterparty_61,21503363.72,2025-03-02,2025-04-06
2025-04-14,3572.31,asset_sale,in,Counterparty_2,21506936.03,,
2025-04-14,1110.08,marketing_spend,out,Counterparty_30,21505825.95,2025-03-07,2025-04-08
2025-04-14,2468.74,customer_payment,in,Counterparty_60,21508294.69,,
2025-04-14,1481.22,supplier_payment,out,Counterparty_74,21506813.47,2025-03-08,2025-04-12
2025-04-14,3023.26,investment_income,in,Counterparty_44,21509836.73,,
2025-04-14,8224.68,T&E,out,Counterparty_99,21501612.05,2025-03-02,2025-03-28
2025-04-14,584.51,credit,in,Counterparty_50,21502196.56,,
2025-04-14,920.06,T&E,out,Counterparty_4,21501276.5,2025-03-18,2025-04-19
2025-04-14,3870.99,payroll,out,Counterparty_37,21497405.51,2025-03-12,2025-04-12
2025-04-14,1563.92,software_subscription,out,Counterparty_17,21495841.59,2025-03-20,2025-04-17
2025-04-14,842.19,payroll,out,Counterparty_20,21494999.4,2025-03-22,2025-04-18
2025-04-14,726.9,customer_payment,in,Counterparty_43,21495726.3,,
2025-04-14,416.49,T&E,out,Counterparty_90,21495309.81,2025-03-22,2025-04-28
2025-04-14,10096.65,loan_repayment,out,Counterparty_46,21485213.16,2025-03-18,2025-04-20
2025-04-14,2955.68,T&E,out,Counterparty_62,21482257.48,2025-03-17,2025-04-17
2025-04-14,95.75,loan_repayment,out,Counterparty_12,21482161.73,2025-03-16,2025-04-14
2025-04-14,4099.56,investment_income,in,Counterparty_81,21486261.29,,
2025-04-14,3440.13,credit,in,Counterparty_15,21489701.42,,
2025-04-14,8362.22,loan_repayment,out,Counterparty_12,21481339.2,2025-03-21,2025-04-19
2025-04-14,2563.44,utilities,out,Counterparty_36,21478775.76,2025-03-23,2025-04-25
2025-04-14,5204.81,loan_repayment,out,Counterparty_28,21473570.95,2025-03-14,2025-04-16
2025-04-14,8095.61,T&E,out,Counterparty_57,21465475.34,2025-03-25,2025-04-30
2025-04-15,4084.28,loan_repayment,out,Counterparty_58,21461391.06,2025-03-06,2025-04-06
2025-04-15,1344.18,T&E,out,Counterparty_86,21460046.88,2025-03-26,2025-04-23
2025-04-15,2200.42,utilities,out,Counterparty_53,21457846.46,2025-03-13,2025-04-16
2025-04-15,581.63,tax_payment,out,Counterparty_92,21457264.83,2025-03-03,2025-03-31
2025-04-15,5271.85,rent,out,Counterparty_62,21451992.98,2025-03-09,2025-04-17
2025-04-15,409.93,software_subscription,out,Counterparty_28,21451583.05,2025-03-09,2025-04-04
2025-04-15,1500.68,rent,out,Counterparty_35,21450082.37,2025-03-15,2025-04-09
2025-04-15,2558.07,refund,in,Counterparty_69,21452640.44,,
2025-04-15,2113.59,payroll,out,Counterparty_60,21450526.85,2025-03-21,2025-04-18
2025-04-15,7329.22,tax_payment,out,Counterparty_39,21443197.63,2025-03-16,2025-04-11
2025-04-15,4438.3,rent,out,Counterparty_24,21438759.33,2025-03-27,2025-05-04
2025-04-15,3192.09,software_subscription,out,Counterparty_14,21435567.24,2025-03-29,2025-04-26
2025-04-15,5636.47,utilities,out,Counterparty_93,21429930.77,2025-03-06,2025-04-09
2025-04-15,14310.84,loan_repayment,out,Counterparty_42,21415619.93,2025-03-18,2025-04-16
2025-04-15,1827.67,credit,in,Counterparty_58,21417447.6,,
2025-04-15,19.53,tax_payment,out,Counterparty_44,21417428.07,2025-03-17,2025-04-16
2025-04-15,105.98,rent,out,Counterparty_44,21417322.09,2025-03-21,2025-04-24
2025-04-15,363.21,utilities,out,Counterparty_49,21416958.88,2025-03-21,2025-04-19
2025-04-15,1999.91,rent,out,Counterparty_40,21414958.97,2025-03-31,2025-05-04
2025-04-15,3579.22,rent,out,Counterparty_16,21411379.75,2025-03-06,2025-04-07
2025-04-15,46.78,rent,out,Counterparty_10,21411332.97,2025-03-26,2025-05-01
2025-04-15,86.53,payroll,out,Counterparty_41,21411246.44,2025-03-10,2025-04-08
2025-04-15,269.61,marketing_spend,out,Counterparty_59,21410976.83,2025-03-22,2025-04-23
2025-04-15,616.13,investment_income,in,Counterparty_85,21411592.96,,
2025-04-15,13468.47,software_subscription,out,Counterparty_29,21398124.49,2025-03-12,2025-04-09
2025-04-15,4329.57,utilities,out,Counterparty_36,21393794.92,2025-03-06,2025-04-11
2025-04-15,1721.92,loan_repayment,out,Counterparty_38,21392073.0,2025-03-23,2025-04-27
2025-04-15,1042.05,tax_payment,out,Counterparty_13,21391030.95,2025-03-24,2025-04-23
2025-04-15,6787.13,tax_payment,out,Counterparty_59,21384243.82,2025-03-12,2025-04-09
2025-04-15,74.88,utilities,out,Counterparty_83,21384168.94,2025-03-17,2025-04-17
2025-04-15,1137.07,asset_sale,in,Counterparty_69,21385306.01,,
2025-04-15,3811.91,supplier_payment,out,Counterparty_25,21381494.1,2025-03-09,2025-04-08
2025-04-15,6803.48,software_subscription,out,Counterparty_65,21374690.62,2025-03-10,2025-04-14
2025-04-15,1466.59,software_subscription,out,Counterparty_47,21373224.03,2025-03-09,2025-04-03
2025-04-15,2554.24,marketing_spend,out,Counterparty_75,21370669.79,2025-03-03,2025-04-04
2025-04-15,924.45,rent,out,Counterparty_25,21369745.34,2025-03-18,2025-04-24
2025-04-15,378.83,rent,out,Counterparty_28,21369366.51,2025-03-09,2025-04-16
2025-04-15,4153.52,refund,in,Counterparty_26,21373520.03,,
2025-04-15,10323.47,investment_income,in,Counterparty_96,21383843.5,,
2025-04-15,8655.52,credit,in,Counterparty_21,21392499.02,,
2025-04-15,15416.05,customer_payment,in,Counterparty_80,21407915.07,,
2025-04-15,404.46,loan_repayment,out,Counterparty_18,21407510.61,2025-03-03,2025-04-06
2025-04-15,140.69,refund,in,Counterparty_76,21407651.3,,
2025-04-15,2366.38,asset_sale,in,Counterparty_93,21410017.68,,
2025-04-15,715.46,payroll,out,Counterparty_61,21409302.22,2025-03-12,2025-04-20
2025-04-15,313.64,refund,in,Counterparty_49,21409615.86,,
2025-04-15,1743.76,investment_income,in,Counterparty_65,21411359.62,,
2025-04-15,3647.8,investment_income,in,Counterparty_97,21415007.42,,
2025-04-15,4649.22,customer_payment,in,Counterparty_69,21419656.64,,
2025-04-15,4762.21,asset_sale,in,Counterparty_29,21424418.85,,
2025-04-15,399.26,refund,in,Counterparty_16,21424818.11,,
2025-04-16,305.11,refund,in,Counterparty_76,21425123.22,,
2025-04-16,2832.31,investment_income,in,Counterparty_46,21427955.53,,
2025-04-16,3402.99,marketing_spend,out,Counterparty_66,21424552.54,2025-03-18,2025-04-22
2025-04-16,504.95,asset_sale,in,Counterparty_70,21425057.49,,
2025-04-16,4740.29,rent,out,Counterparty_20,21420317.2,2025-03-20,2025-04-22
2025-04-16,3605.12,refund,in,Counterparty_14,21423922.32,,
2025-04-16,0.08,credit,in,Counterparty_9,21423922.4,,
2025-04-16,6100.13,rent,out,Counterparty_34,21417822.27,2025-03-15,2025-04-11
2025-04-16,4969.03,software_subscription,out,Counterparty_49,21412853.24,2025-03-21,2025-04-21
2025-04-16,267.57,customer_payment,in,Counterparty_94,21413120.81,,
2025-04-16,790.9,software_subscription,out,Counterparty_71,21412329.91,2025-03-10,2025-04-12
2025-04-16,835.86,credit,in,Counterparty_33,21413165.77,,
2025-04-16,1165.04,investment_income,in,Counterparty_44,21414330.81,,
2025-04-16,6462.24,investment_income,in,Counterparty_75,21420793.05,,
2025-04-16,3768.73,asset_sale,in,Counterparty_82,21424561.78,,
2025-04-16,2601.93,investment_income,in,Counterparty_85,21427163.71,,
2025-04-16,7410.03,marketing_spend,out,Counterparty_2,21419753.68,2025-03-25,2025-04-22
2025-04-16,2143.23,marketing_spend,out,Counterparty_46,21417610.45,2025-03-22,2025-04-19
2025-04-16,1771.13,asset_sale,in,Counterparty_40,21419381.58,,
2025-04-16,3437.26,marketing_spend,out,Counterparty_93,21415944.32,2025-03-20,2025-04-16
2025-04-16,306.48,asset_sale,in,Counterparty_78,21416250.8,,
2025-04-16,1968.9,asset_sale,in,Counterparty_59,21418219.7,,
2025-04-16,4099.43,refund,in,Counterparty_67,21422319.13,,
2025-04-16,2335.3,software_subscription,out,Counterparty_45,21419983.83,2025-03-25,2025-05-02
2025-04-16,1150.18,supplier_payment,out,Counterparty_33,21418833.65,2025-03-27,2025-05-03
2025-04-16,4017.06,refund,in,Counterparty_30,21422850.71,,
2025-04-16,525.23,tax_payment,out,Counterparty_15,21422325.48,2025-03-14,2025-04-12
2025-04-16,3058.66,marketing_spend,out,Counterparty_25,21419266.82,2025-03-17,2025-04-18
2025-04-16,1129.34,T&E,out,Counterparty_74,21418137.48,2025-03-31,2025-05-07
2025-04-16,2865.39,software_subscription,out,Counterparty_50,21415272.09,2025-03-29,2025-04-27
2025-04-16,2784.01,utilities,out,Counterparty_68,21412488.08,2025-03-10,2025-04-07
2025-04-16,2575.98,rent,out,Counterparty_31,21409912.1,2025-03-05,2025-04-01
2025-04-16,1526.62,T&E,out,Counterparty_52,21408385.48,2025-03-16,2025-04-13
2025-04-16,1068.91,investment_income,in,Counterparty_49,21409454.39,,
2025-04-16,2332.07,supplier_payment,out,Counterparty_54,21407122.32,2025-03-15,2025-04-20
2025-04-16,22239.25,marketing_spend,out,Counterparty_87,21384883.07,2025-03-13,2025-04-15
2025-04-16,1325.13,payroll,out,Counterparty_22,21383557.94,2025-03-16,2025-04-15
2025-04-16,4324.43,supplier_payment,out,Counterparty_22,21379233.51,2025-03-22,2025-04-21
2025-04-16,2167.54,utilities,out,Counterparty_31,21377065.97,2025-03-27,2025-04-24
2025-04-16,104.67,payroll,out,Counterparty_66,21376961.3,2025-03-19,2025-04-26
2025-04-16,328.7,investment_income,in,Counterparty_55,21377290.0,,
2025-04-16,973.81,rent,out,Counterparty_29,21376316.19,2025-03-31,2025-04-25
2025-04-16,2530.24,asset_sale,in,Counterparty_56,21378846.43,,
2025-04-16,10343.08,T&E,out,Counterparty_7,21368503.35,2025-03-07,2025-04-14
2025-04-16,7205.6,payroll,out,Counterparty_4,21361297.75,2025-03-03,2025-04-11
2025-04-17,3846.24,utilities,out,Counterparty_34,21357451.51,2025-04-02,2025-04-29
2025-04-17,29177.6,investment_income,in,Counterparty_98,21386629.11,,
2025-04-17,7530.25,utilities,out,Counterparty_57,21379098.86,2025-03-13,2025-04-07
2025-04-17,4792.9,investment_income,in,Counterparty_27,21383891.76,,
2025-04-17,14149.34,credit,in,Counterparty_41,21398041.1,,
2025-04-17,702.82,refund,in,Counterparty_37,21398743.92,,
2025-04-17,3499.47,credit,in,Counterparty_15,21402243.39,,
2025-04-17,1244.61,marketing_spend,out,Counterparty_47,21400998.78,2025-03-18,2025-04-19
2025-04-17,870.64,asset_sale,in,Counterparty_34,21401869.42,,
2025-04-17,935.99,investment_income,in,Counterparty_42,21402805.41,,
2025-04-17,4650.88,refund,in,Counterparty_59,21407456.29,,
2025-04-17,662.88,rent,out,Counterparty_19,21406793.41,2025-03-20,2025-04-26
2025-04-17,8126.9,asset_sale,in,Counterparty_11,21414920.31,,
2025-04-17,618.25,supplier_payment,out,Counterparty_29,21414302.06,2025-03-04,2025-04-06
2025-04-17,3369.01,asset_sale,in,Counterparty_84,21417671.07,,
2025-04-17,1270.24,utilities,out,Counterparty_43,21416400.83,2025-03-06,2025-04-01
2025-04-17,3061.67,asset_sale,in,Counterparty_90,21419462.5,,
2025-04-17,220.37,T&E,out,Counterparty_59,21419242.13,2025-03-28,2025-04-26
2025-04-17,1054.82,credit,in,Counterparty_94,21420296.95,,
2025-04-17,1427.52,loan_repayment,out,Counterparty_7,21418869.43,2025-03-27,2025-05-02
2025-04-17,3220.62,investment_income,in,Counterparty_81,21422090.05,,
2025-04-17,4272.04,tax_payment,out,Counterparty_49,21417818.01,2025-03-21,2025-04-16
2025-04-17,844.14,investment_income,in,Counterparty_94,21418662.15,,
2025-04-17,14258.29,customer_payment,in,Counterparty_83,21432920.44,,
2025-04-17,13405.69,supplier_payment,out,Counterparty_68,21419514.75,2025-03-18,2025-04-22
2025-04-17,589.14,payroll,out,Counterparty_46,21418925.61,2025-03-24,2025-04-20
2025-04-17,1678.3,supplier_payment,out,Counterparty_5,21417247.31,2025-03-22,2025-04-24
2025-04-17,307.55,utilities,out,Counterparty_24,21416939.76,2025-03-15,2025-04-21
2025-04-17,13551.73,asset_sale,in,Counterparty_61,21430491.49,,
2025-04-17,11162.22,refund,in,Counterparty_66,21441653.71,,
2025-04-17,1183.41,payroll,out,Counterparty_76,21440470.3,2025-03-05,2025-04-02
2025-04-17,228.04,asset_sale,in,Counterparty_72,21440698.34,,
2025-04-17,7577.61,refund,in,Counterparty_2,21448275.95,,
2025-04-17,5293.76,customer_payment,in,Counterparty_84,21453569.71,,
2025-04-18,4907.37,refund,in,Counterparty_62,21458477.08,,
2025-04-18,288.55,supplier_payment,out,Counterparty_54,21458188.53,2025-03-13,2025-04-18
2025-04-18,1010.88,T&E,out,Counterparty_26,21457177.65,2025-03-23,2025-04-29
2025-04-18,2125.99,asset_sale,in,Counterparty_77,21459303.64,,
2025-04-18,2953.79,software_subscription,out,Counterparty_90,21456349.85,2025-03-28,2025-05-05
2025-04-18,7847.9,customer_payment,in,Counterparty_87,21464197.75,,
2025-04-18,2258.52,supplier_payment,out,Counterparty_43,21461939.23,2025-03-16,2025-04-16
2025-04-18,249.98,utilities,out,Counterparty_40,21461689.25,2025-03-22,2025-04-20
2025-04-18,594.96,T&E,out,Counterparty_75,21461094.29,2025-04-02,2025-04-29
2025-04-18,3763.83,credit,in,Counterparty_12,21464858.12,,
2025-04-18,3803.24,customer_payment,in,Counterparty_70,21468661.36,,
2025-04-18,641.32,returned_ach,out,Counterparty_36,21468020.04,2025-03-26,2025-04-29
2025-04-18,15160.34,utilities,out,Counterparty_87,21452859.7,2025-03-13,2025-04-07
2025-04-18,2228.91,supplier_payment,out,Counterparty_13,21450630.79,2025-03-27,2025-04-27
2025-04-18,1105.93,supplier_payment,out,Counterparty_36,21449524.86,2025-03-27,2025-04-21
2025-04-18,2489.58,credit,in,Counterparty_42,21452014.44,,
2025-04-18,1638.72,payroll,out,Counterparty_72,21450375.72,2025-03-21,2025-04-18
2025-04-18,172.62,rent,out,Counterparty_76,21450203.1,2025-03-15,2025-04-12
2025-04-18,3287.71,refund,in,Counterparty_52,21453490.81,,
2025-04-18,9474.06,refund,in,Counterparty_17,21462964.87,,
2025-04-18,8353.13,investment_income,in,Counterparty_48,21471318.0,,
2025-04-18,13.26,payroll,out,Counterparty_48,21471304.74,2025-04-01,2025-05-08
2025-04-18,1743.2,customer_payment,in,Counterparty_39,21473047.94,,
2025-04-18,701.82,refund,in,Counterparty_31,21473749.76,,
2025-04-18,3360.0,tax_payment,out,Counterparty_40,21470389.76,2025-03-15,2025-04-18
2025-04-18,584.37,asset_sale,in,Counterparty_38,21470974.13,,
2025-04-18,5022.36,marketing_spend,out,Counterparty_30,21465951.77,2025-03-27,2025-05-04
2025-04-18,4251.42,utilities,out,Counterparty_78,21461700.35,2025-03-14,2025-04-10
2025-04-18,1981.66,supplier_payment,out,Counterparty_1,21459718.69,2025-04-01,2025-05-08
2025-04-18,16322.39,investment_income,in,Counterparty_90,21476041.08,,
2025-04-18,110.95,marketing_spend,out,Counterparty_93,21475930.13,2025-03-06,2025-04-12
2025-04-18,4947.23,utilities,out,Counterparty_63,21470982.9,2025-03-31,2025-05-09
2025-04-18,9090.89,credit,in,Counterparty_79,21480073.79,,
2025-04-18,243.04,refund,in,Counterparty_21,21480316.83,,
2025-04-18,606.36,credit,in,Counterparty_87,21480923.19,,
2025-04-18,286.18,refund,in,Counterparty_59,21481209.37,,
2025-04-18,7349.17,loan_repayment,out,Counterparty_62,21473860.2,2025-03-20,2025-04-22
2025-04-18,1768.1,refund,in,Counterparty_20,21475628.3,,
2025-04-18,10503.56,utilities,out,Counterparty_15,21465124.74,2025-03-15,2025-04-13
2025-04-18,436.29,marketing_spend,out,Counterparty_7,21464688.45,2025-03-20,2025-04-26
2025-04-18,15467.97,tax_payment,out,Counterparty_81,21449220.48,2025-03-18,2025-04-21
2025-04-18,6678.1,refund,in,Counterparty_6,21455898.58,,
2025-04-18,785.24,supplier_payment,out,Counterparty_59,21455113.34,2025-04-03,2025-05-07
2025-04-18,943.99,T&E,out,Counterparty_93,21454169.35,2025-03-15,2025-04-14
2025-04-18,5636.51,tax_payment,out,Counterparty_32,21448532.84,2025-03-31,2025-05-01
2025-04-19,3705.21,T&E,out,Counterparty_29,21444827.63,2025-03-21,2025-04-16
2025-04-19,6094.74,investment_income,in,Counterparty_8,21450922.37,,
2025-04-19,5353.28,supplier_payment,out,Counterparty_27,21445569.09,2025-03-24,2025-04-18
2025-04-19,3731.46,T&E,out,Counterparty_5,21441837.63,2025-03-28,2025-05-03
2025-04-19,131.21,rent,out,Counterparty_64,21441706.42,2025-03-30,2025-05-07
2025-04-19,195.41,investment_income,in,Counterparty_75,21441901.83,,
2025-04-19,2563.45,utilities,out,Counterparty_37,21439338.38,2025-03-17,2025-04-20
2025-04-19,9640.25,refund,in,Counterparty_7,21448978.63,,
2025-04-19,8114.36,T&E,out,Counterparty_48,21440864.27,2025-04-04,2025-05-12
2025-04-19,3994.28,credit,in,Counterparty_53,21444858.55,,
2025-04-19,1163.41,refund,in,Counterparty_10,21446021.96,,
2025-04-19,5105.33,refund,in,Counterparty_43,21451127.29,,
2025-04-19,16790.05,asset_sale,in,Counterparty_20,21467917.34,,
2025-04-19,1654.25,credit,in,Counterparty_24,21469571.59,,
2025-04-19,1505.87,software_subscription,out,Counterparty_17,21468065.72,2025-04-01,2025-05-09
2025-04-19,947.1,loan_repayment,out,Counterparty_70,21467118.62,2025-04-04,2025-05-02
2025-04-19,8015.45,payroll,out,Counterparty_51,21459103.17,2025-03-31,2025-05-07
2025-04-19,1011.04,utilities,out,Counterparty_23,21458092.13,2025-03-19,2025-04-26
2025-04-19,11639.44,investment_income,in,Counterparty_80,21469731.57,,
2025-04-19,294.69,asset_sale,in,Counterparty_38,21470026.26,,
2025-04-19,1.71,utilities,out,Counterparty_33,21470024.55,2025-03-11,2025-04-11
2025-04-19,3380.43,marketing_spend,out,Counterparty_86,21466644.12,2025-03-31,2025-05-05
2025-04-19,877.23,supplier_payment,out,Counterparty_75,21465766.89,2025-04-01,2025-05-01
2025-04-19,4152.93,T&E,out,Counterparty_6,21461613.96,2025-03-14,2025-04-09
2025-04-19,3767.43,loan_repayment,out,Counterparty_24,21457846.53,2025-03-20,2025-04-19
2025-04-19,2380.03,payroll,out,Counterparty_71,21455466.5,2025-03-21,2025-04-21
2025-04-19,6255.72,marketing_spend,out,Counterparty_74,21449210.78,2025-03-06,2025-04-03
2025-04-19,2285.57,rent,out,Counterparty_24,21446925.21,2025-03-12,2025-04-08
2025-04-19,232.34,asset_sale,in,Counterparty_19,21447157.55,,
2025-04-19,744.45,payroll,out,Counterparty_51,21446413.1,2025-03-22,2025-04-21
2025-04-19,11215.55,investment_income,in,Counterparty_66,21457628.65,,
2025-04-19,3721.72,credit,in,Counterparty_50,21461350.37,,
2025-04-19,3382.38,marketing_spend,out,Counterparty_52,21457967.99,2025-03-17,2025-04-22
2025-04-19,8355.03,payroll,out,Counterparty_71,21449612.96,2025-03-07,2025-04-09
2025-04-19,334.4,payroll,out,Counterparty_98,21449278.56,2025-03-30,2025-05-04
2025-04-19,126.15,loan_repayment,out,Counterparty_47,21449152.41,2025-03-18,2025-04-12
2025-04-19,1342.39,utilities,out,Counterparty_53,21447810.02,2025-04-01,2025-05-01
2025-04-19,3038.43,refund,in,Counterparty_40,21450848.45,,
2025-04-19,2376.06,customer_payment,in,Counterparty_30,21453224.51,,
2025-04-19,1935.84,asset_sale,in,Counterparty_96,21455160.35,,
2025-04-19,715.86,refund,in,Counterparty_66,21455876.21,,
2025-04-19,857.69,tax_payment,out,Counterparty_23,21455018.52,2025-03-21,2025-04-29
2025-04-19,1245.82,refund,in,Counterparty_58,21456264.34,,
2025-04-19,2405.14,marketing_spend,out,Counterparty_99,21453859.2,2025-03-12,2025-04-16
2025-04-19,542.72,software_subscription,out,Counterparty_74,21453316.48,2025-03-07,2025-04-09
2025-04-20,268.55,investment_income,in,Counterparty_38,21453585.03,,
2025-04-20,2669.8,T&E,out,Counterparty_52,21450915.23,2025-03-14,2025-04-17
2025-04-20,841.99,utilities,out,Counterparty_48,21450073.24,2025-03-31,2025-05-05
2025-04-20,454.46,investment_income,in,Counterparty_61,21450527.7,,
2025-04-20,1864.84,investment_income,in,Counterparty_4,21452392.54,,
2025-04-20,8920.87,refund,in,Counterparty_61,21461313.41,,
2025-04-20,1758.28,credit,in,Counterparty_29,21463071.69,,
2025-04-20,344.35,utilities,out,Counterparty_34,21462727.34,2025-04-04,2025-05-10
2025-04-20,8138.21,customer_payment,in,Counterparty_36,21470865.55,,
2025-04-20,6317.29,T&E,out,Counterparty_62,21464548.26,2025-03-17,2025-04-22
2025-04-20,630.42,credit,in,Counterparty_93,21465178.68,,
2025-04-20,5030.83,loan_repayment,out,Counterparty_87,21460147.85,2025-03-11,2025-04-15
2025-04-20,6644.39,customer_payment,in,Counterparty_98,21466792.24,,
2025-04-20,2408.23,utilities,out,Counterparty_50,21464384.01,2025-03-10,2025-04-14
2025-04-20,9585.97,marketing_spend,out,Counterparty_44,21454798.04,2025-03-29,2025-04-30
2025-04-20,436.76,refund,in,Counterparty_90,21455234.8,,
2025-04-20,4369.52,investment_income,in,Counterparty_89,21459604.32,,
2025-04-20,2558.12,customer_payment,in,Counterparty_43,21462162.44,,
2025-04-20,5579.13,investment_income,in,Counterparty_52,21467741.57,,
2025-04-20,814.41,rent,out,Counterparty_58,21466927.16,2025-04-02,2025-04-28
2025-04-20,617.92,refund,in,Counterparty_37,21467545.08,,
2025-04-20,7532.08,asset_sale,in,Counterparty_50,21475077.16,,
2025-04-20,4934.21,tax_payment,out,Counterparty_68,21470142.95,2025-03-26,2025-04-27
2025-04-20,4656.57,loan_repayment,out,Counterparty_66,21465486.38,2025-03-28,2025-04-28
2025-04-20,1482.11,tax_payment,out,Counterparty_26,21464004.27,2025-03-20,2025-04-23
2025-04-20,4134.16,utilities,out,Counterparty_33,21459870.11,2025-03-09,2025-04-14
2025-04-20,756.28,loan_repayment,out,Counterparty_9,21459113.83,2025-03-23,2025-04-26
2025-04-20,590.77,asset_sale,in,Counterparty_43,21459704.6,,
2025-04-20,1691.86,tax_payment,out,Counterparty_39,21458012.74,2025-03-11,2025-04-13
2025-04-20,2024.13,utilities,out,Counterparty_11,21455988.61,2025-03-27,2025-04-29
2025-04-20,2519.29,credit,in,Counterparty_83,21458507.9,,
2025-04-20,2083.69,customer_payment,in,Counterparty_23,21460591.59,,
2025-04-20,637.19,refund,in,Counterparty_21,21461228.78,,
2025-04-20,523.04,marketing_spend,out,Counterparty_23,21460705.74,2025-04-02,2025-04-29
2025-04-20,3822.44,refund,in,Counterparty_95,21464528.18,,
2025-04-20,1325.08,asset_sale,in,Counterparty_95,21465853.26,,
2025-04-21,2405.62,software_subscription,out,Counterparty_23,21463447.64,2025-03-28,2025-04-24
2025-04-21,27285.9,asset_sale,in,Counterparty_23,21490733.54,,
2025-04-21,5624.23,loan_repayment,out,Counterparty_68,21485109.31,2025-03-14,2025-04-15
2025-04-21,783.44,T&E,out,Counterparty_72,21484325.87,2025-03-31,2025-05-02
2025-04-21,7125.09,payroll,out,Counterparty_79,21477200.78,2025-03-11,2025-04-16
2025-04-21,3294.58,supplier_payment,out,Counterparty_55,21473906.2,2025-03-15,2025-04-12
2025-04-21,834.74,customer_payment,in,Counterparty_49,21474740.94,,
2025-04-21,717.64,customer_payment,in,Counterparty_92,21475458.58,,
2025-04-21,4315.85,credit,in,Counterparty_17,21479774.43,,
2025-04-21,7635.41,investment_income,in,Counterparty_76,21487409.84,,
2025-04-21,1092.62,supplier_payment,out,Counterparty_34,21486317.22,2025-03-27,2025-04-24
2025-04-21,3053.19,tax_payment,out,Counterparty_27,21483264.03,2025-03-22,2025-04-26
2025-04-21,2670.76,payroll,out,Counterparty_39,21480593.27,2025-03-22,2025-04-23
2025-04-21,6317.19,credit,in,Counterparty_37,21486910.46,,
2025-04-21,5213.41,rent,out,Counterparty_6,21481697.05,2025-04-03,2025-04-29
2025-04-21,4819.72,refund,in,Counterparty_46,21486516.77,,
2025-04-21,7590.55,rent,out,Counterparty_50,21478926.22,2025-03-10,2025-04-14
2025-04-21,2022.69,refund,in,Counterparty_31,21480948.91,,
2025-04-21,2111.04,utilities,out,Counterparty_59,21478837.87,2025-03-17,2025-04-11
2025-04-21,1023.98,rent,out,Counterparty_33,21477813.89,2025-03-16,2025-04-12
2025-04-21,1553.12,rent,out,Counterparty_28,21476260.77,2025-03-17,2025-04-11
2025-04-21,5504.16,T&E,out,Counterparty_10,21470756.61,2025-04-01,2025-05-04
2025-04-21,6458.62,utilities,out,Counterparty_42,21464297.99,2025-03-15,2025-04-11
2025-04-21,2505.56,payroll,out,Counterparty_87,21461792.43,2025-04-01,2025-05-05
2025-04-21,376.78,rent,out,Counterparty_89,21461415.65,2025-04-05,2025-05-13
2025-04-21,1683.97,investment_income,in,Counterparty_11,21463099.62,,
2025-04-21,5063.55,tax_payment,out,Counterparty_84,21458036.07,2025-03-14,2025-04-15
2025-04-21,2824.94,investment_income,in,Counterparty_18,21460861.01,,
2025-04-21,1629.3,credit,in,Counterparty_75,21462490.31,,
2025-04-21,1203.75,utilities,out,Counterparty_14,21461286.56,2025-03-21,2025-04-17
2025-04-21,3145.15,loan_repayment,out,Counterparty_59,21458141.41,2025-03-31,2025-05-03
2025-04-21,498.47,marketing_spend,out,Counterparty_28,21457642.94,2025-04-04,2025-05-05
2025-04-21,1565.63,customer_payment,in,Counterparty_66,21459208.57,,
2025-04-21,1286.86,loan_repayment,out,Counterparty_45,21457921.71,2025-03-25,2025-05-01
2025-04-21,555.84,asset_sale,in,Counterparty_59,21458477.55,,
2025-04-21,2136.69,rent,out,Counterparty_12,21456340.86,2025-03-25,2025-04-26
2025-04-21,1736.5,asset_sale,in,Counterparty_83,21458077.36,,
2025-04-21,1615.2,refund,in,Counterparty_39,21459692.56,,
2025-04-21,1715.16,loan_repayment,out,Counterparty_46,21457977.4,2025-03-30,2025-04-26
2025-04-21,214.86,supplier_payment,out,Counterparty_79,21457762.54,2025-03-31,2025-04-30
2025-04-22,2235.44,customer_payment,in,Counterparty_48,21459997.98,,
2025-04-22,2073.25,T&E,out,Counterparty_10,21457924.73,2025-04-02,2025-05-01
2025-04-22,8366.45,software_subscription,out,Counterparty_37,21449558.28,2025-03-09,2025-04-15
2025-04-22,1513.35,customer_payment,in,Counterparty_28,21451071.63,,
2025-04-22,1399.51,credit,in,Counterparty_1,21452471.14,,
2025-04-22,2647.24,T&E,out,Counterparty_6,21449823.9,2025-03-16,2025-04-23
2025-04-22,793.02,customer_payment,in,Counterparty_5,21450616.92,,
2025-04-22,1153.11,asset_sale,in,Counterparty_31,21451770.03,,
2025-04-22,681.13,customer_payment,in,Counterparty_60,21452451.16,,
2025-04-22,770.89,payroll,out,Counterparty_94,21451680.27,2025-03-10,2025-04-16
2025-04-22,3458.42,supplier_payment,out,Counterparty_31,21448221.85,2025-04-06,2025-05-02
2025-04-22,281.72,rent,out,Counterparty_71,21447940.13,2025-03-18,2025-04-19
2025-04-22,11209.77,customer_payment,in,Counterparty_12,21459149.9,,
2025-04-22,5974.75,payroll,out,Counterparty_82,21453175.15,2025-03-22,2025-04-16
2025-04-22,1161.2,loan_repayment,out,Counterparty_10,21452013.95,2025-03-18,2025-04-16
2025-04-22,10965.73,asset_sale,in,Counterparty_80,21462979.68,,
2025-04-22,3421.72,refund,in,Counterparty_62,21466401.4,,
2025-04-22,12465.01,investment_income,in,Counterparty_89,21478866.41,,
2025-04-22,564.74,refund,in,Counterparty_79,21479431.15,,
2025-04-22,378.47,rent,out,Counterparty_5,21479052.68,2025-04-02,2025-05-04
2025-04-22,1764.98,credit,in,Counterparty_53,21480817.66,,
2025-04-22,410.59,investment_income,in,Counterparty_48,21481228.25,,
2025-04-22,3040.87,payroll,out,Counterparty_52,21478187.38,2025-03-13,2025-04-18
2025-04-22,937.99,credit,in,Counterparty_81,21479125.37,,
2025-04-22,288.41,supplier_payment,out,Counterparty_75,21478836.96,2025-03-31,2025-05-08
2025-04-22,964.58,refund,in,Counterparty_39,21479801.54,,
2025-04-22,929.55,asset_sale,in,Counterparty_33,21480731.09,,
2025-04-22,9214.73,asset_sale,in,Counterparty_53,21489945.82,,
2025-04-22,1795.4,customer_payment,in,Counterparty_28,21491741.22,,
2025-04-22,9038.03,customer_payment,in,Counterparty_32,21500779.25,,
2025-04-22,3759.46,T&E,out,Counterparty_40,21497019.79,2025-03-26,2025-05-02
2025-04-22,4311.59,software_subscription,out,Counterparty_29,21492708.2,2025-03-17,2025-04-24
2025-04-22,1291.71,loan_repayment,out,Counterparty_71,21491416.49,2025-03-31,2025-04-30
2025-04-23,1404.01,investment_income,in,Counterparty_55,21492820.5,,
2025-04-23,3436.38,investment_income,in,Counterparty_50,21496256.88,,
2025-04-23,2303.66,utilities,out,Counterparty_30,21493953.22,2025-03-11,2025-04-06
2025-04-23,3760.04,customer_payment,in,Counterparty_86,21497713.26,,
2025-04-23,785.9,investment_income,in,Counterparty_89,21498499.16,,
2025-04-23,1090.89,refund,in,Counterparty_60,21499590.05,,
2025-04-23,7225.43,credit,in,Counterparty_63,21506815.48,,
2025-04-23,3618.02,supplier_payment,out,Counterparty_86,21503197.46,2025-03-10,2025-04-13
2025-04-23,2239.21,payroll,out,Counterparty_19,21500958.25,2025-04-03,2025-05-05
2025-04-23,1076.0,tax_payment,out,Counterparty_32,21499882.25,2025-03-11,2025-04-14
2025-04-23,4266.17,refund,in,Counterparty_66,21504148.42,,
2025-04-23,1440.88,loan_repayment,out,Counterparty_9,21502707.54,2025-03-20,2025-04-19
2025-04-23,4305.45,supplier_payment,out,Counterparty_28,21498402.09,2025-03-31,2025-05-07
2025-04-23,909.53,software_subscription,out,Counterparty_16,21497492.56,2025-03-29,2025-04-25
2025-04-23,6892.83,credit,in,Counterparty_59,21504385.39,,
2025-04-23,606.9,tax_payment,out,Counterparty_18,21503778.49,2025-03-12,2025-04-12
2025-04-23,1858.05,utilities,out,Counterparty_10,21501920.44,2025-03-16,2025-04-11
2025-04-23,161.71,marketing_spend,out,Counterparty_83,21501758.73,2025-03-25,2025-04-26
2025-04-23,4747.87,refund,in,Counterparty_39,21506506.6,,
2025-04-23,3134.37,utilities,out,Counterparty_93,21503372.23,2025-04-07,2025-05-15
2025-04-23,2851.57,T&E,out,Counterparty_94,21500520.66,2025-03-22,2025-04-26
2025-04-23,1858.43,supplier_payment,out,Counterparty_98,21498662.23,2025-04-03,2025-05-05
2025-04-23,3795.59,credit,in,Counterparty_5,21502457.82,,
2025-04-23,318.75,supplier_payment,out,Counterparty_32,21502139.07,2025-03-13,2025-04-16
2025-04-23,7083.81,rent,out,Counterparty_93,21495055.26,2025-03-25,2025-04-27
2025-04-23,2317.18,refund,in,Counterparty_29,21497372.44,,
2025-04-23,357.32,tax_payment,out,Counterparty_41,21497015.12,2025-04-08,2025-05-09
2025-04-23,315.84,utilities,out,Counterparty_23,21496699.28,2025-03-31,2025-04-27
2025-04-23,798.79,payroll,out,Counterparty_18,21495900.49,2025-04-08,2025-05-05
2025-04-23,800.68,rent,out,Counterparty_67,21495099.81,2025-04-03,2025-05-08
2025-04-23,3544.67,marketing_spend,out,Counterparty_30,21491555.14,2025-03-19,2025-04-23
2025-04-23,6337.79,customer_payment,in,Counterparty_10,21497892.93,,
2025-04-23,2494.74,investment_income,in,Counterparty_48,21500387.67,,
2025-04-23,8551.79,refund,in,Counterparty_90,21508939.46,,
2025-04-23,6519.78,rent,out,Counterparty_54,21502419.68,2025-04-04,2025-04-30
2025-04-23,2167.99,payroll,out,Counterparty_78,21500251.69,2025-03-12,2025-04-14
2025-04-23,2467.09,T&E,out,Counterparty_53,21497784.6,2025-04-03,2025-05-06
2025-04-23,1728.26,asset_sale,in,Counterparty_25,21499512.86,,
2025-04-23,1292.12,tax_payment,out,Counterparty_44,21498220.74,2025-04-02,2025-05-10
2025-04-23,397.23,refund,in,Counterparty_79,21498617.97,,
2025-04-23,1401.46,customer_payment,in,Counterparty_16,21500019.43,,
2025-04-23,2317.09,asset_sale,in,Counterparty_24,21502336.52,,
2025-04-23,9436.34,rent,out,Counterparty_78,21492900.18,2025-04-06,2025-05-01
2025-04-23,4172.21,asset_sale,in,Counterparty_40,21497072.39,,
2025-04-23,1214.65,software_subscription,out,Counterparty_84,21495857.74,2025-03-15,2025-04-12
2025-04-23,4343.43,supplier_payment,out,Counterparty_4,21491514.31,2025-03-29,2025-05-05
2025-04-23,1842.28,software_subscription,out,Counterparty_5,21489672.03,2025-03-19,2025-04-24
2025-04-23,1093.19,asset_sale,in,Counterparty_46,21490765.22,,
2025-04-23,9582.17,supplier_payment,out,Counterparty_43,21481183.05,2025-03-24,2025-04-25
2025-04-23,374.33,utilities,out,Counterparty_61,21480808.72,2025-03-17,2025-04-16
2025-04-23,7361.39,software_subscription,out,Counterparty_2,21473447.33,2025-03-25,2025-04-27
2025-04-23,4179.2,rent,out,Counterparty_66,21469268.13,2025-04-03,2025-05-08
2025-04-23,511.31,marketing_spend,out,Counterparty_80,21468756.82,2025-03-16,2025-04-20
2025-04-23,639.46,rent,out,Counterparty_73,21468117.36,2025-03-15,2025-04-19
2025-04-24,2695.17,loan_repayment,out,Counterparty_2,21465422.19,2025-03-19,2025-04-26
2025-04-24,11093.83,rent,out,Counterparty_76,21454328.36,2025-03-30,2025-05-06
2025-04-24,1239.62,loan_repayment,out,Counterparty_58,21453088.74,2025-03-24,2025-04-23
2025-04-24,5541.02,rent,out,Counterparty_91,21447547.72,2025-03-27,2025-04-24
2025-04-24,2295.85,payroll,out,Counterparty_89,21445251.87,2025-03-27,2025-04-27
2025-04-24,551.85,refund,in,Counterparty_29,21445803.72,,
2025-04-24,3727.2,payroll,out,Counterparty_41,21442076.52,2025-04-05,2025-05-06
2025-04-24,979.81,customer_payment,in,Counterparty_4,21443056.33,,
2025-04-24,1509.56,tax_payment,out,Counterparty_10,21441546.77,2025-03-12,2025-04-11
2025-04-24,420.98,utilities,out,Counterparty_37,21441125.79,2025-03-25,2025-04-24
2025-04-24,5144.67,utilities,out,Counterparty_95,21435981.12,2025-04-01,2025-05-04
2025-04-24,5588.15,loan_repayment,out,Counterparty_51,21430392.97,2025-03-31,2025-05-06
2025-04-24,1632.11,investment_income,in,Counterparty_95,21432025.08,,
2025-04-24,5528.69,customer_payment,in,Counterparty_29,21437553.77,,
2025-04-24,7967.12,software_subscription,out,Counterparty_68,21429586.65,2025-04-04,2025-05-05
2025-04-24,2666.78,credit,in,Counterparty_74,21432253.43,,
2025-04-24,4489.33,customer_payment,in,Counterparty_39,21436742.76,,
2025-04-24,726.44,refund,in,Counterparty_78,21437469.2,,
2025-04-24,3101.68,customer_payment,in,Counterparty_5,21440570.88,,
2025-04-24,3615.94,utilities,out,Counterparty_15,21436954.94,2025-03-12,2025-04-20
2025-04-24,5166.04,supplier_payment,out,Counterparty_97,21431788.9,2025-04-02,2025-05-03
2025-04-24,8642.77,supplier_payment,out,Counterparty_76,21423146.13,2025-03-14,2025-04-17
2025-04-24,14115.95,tax_payment,out,Counterparty_13,21409030.18,2025-04-06,2025-05-12
2025-04-24,688.92,investment_income,in,Counterparty_93,21409719.1,,
2025-04-24,3104.39,payroll,out,Counterparty_50,21406614.71,2025-03-14,2025-04-08
2025-04-24,3334.3,investment_income,in,Counterparty_96,21409949.01,,
2025-04-24,3007.02,loan_repayment,out,Counterparty_12,21406941.99,2025-03-21,2025-04-26
2025-04-24,3686.78,investment_income,in,Counterparty_38,21410628.77,,
2025-04-24,3942.21,credit,in,Counterparty_29,21414570.98,,
2025-04-24,5514.44,tax_payment,out,Counterparty_40,21409056.54,2025-04-09,2025-05-04
2025-04-24,5142.83,asset_sale,in,Counterparty_74,21414199.37,,
2025-04-24,4459.99,tax_payment,out,Counterparty_31,21409739.38,2025-04-04,2025-05-11
2025-04-24,2177.16,payroll,out,Counterparty_94,21407562.22,2025-03-24,2025-04-19
2025-04-24,1865.89,software_subscription,out,Counterparty_16,21405696.33,2025-03-22,2025-04-25
2025-04-24,4190.14,utilities,out,Counterparty_22,21401506.19,2025-03-28,2025-04-24
2025-04-24,969.69,customer_payment,in,Counterparty_63,21402475.88,,
2025-04-24,387.99,refund,in,Counterparty_77,21402863.87,,
2025-04-25,1090.35,supplier_payment,out,Counterparty_11,21401773.52,2025-04-10,2025-05-06
2025-04-25,14771.46,investment_income,in,Counterparty_26,21416544.98,,
2025-04-25,7162.19,payroll,out,Counterparty_5,21409382.79,2025-03-22,2025-04-23
2025-04-25,7705.16,investment_income,in,Counterparty_82,21417087.95,,
2025-04-25,859.45,utilities,out,Counterparty_55,21416228.5,2025-03-31,2025-04-29
2025-04-25,484.59,loan_repayment,out,Counterparty_76,21415743.91,2025-03-25,2025-04-20
2025-04-25,868.67,customer_payment,in,Counterparty_9,21416612.58,,
2025-04-25,604.01,loan_repayment,out,Counterparty_94,21416008.57,2025-03-19,2025-04-27
2025-04-25,8864.76,utilities,out,Counterparty_29,21407143.81,2025-03-13,2025-04-17
2025-04-25,2176.75,refund,in,Counterparty_3,21409320.56,,
2025-04-25,3572.29,credit,in,Counterparty_2,21412892.85,,
2025-04-25,1151.97,payroll,out,Counterparty_67,21411740.88,2025-03-14,2025-04-11
2025-04-25,3611.66,T&E,out,Counterparty_81,21408129.22,2025-03-15,2025-04-16
2025-04-25,848.71,refund,in,Counterparty_44,21408977.93,,
2025-04-25,5.79,customer_payment,in,Counterparty_36,21408983.72,,
2025-04-25,845.07,customer_payment,in,Counterparty_72,21409828.79,,
2025-04-25,8046.69,customer_payment,in,Counterparty_39,21417875.48,,
2025-04-25,2508.92,software_subscription,out,Counterparty_11,21415366.56,2025-03-21,2025-04-15
2025-04-25,1636.42,asset_sale,in,Counterparty_15,21417002.98,,
2025-04-25,243.55,software_subscription,out,Counterparty_23,21416759.43,2025-03-15,2025-04-15
2025-04-25,1018.33,supplier_payment,out,Counterparty_57,21415741.1,2025-04-05,2025-05-02
2025-04-25,5554.24,credit,in,Counterparty_30,21421295.34,,
2025-04-25,5974.1,loan_repayment,out,Counterparty_92,21415321.24,2025-03-28,2025-04-30
2025-04-25,181.29,credit,in,Counterparty_41,21415502.53,,
2025-04-25,5266.73,customer_payment,in,Counterparty_33,21420769.26,,
2025-04-25,22251.82,loan_repayment,out,Counterparty_43,21398517.44,2025-03-13,2025-04-21
2025-04-25,1992.61,payroll,out,Counterparty_66,21396524.83,2025-03-14,2025-04-16
2025-04-25,2984.4,tax_payment,out,Counterparty_59,21393540.43,2025-04-06,2025-05-07
2025-04-25,636.81,tax_payment,out,Counterparty_91,21392903.62,2025-04-02,2025-05-06
2025-04-25,875.07,supplier_payment,out,Counterparty_24,21392028.55,2025-03-29,2025-04-23
2025-04-25,2226.67,asset_sale,in,Counterparty_27,21394255.22,,
2025-04-25,5318.45,credit,in,Counterparty_83,21399573.67,,
2025-04-25,1469.11,utilities,out,Counterparty_66,21398104.56,2025-03-15,2025-04-23
2025-04-25,8584.05,utilities,out,Counterparty_69,21389520.51,2025-03-13,2025-04-12
2025-04-25,3773.04,payroll,out,Counterparty_38,21385747.47,2025-03-31,2025-04-28
2025-04-25,1871.93,investment_income,in,Counterparty_91,21387619.4,,
2025-04-25,1079.66,T&E,out,Counterparty_24,21386539.74,2025-03-28,2025-04-27
2025-04-26,628.29,refund,in,Counterparty_89,21387168.03,,
2025-04-26,4457.78,credit,in,Counterparty_64,21391625.81,,
2025-04-26,15084.13,customer_payment,in,Counterparty_15,21406709.94,,
2025-04-26,2889.4,marketing_spend,out,Counterparty_2,21403820.54,2025-04-09,2025-05-12
2025-04-26,3225.19,payroll,out,Counterparty_90,21400595.35,2025-03-15,2025-04-14
2025-04-26,660.09,credit,in,Counterparty_46,21401255.44,,
2025-04-26,8146.6,refund,in,Counterparty_29,21409402.04,,
2025-04-26,8060.13,T&E,out,Counterparty_52,21401341.91,2025-03-16,2025-04-19
2025-04-26,824.3,marketing_spend,out,Counterparty_93,21400517.61,2025-03-30,2025-04-26
2025-04-26,270.28,rent,out,Counterparty_17,21400247.33,2025-04-11,2025-05-20
2025-04-26,2469.25,T&E,out,Counterparty_8,21397778.08,2025-04-02,2025-04-28
2025-04-26,891.24,refund,in,Counterparty_68,21398669.32,,
2025-04-26,131.06,credit,in,Counterparty_65,21398800.38,,
2025-04-26,16572.22,credit,in,Counterparty_21,21415372.6,,
2025-04-26,1329.93,utilities,out,Counterparty_8,21414042.67,2025-04-09,2025-05-08
2025-04-26,666.41,investment_income,in,Counterparty_6,21414709.08,,
2025-04-26,3329.47,refund,in,Counterparty_66,21418038.55,,
2025-04-26,1472.25,credit,in,Counterparty_82,21419510.8,,
2025-04-26,5235.76,credit,in,Counterparty_22,21424746.56,,
2025-04-26,4974.85,refund,in,Counterparty_70,21429721.41,,
2025-04-26,4457.08,marketing_spend,out,Counterparty_47,21425264.33,2025-03-13,2025-04-08
2025-04-26,1770.18,loan_repayment,out,Counterparty_33,21423494.15,2025-04-08,2025-05-13
2025-04-26,2272.92,investment_income,in,Counterparty_62,21425767.07,,
2025-04-26,736.37,refund,in,Counterparty_13,21426503.44,,
2025-04-26,4106.18,rent,out,Counterparty_91,21422397.26,2025-04-05,2025-05-05
2025-04-26,3587.01,asset_sale,in,Counterparty_99,21425984.27,,
2025-04-26,328.73,refund,in,Counterparty_43,21426313.0,,
2025-04-26,785.53,investment_income,in,Counterparty_48,21427098.53,,
2025-04-26,365.07,rent,out,Counterparty_23,21426733.46,2025-03-19,2025-04-13
2025-04-26,424.66,T&E,out,Counterparty_77,21426308.8,2025-03-14,2025-04-17
2025-04-26,7.32,payroll,out,Counterparty_98,21426301.48,2025-03-15,2025-04-19
2025-04-26,4836.56,asset_sale,in,Counterparty_54,21431138.04,,
2025-04-26,253.96,refund,in,Counterparty_72,21431392.0,,
2025-04-26,4277.34,marketing_spend,out,Counterparty_59,21427114.66,2025-03-16,2025-04-22
2025-04-26,5383.73,T&E,out,Counterparty_19,21421730.93,2025-03-20,2025-04-15
2025-04-26,530.27,customer_payment,in,Counterparty_46,21422261.2,,
2025-04-26,3582.07,supplier_payment,out,Counterparty_57,21418679.13,2025-04-07,2025-05-08
2025-04-26,1677.55,refund,in,Counterparty_44,21420356.68,,
2025-04-26,1729.89,tax_payment,out,Counterparty_22,21418626.79,2025-04-03,2025-05-10
2025-04-26,1558.53,credit,in,Counterparty_70,21420185.32,,
2025-04-26,2311.25,loan_repayment,out,Counterparty_79,21417874.07,2025-04-09,2025-05-08
2025-04-26,2482.83,payroll,out,Counterparty_78,21415391.24,2025-04-06,2025-05-11
2025-04-26,3204.6,software_subscription,out,Counterparty_81,21412186.64,2025-03-18,2025-04-21
2025-04-26,2941.16,refund,in,Counterparty_45,21415127.8,,
2025-04-26,272.72,customer_payment,in,Counterparty_62,21415400.52,,
2025-04-26,959.47,investment_income,in,Counterparty_48,21416359.99,,
2025-04-26,1402.4,software_subscription,out,Counterparty_29,21414957.59,2025-03-31,2025-04-25
2025-04-26,8541.81,refund,in,Counterparty_70,21423499.4,,
2025-04-26,570.58,rent,out,Counterparty_91,21422928.82,2025-04-09,2025-05-12
2025-04-26,2142.35,supplier_payment,out,Counterparty_40,21420786.47,2025-03-20,2025-04-20
2025-04-26,14204.28,T&E,out,Counterparty_8,21406582.19,2025-03-13,2025-04-13
2025-04-26,4937.91,investment_income,in,Counterparty_48,21411520.1,,
2025-04-26,4231.77,asset_sale,in,Counterparty_74,21415751.87,,
2025-04-27,5266.88,customer_payment,in,Counterparty_46,21421018.75,,
2025-04-27,512.39,customer_payment,in,Counterparty_57,21421531.14,,
2025-04-27,600.06,rent,out,Counterparty_96,21420931.08,2025-03-24,2025-04-27
2025-04-27,2497.32,credit,in,Counterparty_63,21423428.4,,
2025-04-27,10367.02,asset_sale,in,Counterparty_2,21433795.42,,
2025-04-27,757.13,customer_payment,in,Counterparty_99,21434552.55,,
2025-04-27,13835.35,credit,in,Counterparty_32,21448387.9,,
2025-04-27,1138.58,payroll,out,Counterparty_63,21447249.32,2025-03-28,2025-05-04
2025-04-27,71.33,customer_payment,in,Counterparty_5,21447320.65,,
2025-04-27,3818.43,software_subscription,out,Counterparty_7,21443502.22,2025-04-03,2025-05-05
2025-04-27,4965.46,customer_payment,in,Counterparty_80,21448467.68,,
2025-04-27,1286.22,refund,in,Counterparty_7,21449753.9,,
2025-04-27,4.47,utilities,out,Counterparty_40,21449749.43,2025-04-07,2025-05-11
2025-04-27,2371.18,customer_payment,in,Counterparty_24,21452120.61,,
2025-04-27,13069.99,utilities,out,Counterparty_3,21439050.62,2025-03-30,2025-05-04
2025-04-27,701.68,rent,out,Counterparty_19,21438348.94,2025-03-24,2025-04-25
2025-04-27,389.35,loan_repayment,out,Counterparty_90,21437959.59,2025-03-22,2025-04-30
2025-04-27,9059.51,investment_income,in,Counterparty_12,21447019.1,,
2025-04-27,625.27,utilities,out,Counterparty_96,21446393.83,2025-03-29,2025-05-06
2025-04-27,1914.39,customer_payment,in,Counterparty_70,21448308.22,,
2025-04-27,1588.15,supplier_payment,out,Counterparty_20,21446720.07,2025-04-04,2025-05-11
2025-04-27,5291.63,rent,out,Counterparty_54,21441428.44,2025-04-10,2025-05-18
2025-04-27,101.69,T&E,out,Counterparty_89,21441326.75,2025-03-30,2025-05-02
2025-04-27,1209.77,supplier_payment,out,Counterparty_63,21440116.98,2025-03-17,2025-04-14
2025-04-27,1631.73,refund,in,Counterparty_11,21441748.71,,
2025-04-27,10062.43,credit,in,Counterparty_96,21451811.14,,
2025-04-27,16984.28,credit,in,Counterparty_37,21468795.42,,
2025-04-27,2832.81,payroll,out,Counterparty_41,21465962.61,2025-04-03,2025-05-01
2025-04-27,457.5,credit,in,Counterparty_42,21466420.11,,
2025-04-27,3485.45,loan_repayment,out,Counterparty_37,21462934.66,2025-04-10,2025-05-18
2025-04-27,830.93,T&E,out,Counterparty_2,21462103.73,2025-03-27,2025-04-22
2025-04-27,591.78,marketing_spend,out,Counterparty_27,21461511.95,2025-04-02,2025-05-05
2025-04-27,6478.96,T&E,out,Counterparty_98,21455032.99,2025-04-08,2025-05-12
2025-04-27,364.64,T&E,out,Counterparty_13,21454668.35,2025-03-15,2025-04-15
2025-04-27,2492.19,rent,out,Counterparty_27,21452176.16,2025-03-27,2025-04-25
2025-04-27,878.61,customer_payment,in,Counterparty_69,21453054.77,,
2025-04-27,2376.71,T&E,out,Counterparty_50,21450678.06,2025-03-14,2025-04-08
2025-04-27,472.34,refund,in,Counterparty_93,21451150.4,,
2025-04-27,1151.6,customer_payment,in,Counterparty_55,21452302.0,,
2025-04-27,1852.86,payroll,out,Counterparty_73,21450449.14,2025-04-12,2025-05-13
2025-04-27,3500.27,marketing_spend,out,Counterparty_30,21446948.87,2025-04-01,2025-04-29
2025-04-27,85.28,loan_repayment,out,Counterparty_53,21446863.59,2025-04-08,2025-05-08
2025-04-27,9605.77,asset_sale,in,Counterparty_21,21456469.36,,
2025-04-27,8.21,utilities,out,Counterparty_31,21456461.15,2025-04-02,2025-05-01
2025-04-27,4053.96,software_subscription,out,Counterparty_92,21452407.19,2025-03-28,2025-04-29
2025-04-27,9761.35,supplier_payment,out,Counterparty_33,21442645.84,2025-03-15,2025-04-17
2025-04-27,7455.25,marketing_spend,out,Counterparty_42,21435190.59,2025-04-12,2025-05-15
2025-04-27,6277.28,investment_income,in,Counterparty_47,21441467.87,,
2025-04-27,1415.31,asset_sale,in,Counterparty_43,21442883.18,,
2025-04-27,4420.87,loan_repayment,out,Counterparty_49,21438462.31,2025-03-22,2025-04-17
2025-04-28,2092.22,utilities,out,Counterparty_35,21436370.09,2025-03-19,2025-04-24
2025-04-28,1558.31,utilities,out,Counterparty_16,21434811.78,2025-03-24,2025-04-28
2025-04-28,8261.88,payroll,out,Counterparty_2,21426549.9,2025-03-22,2025-04-24
2025-04-28,74.93,loan_repayment,out,Counterparty_88,21426474.97,2025-03-26,2025-05-03
2025-04-28,472.71,payroll,out,Counterparty_6,21426002.26,2025-04-01,2025-05-02
2025-04-28,1860.1,marketing_spend,out,Counterparty_68,21424142.16,2025-03-23,2025-04-26
2025-04-28,4710.77,loan_repayment,out,Counterparty_89,21419431.39,2025-04-13,2025-05-11
2025-04-28,1486.22,returned_ach,out,Counterparty_19,21417945.17,2025-03-23,2025-04-24
2025-04-28,281.38,investment_income,in,Counterparty_71,21418226.55,,
2025-04-28,1579.93,rent,out,Counterparty_79,21416646.62,2025-04-13,2025-05-15
2025-04-28,1314.07,credit,in,Counterparty_53,21417960.69,,
2025-04-28,2914.34,marketing_spend,out,Counterparty_96,21415046.35,2025-03-26,2025-04-20
2025-04-28,2808.17,credit,in,Counterparty_82,21417854.52,,
2025-04-28,3500.1,rent,out,Counterparty_20,21414354.42,2025-03-15,2025-04-16
2025-04-28,2584.24,asset_sale,in,Counterparty_88,21416938.66,,
2025-04-28,15816.42,customer_payment,in,Counterparty_23,21432755.08,,
2025-04-28,7941.48,loan_repayment,out,Counterparty_86,21424813.6,2025-03-27,2025-05-01
2025-04-28,11311.22,credit,in,Counterparty_70,21436124.82,,
2025-04-28,10086.81,T&E,out,Counterparty_28,21426038.01,2025-03-22,2025-04-29
2025-04-28,29717.74,supplier_payment,out,Counterparty_49,21396320.27,2025-03-15,2025-04-15
2025-04-28,776.99,investment_income,in,Counterparty_67,21397097.26,,
2025-04-28,1732.98,asset_sale,in,Counterparty_15,21398830.24,,
2025-04-28,506.11,utilities,out,Counterparty_51,21398324.13,2025-04-08,2025-05-03
2025-04-28,3558.05,customer_payment,in,Counterparty_59,21401882.18,,
2025-04-28,2471.58,supplier_payment,out,Counterparty_40,21399410.6,2025-04-02,2025-04-29
2025-04-28,161.69,refund,in,Counterparty_82,21399572.29,,
2025-04-28,1020.24,software_subscription,out,Counterparty_55,21398552.05,2025-03-27,2025-05-02
2025-04-28,2774.25,marketing_spend,out,Counterparty_78,21395777.8,2025-03-29,2025-05-05
2025-04-28,2247.51,loan_repayment,out,Counterparty_91,21393530.29,2025-03-18,2025-04-17
2025-04-28,17346.69,credit,in,Counterparty_70,21410876.98,,
2025-04-28,2717.88,customer_payment,in,Counterparty_79,21413594.86,,
2025-04-28,1848.1,refund,in,Counterparty_23,21415442.96,,
2025-04-28,4719.51,payroll,out,Counterparty_94,21410723.45,2025-04-05,2025-05-12
2025-04-28,2525.54,asset_sale,in,Counterparty_76,21413248.99,,
2025-04-28,982.44,refund,in,Counterparty_32,21414231.43,,
2025-04-28,7389.51,customer_payment,in,Counterparty_45,21421620.94,,
2025-04-28,956.87,customer_payment,in,Counterparty_17,21422577.81,,
2025-04-28,2680.09,credit,in,Counterparty_47,21425257.9,,
2025-04-28,3723.16,loan_repayment,out,Counterparty_10,21421534.74,2025-04-12,2025-05-19
2025-04-28,3542.91,asset_sale,in,Counterparty_65,21425077.65,,
2025-04-28,1069.31,rent,out,Counterparty_89,21424008.34,2025-03-20,2025-04-27
2025-04-28,2943.81,customer_payment,in,Counterparty_75,21426952.15,,
2025-04-28,259.16,refund,in,Counterparty_3,21427211.31,,
2025-04-28,1446.08,refund,in,Counterparty_90,21428657.39,,
2025-04-28,5650.88,T&E,out,Counterparty_13,21423006.51,2025-04-07,2025-05-02
2025-04-28,127.16,rent,out,Counterparty_41,21422879.35,2025-03-15,2025-04-20
2025-04-28,1749.29,supplier_payment,out,Counterparty_77,21421130.06,2025-04-09,2025-05-08
2025-04-29,715.81,investment_income,in,Counterparty_81,21421845.87,,
2025-04-29,15898.13,refund,in,Counterparty_86,21437744.0,,
2025-04-29,4107.97,refund,in,Counterparty_3,21441851.97,,
2025-04-29,1427.81,investment_income,in,Counterparty_66,21443279.78,,
2025-04-29,658.35,investment_income,in,Counterparty_56,21443938.13,,
2025-04-29,2050.68,asset_sale,in,Counterparty_87,21445988.81,,
2025-04-29,8263.15,credit,in,Counterparty_47,21454251.96,,
2025-04-29,2881.28,payroll,out,Counterparty_22,21451370.68,2025-04-01,2025-05-04
2025-04-29,430.13,software_subscription,out,Counterparty_16,21450940.55,2025-03-28,2025-04-24
2025-04-29,2014.46,supplier_payment,out,Counterparty_24,21448926.09,2025-03-19,2025-04-26
2025-04-29,2510.98,loan_repayment,out,Counterparty_90,21446415.11,2025-03-23,2025-04-22
2025-04-29,2937.29,utilities,out,Counterparty_17,21443477.82,2025-04-03,2025-04-29
2025-04-29,1450.02,T&E,out,Counterparty_32,21442027.8,2025-04-02,2025-05-02
2025-04-29,4181.35,tax_payment,out,Counterparty_95,21437846.45,2025-04-01,2025-05-09
2025-04-29,1019.6,software_subscription,out,Counterparty_90,21436826.85,2025-04-06,2025-05-11
2025-04-29,1165.47,marketing_spend,out,Counterparty_54,21435661.38,2025-04-13,2025-05-12
2025-04-29,236.8,refund,in,Counterparty_95,21435898.18,,
2025-04-29,79.2,payroll,out,Counterparty_19,21435818.98,2025-03-17,2025-04-16
2025-04-29,2060.67,investment_income,in,Counterparty_8,21437879.65,,
2025-04-29,4297.44,refund,in,Counterparty_55,21442177.09,,
2025-04-29,4477.19,supplier_payment,out,Counterparty_58,21437699.9,2025-04-13,2025-05-10
2025-04-29,3342.1,software_subscription,out,Counterparty_84,21434357.8,2025-03-29,2025-04-30
2025-04-29,983.4,utilities,out,Counterparty_87,21433374.4,2025-04-08,2025-05-04
2025-04-29,6210.9,refund,in,Counterparty_8,21439585.3,,
2025-04-29,1037.35,payroll,out,Counterparty_51,21438547.95,2025-03-20,2025-04-25
2025-04-29,2849.27,marketing_spend,out,Counterparty_24,21435698.68,2025-03-28,2025-04-30
2025-04-29,1956.26,rent,out,Counterparty_16,21433742.42,2025-03-16,2025-04-24
2025-04-29,13709.42,supplier_payment,out,Counterparty_81,21420033.0,2025-03-23,2025-04-29
2025-04-29,558.36,marketing_spend,out,Counterparty_43,21419474.64,2025-04-03,2025-05-11
2025-04-29,6755.94,T&E,out,Counterparty_19,21412718.7,2025-04-11,2025-05-18
2025-04-29,919.86,supplier_payment,out,Counterparty_82,21411798.84,2025-03-18,2025-04-20
2025-04-29,4106.33,utilities,out,Counterparty_19,21407692.51,2025-04-03,2025-05-05
2025-04-29,1031.76,customer_payment,in,Counterparty_91,21408724.27,,
2025-04-29,8021.82,investment_income,in,Counterparty_78,21416746.09,,
2025-04-29,219.89,payroll,out,Counterparty_2,21416526.2,2025-04-12,2025-05-15
2025-04-30,7487.46,investment_income,in,Counterparty_67,21424013.66,,
2025-04-30,1074.28,customer_payment,in,Counterparty_92,21425087.94,,
2025-04-30,587.25,T&E,out,Counterparty_65,21424500.69,2025-04-06,2025-05-06
2025-04-30,936.53,credit,in,Counterparty_94,21425437.22,,
2025-04-30,1152.48,credit,in,Counterparty_34,21426589.7,,
2025-04-30,2785.71,investment_income,in,Counterparty_75,21429375.41,,
2025-04-30,521.67,investment_income,in,Counterparty_42,21429897.08,,
2025-04-30,1342.68,tax_payment,out,Counterparty_66,21428554.4,2025-04-11,2025-05-20
2025-04-30,1921.21,loan_repayment,out,Counterparty_97,21426633.19,2025-03-30,2025-04-28
2025-04-30,19121.42,investment_income,in,Counterparty_19,21445754.61,,
2025-04-30,178.96,loan_repayment,out,Counterparty_81,21445575.65,2025-04-07,2025-05-16
2025-04-30,8652.7,rent,out,Counterparty_26,21436922.95,2025-03-22,2025-04-30
2025-04-30,849.3,T&E,out,Counterparty_13,21436073.65,2025-04-08,2025-05-04
2025-04-30,2135.04,payroll,out,Counterparty_7,21433938.61,2025-03-30,2025-04-30
2025-04-30,777.52,rent,out,Counterparty_52,21433161.09,2025-04-01,2025-05-04
2025-04-30,1016.29,T&E,out,Counterparty_59,21432144.8,2025-03-31,2025-05-06
2025-04-30,1791.77,loan_repayment,out,Counterparty_6,21430353.03,2025-04-01,2025-04-30
2025-04-30,4952.37,payroll,out,Counterparty_44,21425400.66,2025-03-30,2025-04-29
2025-04-30,226.98,utilities,out,Counterparty_13,21425173.68,2025-03-23,2025-04-28
2025-04-30,6180.59,T&E,out,Counterparty_41,21418993.09,2025-03-26,2025-04-27
2025-04-30,847.31,payroll,out,Counterparty_51,21418145.78,2025-04-04,2025-05-10
2025-04-30,2146.97,marketing_spend,out,Counterparty_84,21415998.81,2025-04-04,2025-04-29
2025-04-30,544.7,credit,in,Counterparty_3,21416543.51,,
2025-04-30,2787.63,customer_payment,in,Counterparty_66,21419331.14,,
2025-04-30,73.58,asset_sale,in,Counterparty_62,21419404.72,,
2025-04-30,13493.39,customer_payment,in,Counterparty_5,21432898.11,,
2025-04-30,1049.75,credit,in,Counterparty_13,21433947.86,,
2025-04-30,2450.73,asset_sale,in,Counterparty_6,21436398.59,,
2025-04-30,2768.7,investment_income,in,Counterparty_25,21439167.29,,
2025-04-30,450.53,tax_payment,out,Counterparty_53,21438716.76,2025-04-01,2025-05-02
2025-04-30,3067.37,refund,in,Counterparty_26,21441784.13,,
2025-04-30,6125.23,refund,in,Counterparty_70,21447909.36,,
2025-05-01,505.45,customer_payment,in,Counterparty_89,21448414.81,,
2025-05-01,1523.48,credit,in,Counterparty_31,21449938.29,,
2025-05-01,798.93,utilities,out,Counterparty_7,21449139.36,2025-04-13,2025-05-13
2025-05-01,2599.83,payroll,out,Counterparty_35,21446539.53,2025-03-29,2025-04-23
2025-05-01,3074.36,tax_payment,out,Counterparty_3,21443465.17,2025-04-14,2025-05-12
2025-05-01,996.66,marketing_spend,out,Counterparty_6,21442468.51,2025-03-22,2025-04-21
2025-05-01,4058.71,tax_payment,out,Counterparty_34,21438409.8,2025-04-08,2025-05-17
2025-05-01,1534.14,loan_repayment,out,Counterparty_12,21436875.66,2025-04-06,2025-05-01
2025-05-01,462.34,payroll,out,Counterparty_60,21436413.32,2025-04-14,2025-05-17
2025-05-01,2713.28,asset_sale,in,Counterparty_14,21439126.6,,
2025-05-01,5553.94,asset_sale,in,Counterparty_75,21444680.54,,
2025-05-01,1175.33,software_subscription,out,Counterparty_97,21443505.21,2025-03-25,2025-05-01
2025-05-01,71.59,supplier_payment,out,Counterparty_68,21443433.62,2025-03-26,2025-04-30
2025-05-01,7017.96,credit,in,Counterparty_10,21450451.58,,
2025-05-01,661.89,software_subscription,out,Counterparty_82,21449789.69,2025-04-15,2025-05-13
2025-05-01,1720.86,T&E,out,Counterparty_8,21448068.83,2025-04-06,2025-05-11
2025-05-01,6394.43,asset_sale,in,Counterparty_40,21454463.26,,
2025-05-01,2005.53,T&E,out,Counterparty_53,21452457.73,2025-03-24,2025-04-22
2025-05-01,3374.2,refund,in,Counterparty_80,21455831.93,,
2025-05-01,2923.92,utilities,out,Counterparty_5,21452908.01,2025-03-21,2025-04-16
2025-05-01,413.81,rent,out,Counterparty_29,21452494.2,2025-04-02,2025-05-11
2025-05-01,1238.18,supplier_payment,out,Counterparty_76,21451256.02,2025-03-30,2025-05-06
2025-05-01,5915.85,supplier_payment,out,Counterparty_14,21445340.17,2025-03-21,2025-04-20
2025-05-01,337.02,asset_sale,in,Counterparty_82,21445677.19,,
2025-05-01,4195.34,investment_income,in,Counterparty_77,21449872.53,,
2025-05-01,110.17,T&E,out,Counterparty_21,21449762.36,2025-04-02,2025-05-02
2025-05-01,10503.5,payroll,out,Counterparty_11,21439258.86,2025-04-06,2025-05-10
2025-05-01,210.45,asset_sale,in,Counterparty_26,21439469.31,,
2025-05-01,686.74,T&E,out,Counterparty_38,21438782.57,2025-03-31,2025-04-29
2025-05-01,772.56,utilities,out,Counterparty_71,21438010.01,2025-04-09,2025-05-16
2025-05-01,163.64,tax_payment,out,Counterparty_30,21437846.37,2025-04-08,2025-05-08
2025-05-01,1097.88,utilities,out,Counterparty_95,21436748.49,2025-04-01,2025-05-10
2025-05-01,2069.7,T&E,out,Counterparty_7,21434678.79,2025-04-13,2025-05-08
2025-05-01,2981.31,asset_sale,in,Counterparty_85,21437660.1,,
2025-05-01,5912.74,supplier_payment,out,Counterparty_22,21431747.36,2025-04-07,2025-05-05
2025-05-01,291.03,rent,out,Counterparty_26,21431456.33,2025-03-25,2025-04-28
2025-05-01,2985.41,asset_sale,in,Counterparty_92,21434441.74,,
2025-05-01,1754.8,utilities,out,Counterparty_22,21432686.94,2025-04-14,2025-05-22
2025-05-01,16.75,rent,out,Counterparty_26,21432670.19,2025-04-02,2025-05-10
2025-05-01,1117.85,software_subscription,out,Counterparty_9,21431552.34,2025-03-28,2025-04-28
2025-05-01,7512.99,asset_sale,in,Counterparty_72,21439065.33,,
2025-05-01,401.17,customer_payment,in,Counterparty_28,21439466.5,,
2025-05-01,1833.18,loan_repayment,out,Counterparty_24,21437633.32,2025-04-15,2025-05-24
2025-05-01,1375.53,tax_payment,out,Counterparty_16,21436257.79,2025-03-29,2025-05-04
2025-05-01,1906.41,tax_payment,out,Counterparty_89,21434351.38,2025-04-09,2025-05-04
2025-05-01,5733.07,T&E,out,Counterparty_80,21428618.31,2025-03-23,2025-04-27
2025-05-01,222.8,loan_repayment,out,Counterparty_96,21428395.51,2025-03-28,2025-04-26
2025-05-01,2256.82,refund,in,Counterparty_24,21430652.33,,
2025-05-01,793.88,payroll,out,Counterparty_72,21429858.45,2025-04-15,2025-05-15
2025-05-01,628.0,T&E,out,Counterparty_24,21429230.45,2025-04-12,2025-05-11
2025-05-01,468.58,marketing_spend,out,Counterparty_19,21428761.87,2025-04-15,2025-05-16
2025-05-01,8510.27,T&E,out,Counterparty_63,21420251.6,2025-04-04,2025-05-13
2025-05-01,3018.23,customer_payment,in,Counterparty_50,21423269.83,,
2025-05-01,2875.23,payroll,out,Counterparty_67,21420394.6,2025-04-08,2025-05-09
2025-05-01,1167.27,T&E,out,Counterparty_67,21419227.33,2025-03-25,2025-04-19
2025-05-01,1876.89,rent,out,Counterparty_2,21417350.44,2025-03-23,2025-04-21
2025-05-01,1504.64,tax_payment,out,Counterparty_78,21415845.8,2025-04-14,2025-05-11
2025-05-01,252.03,refund,in,Counterparty_30,21416097.83,,
2025-05-01,1151.53,software_subscription,out,Counterparty_25,21414946.3,2025-04-02,2025-05-06
2025-05-01,140.96,T&E,out,Counterparty_57,21414805.34,2025-03-29,2025-04-26
2025-05-01,2360.45,tax_payment,out,Counterparty_22,21412444.89,2025-04-11,2025-05-06
2025-05-01,740.72,tax_payment,out,Counterparty_98,21411704.17,2025-03-26,2025-04-30
2025-05-01,905.34,investment_income,in,Counterparty_13,21412609.51,,
2025-05-01,40.96,supplier_payment,out,Counterparty_30,21412568.55,2025-04-05,2025-05-06
2025-05-01,2304.9,software_subscription,out,Counterparty_34,21410263.65,2025-03-23,2025-04-23
2025-05-01,568.24,payroll,out,Counterparty_88,21409695.41,2025-04-02,2025-04-27
2025-05-01,1242.86,marketing_spend,out,Counterparty_47,21408452.55,2025-03-18,2025-04-22
2025-05-01,5658.93,investment_income,in,Counterparty_82,21414111.48,,
2025-05-01,425.12,payroll,out,Counterparty_99,21413686.36,2025-04-06,2025-05-11
2025-05-01,466.95,investment_income,in,Counterparty_6,21414153.31,,
2025-05-01,4743.3,marketing_spend,out,Counterparty_86,21409410.01,2025-03-29,2025-05-04
2025-05-01,297.65,investment_income,in,Counterparty_71,21409707.66,,
2025-05-01,21.81,marketing_spend,out,Counterparty_33,21409685.85,2025-04-06,2025-05-11
2025-05-01,352.38,asset_sale,in,Counterparty_94,21410038.23,,
2025-05-01,1330.38,customer_payment,in,Counterparty_78,21411368.61,,
2025-05-01,2127.56,asset_sale,in,Counterparty_50,21413496.17,,
2025-05-01,1362.96,investment_income,in,Counterparty_52,21414859.13,,
2025-05-01,1206.43,tax_payment,out,Counterparty_29,21413652.7,2025-03-23,2025-04-29
2025-05-01,1680.18,tax_payment,out,Counterparty_32,21411972.52,2025-04-08,2025-05-15
2025-05-01,1534.18,utilities,out,Counterparty_12,21410438.34,2025-04-05,2025-05-12
2025-05-01,2474.59,loan_repayment,out,Counterparty_97,21407963.75,2025-04-16,2025-05-19
2025-05-02,2042.29,tax_payment,out,Counterparty_34,21405921.46,2025-04-16,2025-05-14
2025-05-02,1570.89,asset_sale,in,Counterparty_24,21407492.35,,
2025-05-02,381.87,loan_repayment,out,Counterparty_60,21407110.48,2025-03-19,2025-04-14
2025-05-02,4272.88,utilities,out,Counterparty_29,21402837.6,2025-03-27,2025-05-01
2025-05-02,4757.38,tax_payment,out,Counterparty_49,21398080.22,2025-04-11,2025-05-06
2025-05-02,1661.36,loan_repayment,out,Counterparty_91,21396418.86,2025-04-05,2025-05-03
2025-05-02,4584.04,customer_payment,in,Counterparty_31,21401002.9,,
2025-05-02,2923.6,rent,out,Counterparty_68,21398079.3,2025-04-13,2025-05-15
2025-05-02,90.47,rent,out,Counterparty_91,21397988.83,2025-04-14,2025-05-23
2025-05-02,338.49,loan_repayment,out,Counterparty_69,21397650.34,2025-03-30,2025-04-27
2025-05-02,2240.1,supplier_payment,out,Counterparty_19,21395410.24,2025-03-26,2025-04-27
2025-05-02,1262.11,rent,out,Counterparty_48,21394148.13,2025-04-08,2025-05-07
2025-05-02,256.08,loan_repayment,out,Counterparty_65,21393892.05,2025-04-14,2025-05-09
2025-05-02,2411.91,loan_repayment,out,Counterparty_73,21391480.14,2025-03-25,2025-04-30
2025-05-02,1978.97,credit,in,Counterparty_85,21393459.11,,
2025-05-02,842.75,asset_sale,in,Counterparty_14,21394301.86,,
2025-05-02,3802.65,customer_payment,in,Counterparty_65,21398104.51,,
2025-05-02,997.46,supplier_payment,out,Counterparty_82,21397107.05,2025-04-04,2025-05-05
2025-05-02,484.26,T&E,out,Counterparty_65,21396622.79,2025-03-20,2025-04-15
2025-05-02,4203.97,customer_payment,in,Counterparty_2,21400826.76,,
2025-05-02,578.45,loan_repayment,out,Counterparty_32,21400248.31,2025-03-25,2025-05-03
2025-05-02,6.81,investment_income,in,Counterparty_43,21400255.12,,
2025-05-02,3266.23,tax_payment,out,Counterparty_70,21396988.89,2025-04-09,2025-05-04
2025-05-02,888.03,asset_sale,in,Counterparty_14,21397876.92,,
2025-05-02,1766.98,asset_sale,in,Counterparty_82,21399643.9,,
2025-05-02,3622.26,credit,in,Counterparty_56,21403266.16,,
2025-05-02,628.97,marketing_spend,out,Counterparty_14,21402637.19,2025-04-05,2025-05-03
2025-05-02,1070.32,supplier_payment,out,Counterparty_45,21401566.87,2025-04-07,2025-05-13
2025-05-02,2990.69,rent,out,Counterparty_39,21398576.18,2025-03-30,2025-05-08
2025-05-02,205.03,credit,in,Counterparty_17,21398781.21,,
2025-05-02,4076.77,software_subscription,out,Counterparty_74,21394704.44,2025-04-04,2025-05-04
2025-05-02,3320.92,rent,out,Counterparty_47,21391383.52,2025-03-30,2025-05-02
2025-05-02,1626.77,utilities,out,Counterparty_67,21389756.75,2025-03-19,2025-04-20
2025-05-02,8.78,loan_repayment,out,Counterparty_14,21389747.97,2025-04-12,2025-05-20
2025-05-02,2132.44,asset_sale,in,Counterparty_88,21391880.41,,
2025-05-02,980.99,customer_payment,in,Counterparty_32,21392861.4,,
2025-05-02,831.67,credit,in,Counterparty_13,21393693.07,,
2025-05-02,1213.92,investment_income,in,Counterparty_22,21394906.99,,
2025-05-02,1953.64,investment_income,in,Counterparty_37,21396860.63,,
2025-05-02,3734.16,refund,in,Counterparty_20,21400594.79,,
2025-05-02,664.9,tax_payment,out,Counterparty_49,21399929.89,2025-04-09,2025-05-18
2025-05-02,2164.01,asset_sale,in,Counterparty_2,21402093.9,,
2025-05-02,920.84,investment_income,in,Counterparty_8,21403014.74,,
2025-05-02,763.47,rent,out,Counterparty_23,21402251.27,2025-03-22,2025-04-23
2025-05-02,2170.87,asset_sale,in,Counterparty_4,21404422.14,,
2025-05-02,427.61,credit,in,Counterparty_48,21404849.75,,
2025-05-02,2131.29,T&E,out,Counterparty_67,21402718.46,2025-03-23,2025-04-26
2025-05-02,1024.88,refund,in,Counterparty_20,21403743.34,,
2025-05-02,1588.96,credit,in,Counterparty_87,21405332.3,,
2025-05-02,3168.11,credit,in,Counterparty_61,21408500.41,,
2025-05-02,3430.63,marketing_spend,out,Counterparty_66,21405069.78,2025-04-11,2025-05-17
2025-05-02,1750.36,software_subscription,out,Counterparty_23,21403319.42,2025-04-10,2025-05-15
2025-05-02,3751.99,tax_payment,out,Counterparty_44,21399567.43,2025-04-15,2025-05-12
2025-05-02,4061.14,investment_income,in,Counterparty_51,21403628.57,,
2025-05-02,1055.65,marketing_spend,out,Counterparty_8,21402572.92,2025-03-27,2025-05-04
2025-05-02,1987.49,tax_payment,out,Counterparty_58,21400585.43,2025-04-04,2025-05-04
2025-05-02,574.45,supplier_payment,out,Counterparty_48,21400010.98,2025-03-19,2025-04-20
2025-05-02,2752.6,rent,out,Counterparty_77,21397258.38,2025-04-04,2025-05-09
2025-05-02,1103.24,payroll,out,Counterparty_97,21396155.14,2025-03-31,2025-04-28
2025-05-02,8389.2,refund,in,Counterparty_62,21404544.34,,
2025-05-02,280.67,software_subscription,out,Counterparty_54,21404263.67,2025-03-29,2025-05-03
2025-05-02,2084.34,T&E,out,Counterparty_40,21402179.33,2025-04-09,2025-05-04
2025-05-02,5238.53,investment_income,in,Counterparty_1,21407417.86,,
2025-05-02,538.86,T&E,out,Counterparty_48,21406879.0,2025-03-31,2025-05-08
2025-05-02,1619.55,investment_income,in,Counterparty_39,21408498.55,,
2025-05-02,730.63,software_subscription,out,Counterparty_70,21407767.92,2025-04-10,2025-05-06
2025-05-02,1001.93,supplier_payment,out,Counterparty_56,21406765.99,2025-04-16,2025-05-14
2025-05-02,2075.16,supplier_payment,out,Counterparty_66,21404690.83,2025-04-12,2025-05-21
2025-05-02,655.39,rent,out,Counterparty_74,21404035.44,2025-04-08,2025-05-07
2025-05-03,7966.54,refund,in,Counterparty_56,21412001.98,,
2025-05-03,1004.78,marketing_spend,out,Counterparty_25,21410997.2,2025-03-28,2025-05-04
2025-05-03,2831.22,tax_payment,out,Counterparty_25,21408165.98,2025-03-23,2025-04-22
2025-05-03,574.78,marketing_spend,out,Counterparty_12,21407591.2,2025-04-16,2025-05-24
2025-05-03,4397.99,credit,in,Counterparty_91,21411989.19,,
2025-05-03,3520.04,software_subscription,out,Counterparty_13,21408469.15,2025-04-02,2025-05-09
2025-05-03,2302.84,customer_payment,in,Counterparty_42,21410771.99,,
2025-05-03,10110.24,asset_sale,in,Counterparty_52,21420882.23,,
2025-05-03,984.56,investment_income,in,Counterparty_4,21421866.79,,
2025-05-03,3780.59,investment_income,in,Counterparty_94,21425647.38,,
2025-05-03,314.29,credit,in,Counterparty_18,21425961.67,,
2025-05-03,1304.85,asset_sale,in,Counterparty_25,21427266.52,,
2025-05-03,2032.58,investment_income,in,Counterparty_21,21429299.1,,
2025-05-03,4068.81,payroll,out,Counterparty_60,21425230.29,2025-04-02,2025-05-08
2025-05-03,410.51,supplier_payment,out,Counterparty_83,21424819.78,2025-04-17,2025-05-15
2025-05-03,5450.39,loan_repayment,out,Counterparty_44,21419369.39,2025-03-26,2025-04-21
2025-05-03,181.2,utilities,out,Counterparty_49,21419188.19,2025-04-07,2025-05-12
2025-05-03,3190.82,loan_repayment,out,Counterparty_23,21415997.37,2025-03-27,2025-04-27
2025-05-03,74.03,tax_payment,out,Counterparty_23,21415923.34,2025-04-14,2025-05-15
2025-05-03,834.96,credit,in,Counterparty_30,21416758.3,,
2025-05-03,1603.61,T&E,out,Counterparty_43,21415154.69,2025-04-02,2025-05-09
2025-05-03,486.55,tax_payment,out,Counterparty_49,21414668.14,2025-04-17,2025-05-14
2025-05-03,1603.65,refund,in,Counterparty_52,21416271.79,,
2025-05-03,499.02,rent,out,Counterparty_87,21415772.77,2025-04-18,2025-05-25
2025-05-03,2991.97,payroll,out,Counterparty_19,21412780.8,2025-04-10,2025-05-07
2025-05-03,92.65,T&E,out,Counterparty_74,21412688.15,2025-04-08,2025-05-03
2025-05-03,3016.35,utilities,out,Counterparty_7,21409671.8,2025-03-28,2025-05-05
2025-05-03,2603.75,refund,in,Counterparty_51,21412275.55,,
2025-05-03,673.87,asset_sale,in,Counterparty_33,21412949.42,,
2025-05-03,8334.72,customer_payment,in,Counterparty_75,21421284.14,,
2025-05-03,189.33,marketing_spend,out,Counterparty_79,21421094.81,2025-04-03,2025-05-02
2025-05-03,3101.31,software_subscription,out,Counterparty_98,21417993.5,2025-04-11,2025-05-16
2025-05-03,800.28,investment_income,in,Counterparty_22,21418793.78,,
2025-05-03,1643.57,T&E,out,Counterparty_38,21417150.21,2025-04-05,2025-05-06
2025-05-03,1849.56,customer_payment,in,Counterparty_75,21418999.77,,
2025-05-03,1518.57,software_subscription,out,Counterparty_10,21417481.2,2025-03-30,2025-04-26
2025-05-03,946.21,rent,out,Counterparty_98,21416534.99,2025-04-12,2025-05-18
2025-05-03,1108.44,asset_sale,in,Counterparty_70,21417643.43,,
2025-05-03,1462.46,marketing_spend,out,Counterparty_29,21416180.97,2025-03-24,2025-04-19
2025-05-03,1201.73,T&E,out,Counterparty_11,21414979.24,2025-03-30,2025-04-29
2025-05-03,621.42,utilities,out,Counterparty_94,21414357.82,2025-04-03,2025-05-12
2025-05-03,682.41,supplier_payment,out,Counterparty_42,21413675.41,2025-04-18,2025-05-13
2025-05-03,4159.93,asset_sale,in,Counterparty_35,21417835.34,,
2025-05-03,3007.63,rent,out,Counterparty_74,21414827.71,2025-04-16,2025-05-23
2025-05-03,4835.88,rent,out,Counterparty_2,21409991.83,2025-04-01,2025-05-04
2025-05-03,17.24,T&E,out,Counterparty_36,21409974.59,2025-04-04,2025-05-10
2025-05-03,782.63,tax_payment,out,Counterparty_29,21409191.96,2025-03-24,2025-04-24
2025-05-03,204.67,tax_payment,out,Counterparty_36,21408987.29,2025-03-31,2025-04-25
2025-05-03,1433.22,credit,in,Counterparty_58,21410420.51,,
2025-05-03,588.52,software_subscription,out,Counterparty_56,21409831.99,2025-04-09,2025-05-17
2025-05-03,230.61,rent,out,Counterparty_22,21409601.38,2025-04-02,2025-05-08
2025-05-03,3748.95,customer_payment,in,Counterparty_5,21413350.33,,
2025-05-03,1622.11,asset_sale,in,Counterparty_99,21414972.44,,
2025-05-03,3046.67,credit,in,Counterparty_85,21418019.11,,
2025-05-03,955.64,utilities,out,Counterparty_77,21417063.47,2025-04-11,2025-05-14
2025-05-03,11026.77,credit,in,Counterparty_81,21428090.24,,
2025-05-03,1867.6,utilities,out,Counterparty_72,21426222.64,2025-04-18,2025-05-14
2025-05-03,88.85,rent,out,Counterparty_28,21426133.79,2025-04-13,2025-05-14
2025-05-03,1059.82,customer_payment,in,Counterparty_21,21427193.61,,
2025-05-03,1965.81,supplier_payment,out,Counterparty_92,21425227.8,2025-04-05,2025-05-03
2025-05-03,228.19,marketing_spend,out,Counterparty_1,21424999.61,2025-04-16,2025-05-24
2025-05-04,5382.83,refund,in,Counterparty_10,21430382.44,,
2025-05-04,438.64,customer_payment,in,Counterparty_87,21430821.08,,
2025-05-04,2014.06,customer_payment,in,Counterparty_64,21432835.14,,
2025-05-04,101.35,payroll,out,Counterparty_53,21432733.79,2025-03-21,2025-04-26
2025-05-04,2180.48,tax_payment,out,Counterparty_12,21430553.31,2025-04-07,2025-05-02
2025-05-04,1120.93,loan_repayment,out,Counterparty_66,21429432.38,2025-04-07,2025-05-10
2025-05-04,2158.32,supplier_payment,out,Counterparty_2,21427274.06,2025-03-27,2025-04-29
2025-05-04,562.66,marketing_spend,out,Counterparty_57,21426711.4,2025-04-09,2025-05-15
2025-05-04,1936.95,customer_payment,in,Counterparty_99,21428648.35,,
2025-05-04,377.76,customer_payment,in,Counterparty_73,21429026.11,,
2025-05-04,4016.2,asset_sale,in,Counterparty_44,21433042.31,,
2025-05-04,376.45,software_subscription,out,Counterparty_87,21432665.86,2025-03-21,2025-04-22
2025-05-04,5195.59,utilities,out,Counterparty_70,21427470.27,2025-04-07,2025-05-09
2025-05-04,1817.33,refund,in,Counterparty_52,21429287.6,,
2025-05-04,3578.48,loan_repayment,out,Counterparty_72,21425709.12,2025-03-22,2025-04-20
2025-05-04,1024.17,utilities,out,Counterparty_11,21424684.95,2025-03-22,2025-04-19
2025-05-04,1711.04,asset_sale,in,Counterparty_74,21426395.99,,
2025-05-04,402.02,supplier_payment,out,Counterparty_13,21425993.97,2025-04-11,2025-05-18
2025-05-04,819.32,marketing_spend,out,Counterparty_78,21425174.65,2025-03-21,2025-04-16
2025-05-04,86.32,marketing_spend,out,Counterparty_14,21425088.33,2025-04-06,2025-05-01
2025-05-04,87.78,payroll,out,Counterparty_79,21425000.55,2025-04-01,2025-05-06
2025-05-04,6647.12,customer_payment,in,Counterparty_42,21431647.67,,
2025-05-04,1339.63,supplier_payment,out,Counterparty_57,21430308.04,2025-03-23,2025-04-26
2025-05-04,11129.98,asset_sale,in,Counterparty_11,21441438.02,,
2025-05-04,1238.73,T&E,out,Counterparty_46,21440199.29,2025-04-10,2025-05-14
2025-05-04,1413.29,T&E,out,Counterparty_34,21438786.0,2025-04-07,2025-05-12
2025-05-04,1611.44,marketing_spend,out,Counterparty_15,21437174.56,2025-04-05,2025-05-09
2025-05-04,1025.28,asset_sale,in,Counterparty_40,21438199.84,,
2025-05-04,63.77,tax_payment,out,Counterparty_79,21438136.07,2025-03-29,2025-05-05
2025-05-04,10959.04,tax_payment,out,Counterparty_43,21427177.03,2025-03-31,2025-04-29
2025-05-04,4887.82,customer_payment,in,Counterparty_65,21432064.85,,
2025-05-04,933.83,asset_sale,in,Counterparty_90,21432998.68,,
2025-05-04,61.69,utilities,out,Counterparty_18,21432936.99,2025-04-09,2025-05-14
2025-05-04,546.48,customer_payment,in,Counterparty_81,21433483.47,,
2025-05-04,4882.63,investment_income,in,Counterparty_53,21438366.1,,
2025-05-04,3501.14,customer_payment,in,Counterparty_89,21441867.24,,
2025-05-04,4317.78,software_subscription,out,Counterparty_21,21437549.46,2025-03-24,2025-04-28
2025-05-04,2992.71,marketing_spend,out,Counterparty_63,21434556.75,2025-04-08,2025-05-04
2025-05-04,3133.71,loan_repayment,out,Counterparty_77,21431423.04,2025-04-04,2025-05-04
2025-05-04,673.27,refund,in,Counterparty_15,21432096.31,,
2025-05-04,346.04,supplier_payment,out,Counterparty_3,21431750.27,2025-04-01,2025-05-09
2025-05-04,1418.09,marketing_spend,out,Counterparty_27,21430332.18,2025-04-02,2025-04-28
2025-05-04,1177.9,investment_income,in,Counterparty_77,21431510.08,,
2025-05-04,1228.94,asset_sale,in,Counterparty_32,21432739.02,,
2025-05-04,4675.27,rent,out,Counterparty_41,21428063.75,2025-03-31,2025-04-30
2025-05-04,1568.04,payroll,out,Counterparty_43,21426495.71,2025-03-23,2025-04-28
2025-05-04,2744.76,customer_payment,in,Counterparty_54,21429240.47,,
2025-05-04,761.64,investment_income,in,Counterparty_71,21430002.11,,
2025-05-04,3313.34,customer_payment,in,Counterparty_98,21433315.45,,
2025-05-04,2551.25,credit,in,Counterparty_21,21435866.7,,
2025-05-05,278.43,credit,in,Counterparty_76,21436145.13,,
2025-05-05,2103.52,T&E,out,Counterparty_54,21434041.61,2025-03-30,2025-04-25
2025-05-05,5664.64,credit,in,Counterparty_11,21439706.25,,
2025-05-05,455.54,asset_sale,in,Counterparty_68,21440161.79,,
2025-05-05,7303.78,refund,in,Counterparty_47,21447465.57,,
2025-05-05,29.97,refund,in,Counterparty_59,21447495.54,,
2025-05-05,471.46,supplier_payment,out,Counterparty_57,21447024.08,2025-03-25,2025-04-26
2025-05-05,2690.45,marketing_spend,out,Counterparty_55,21444333.63,2025-04-20,2025-05-21
2025-05-05,195.12,refund,in,Counterparty_78,21444528.75,,
2025-05-05,1322.1,investment_income,in,Counterparty_63,21445850.85,,
2025-05-05,2417.51,asset_sale,in,Counterparty_95,21448268.36,,
2025-05-05,318.04,payroll,out,Counterparty_72,21447950.32,2025-04-11,2025-05-11
2025-05-05,1558.76,rent,out,Counterparty_86,21446391.56,2025-04-09,2025-05-17
2025-05-05,210.67,marketing_spend,out,Counterparty_59,21446180.89,2025-04-09,2025-05-17
2025-05-05,37.83,asset_sale,in,Counterparty_78,21446218.72,,
2025-05-05,498.22,loan_repayment,out,Counterparty_89,21445720.5,2025-03-27,2025-05-02
2025-05-05,5427.24,refund,in,Counterparty_7,21451147.74,,
2025-05-05,127.49,rent,out,Counterparty_50,21451020.25,2025-04-07,2025-05-06
2025-05-05,216.74,tax_payment,out,Counterparty_77,21450803.51,2025-04-18,2025-05-15
2025-05-05,26.14,rent,out,Counterparty_96,21450777.37,2025-04-11,2025-05-20
2025-05-05,5420.72,customer_payment,in,Counterparty_44,21456198.09,,
2025-05-05,777.56,investment_income,in,Counterparty_76,21456975.65,,
2025-05-05,4145.95,payroll,out,Counterparty_11,21452829.7,2025-04-02,2025-05-05
2025-05-05,2927.88,asset_sale,in,Counterparty_84,21455757.58,,
2025-05-05,2712.29,utilities,out,Counterparty_90,21453045.29,2025-04-16,2025-05-20
2025-05-05,3822.35,investment_income,in,Counterparty_27,21456867.64,,
2025-05-05,5846.25,tax_payment,out,Counterparty_68,21451021.39,2025-03-30,2025-04-30
2025-05-05,1872.11,asset_sale,in,Counterparty_28,21452893.5,,
2025-05-05,793.85,software_subscription,out,Counterparty_29,21452099.65,2025-04-13,2025-05-12
2025-05-05,466.82,customer_payment,in,Counterparty_79,21452566.47,,
2025-05-05,2505.62,utilities,out,Counterparty_53,21450060.85,2025-04-07,2025-05-14
2025-05-05,1550.36,payroll,out,Counterparty_8,21448510.49,2025-04-02,2025-04-28
2025-05-05,1204.68,customer_payment,in,Counterparty_45,21449715.17,,
2025-05-05,4219.96,software_subscription,out,Counterparty_40,21445495.21,2025-04-14,2025-05-17
2025-05-05,948.58,supplier_payment,out,Counterparty_44,21444546.63,2025-04-15,2025-05-24
2025-05-05,1445.1,supplier_payment,out,Counterparty_23,21443101.53,2025-04-12,2025-05-12
2025-05-05,3156.12,supplier_payment,out,Counterparty_80,21439945.41,2025-04-05,2025-05-14
2025-05-05,1123.47,payroll,out,Counterparty_23,21438821.94,2025-04-16,2025-05-24
2025-05-05,510.89,loan_repayment,out,Counterparty_96,21438311.05,2025-04-09,2025-05-06
2025-05-05,1344.34,customer_payment,in,Counterparty_35,21439655.39,,
2025-05-05,73.07,marketing_spend,out,Counterparty_81,21439582.32,2025-04-09,2025-05-15
2025-05-05,393.54,refund,in,Counterparty_79,21439975.86,,
2025-05-05,1126.17,refund,in,Counterparty_97,21441102.03,,
2025-05-05,1275.76,payroll,out,Counterparty_90,21439826.27,2025-03-29,2025-04-24
2025-05-05,8127.45,customer_payment,in,Counterparty_18,21447953.72,,
2025-05-05,628.6,payroll,out,Counterparty_91,21447325.12,2025-04-09,2025-05-17
2025-05-05,1626.48,supplier_payment,out,Counterparty_55,21445698.64,2025-04-19,2025-05-14
2025-05-05,1351.89,rent,out,Counterparty_91,21444346.75,2025-04-18,2025-05-13
2025-05-05,680.44,loan_repayment,out,Counterparty_57,21443666.31,2025-03-22,2025-04-23
2025-05-05,818.15,payroll,out,Counterparty_61,21442848.16,2025-03-31,2025-04-28
2025-05-05,1124.15,refund,in,Counterparty_92,21443972.31,,
2025-05-05,1061.78,supplier_payment,out,Counterparty_34,21442910.53,2025-04-11,2025-05-20
2025-05-05,500.93,marketing_spend,out,Counterparty_65,21442409.6,2025-04-20,2025-05-19
2025-05-05,658.06,marketing_spend,out,Counterparty_13,21441751.54,2025-03-25,2025-04-24
2025-05-05,453.48,loan_repayment,out,Counterparty_86,21441298.06,2025-04-01,2025-05-07
2025-05-05,138.12,tax_payment,out,Counterparty_84,21441159.94,2025-04-08,2025-05-15
2025-05-05,1082.48,T&E,out,Counterparty_96,21440077.46,2025-04-15,2025-05-17
2025-05-05,1.38,software_subscription,out,Counterparty_98,21440076.08,2025-04-18,2025-05-24
2025-05-05,1462.1,tax_payment,out,Counterparty_7,21438613.98,2025-04-02,2025-05-10
2025-05-05,4266.77,loan_repayment,out,Counterparty_34,21434347.21,2025-04-10,2025-05-07
2025-05-05,6970.16,investment_income,in,Counterparty_43,21441317.37,,
2025-05-05,2291.64,supplier_payment,out,Counterparty_6,21439025.73,2025-03-29,2025-04-23
2025-05-05,1852.08,utilities,out,Counterparty_63,21437173.65,2025-04-19,2025-05-17
2025-05-05,397.96,credit,in,Counterparty_9,21437571.61,,
2025-05-05,125.74,rent,out,Counterparty_13,21437445.87,2025-03-27,2025-04-29
2025-05-05,1507.42,loan_repayment,out,Counterparty_32,21435938.45,2025-03-23,2025-04-18
2025-05-05,2082.06,payroll,out,Counterparty_44,21433856.39,2025-04-01,2025-05-01
2025-05-05,2729.43,refund,in,Counterparty_66,21436585.82,,
2025-05-05,1204.67,tax_payment,out,Counterparty_68,21435381.15,2025-03-30,2025-05-04
2025-05-05,4043.73,refund,in,Counterparty_98,21439424.88,,
2025-05-05,967.03,tax_payment,out,Counterparty_78,21438457.85,2025-03-29,2025-04-30
2025-05-05,3330.74,customer_payment,in,Counterparty_69,21441788.59,,
2025-05-05,3928.09,software_subscription,out,Counterparty_8,21437860.5,2025-04-13,2025-05-22
2025-05-05,4665.5,refund,in,Counterparty_85,21442526.0,,
2025-05-06,1139.66,marketing_spend,out,Counterparty_6,21441386.34,2025-03-31,2025-05-01
2025-05-06,2229.77,refund,in,Counterparty_42,21443616.11,,
2025-05-06,431.84,supplier_payment,out,Counterparty_97,21443184.27,2025-04-20,2025-05-15
2025-05-06,2270.64,credit,in,Counterparty_13,21445454.91,,
2025-05-06,846.8,marketing_spend,out,Counterparty_55,21444608.11,2025-04-17,2025-05-24
2025-05-06,1039.48,loan_repayment,out,Counterparty_67,21443568.63,2025-04-16,2025-05-14
2025-05-06,741.39,rent,out,Counterparty_25,21442827.24,2025-04-13,2025-05-11
2025-05-06,1134.58,payroll,out,Counterparty_20,21441692.66,2025-03-28,2025-04-23
2025-05-06,17198.39,refund,in,Counterparty_86,21458891.05,,
2025-05-06,789.71,tax_payment,out,Counterparty_73,21458101.34,2025-03-23,2025-04-19
2025-05-06,5147.49,customer_payment,in,Counterparty_20,21463248.83,,
2025-05-06,8253.4,asset_sale,in,Counterparty_81,21471502.23,,
2025-05-06,4386.73,customer_payment,in,Counterparty_91,21475888.96,,
2025-05-06,8275.01,payroll,out,Counterparty_55,21467613.95,2025-04-04,2025-05-12
2025-05-06,1533.74,utilities,out,Counterparty_65,21466080.21,2025-03-26,2025-04-25
2025-05-06,1776.54,investment_income,in,Counterparty_88,21467856.75,,
2025-05-06,2530.29,loan_repayment,out,Counterparty_7,21465326.46,2025-04-17,2025-05-13
2025-05-06,2767.85,investment_income,in,Counterparty_62,21468094.31,,
2025-05-06,271.52,credit,in,Counterparty_24,21468365.83,,
2025-05-06,79.88,supplier_payment,out,Counterparty_88,21468285.95,2025-04-02,2025-05-09
2025-05-06,137.35,customer_payment,in,Counterparty_67,21468423.3,,
2025-05-06,1395.29,credit,in,Counterparty_50,21469818.59,,
2025-05-06,799.5,marketing_spend,out,Counterparty_81,21469019.09,2025-04-04,2025-05-02
2025-05-06,2663.07,refund,in,Counterparty_54,21471682.16,,
2025-05-06,16684.11,asset_sale,in,Counterparty_96,21488366.27,,
2025-05-06,2307.93,marketing_spend,out,Counterparty_34,21486058.34,2025-04-17,2025-05-14
2025-05-06,4182.13,loan_repayment,out,Counterparty_33,21481876.21,2025-04-11,2025-05-10
2025-05-06,3374.96,T&E,out,Counterparty_95,21478501.25,2025-04-13,2025-05-11
2025-05-06,3794.34,credit,in,Counterparty_72,21482295.59,,
2025-05-06,132.54,payroll,out,Counterparty_21,21482163.05,2025-04-03,2025-05-07
2025-05-06,1667.14,tax_payment,out,Counterparty_94,21480495.91,2025-04-14,2025-05-11
2025-05-06,1333.26,rent,out,Counterparty_99,21479162.65,2025-04-20,2025-05-25
2025-05-06,3078.14,credit,in,Counterparty_52,21482240.79,,
2025-05-06,11196.59,rent,out,Counterparty_46,21471044.2,2025-04-16,2025-05-21
2025-05-06,4417.58,T&E,out,Counterparty_72,21466626.62,2025-04-15,2025-05-13
2025-05-06,950.45,payroll,out,Counterparty_84,21465676.17,2025-04-11,2025-05-16
2025-05-06,1958.59,tax_payment,out,Counterparty_20,21463717.58,2025-04-18,2025-05-22
2025-05-06,1066.51,credit,in,Counterparty_23,21464784.09,,
2025-05-06,336.57,asset_sale,in,Counterparty_26,21465120.66,,
2025-05-06,4395.42,investment_income,in,Counterparty_41,21469516.08,,
2025-05-06,2449.4,credit,in,Counterparty_15,21471965.48,,
2025-05-06,595.48,software_subscription,out,Counterparty_40,21471370.0,2025-03-24,2025-04-21
2025-05-06,390.03,customer_payment,in,Counterparty_82,21471760.03,,
2025-05-06,478.36,payroll,out,Counterparty_14,21471281.67,2025-03-23,2025-04-22
2025-05-06,1489.82,supplier_payment,out,Counterparty_27,21469791.85,2025-04-05,2025-05-09
2025-05-06,548.7,marketing_spend,out,Counterparty_17,21469243.15,2025-03-30,2025-04-27
2025-05-06,1002.32,T&E,out,Counterparty_49,21468240.83,2025-04-13,2025-05-21
2025-05-06,1214.02,payroll,out,Counterparty_11,21467026.81,2025-04-13,2025-05-22
2025-05-06,472.99,loan_repayment,out,Counterparty_44,21466553.82,2025-04-03,2025-04-30
2025-05-06,2599.88,tax_payment,out,Counterparty_87,21463953.94,2025-04-02,2025-04-30
2025-05-06,5071.59,asset_sale,in,Counterparty_62,21469025.53,,
2025-05-06,608.77,supplier_payment,out,Counterparty_44,21468416.76,2025-03-24,2025-04-21
2025-05-06,2693.02,credit,in,Counterparty_65,21471109.78,,
2025-05-06,194.4,utilities,out,Counterparty_44,21470915.38,2025-04-11,2025-05-12
2025-05-06,1157.96,investment_income,in,Counterparty_80,21472073.34,,
2025-05-06,1912.41,tax_payment,out,Counterparty_24,21470160.93,2025-04-11,2025-05-17
2025-05-06,5769.0,rent,out,Counterparty_23,21464391.93,2025-04-11,2025-05-08
2025-05-06,4118.7,T&E,out,Counterparty_17,21460273.23,2025-03-31,2025-04-29
2025-05-06,358.51,investment_income,in,Counterparty_15,21460631.74,,
2025-05-06,3728.94,loan_repayment,out,Counterparty_35,21456902.8,2025-04-09,2025-05-15
2025-05-06,657.15,supplier_payment,out,Counterparty_1,21456245.65,2025-04-11,2025-05-14
2025-05-06,1559.87,utilities,out,Counterparty_77,21454685.78,2025-04-03,2025-04-28
2025-05-06,3727.85,loan_repayment,out,Counterparty_83,21450957.93,2025-04-08,2025-05-08
2025-05-06,4813.5,credit,in,Counterparty_63,21455771.43,,
2025-05-06,768.03,rent,out,Counterparty_11,21455003.4,2025-03-27,2025-04-22
2025-05-06,7113.79,tax_payment,out,Counterparty_6,21447889.61,2025-04-14,2025-05-23
2025-05-06,1973.3,customer_payment,in,Counterparty_98,21449862.91,,
2025-05-06,4317.49,refund,in,Counterparty_70,21454180.4,,
2025-05-06,699.16,credit,in,Counterparty_25,21454879.56,,
2025-05-06,2129.47,credit,in,Counterparty_15,21457009.03,,
2025-05-06,248.25,marketing_spend,out,Counterparty_62,21456760.78,2025-04-20,2025-05-21
2025-05-06,623.69,loan_repayment,out,Counterparty_12,21456137.09,2025-04-08,2025-05-03
2025-05-06,50.97,investment_income,in,Counterparty_62,21456188.06,,
2025-05-07,2651.48,investment_income,in,Counterparty_50,21458839.54,,
2025-05-07,6382.24,asset_sale,in,Counterparty_33,21465221.78,,
2025-05-07,1188.31,marketing_spend,out,Counterparty_34,21464033.47,2025-04-20,2025-05-22
2025-05-07,2994.3,T&E,out,Counterparty_92,21461039.17,2025-04-08,2025-05-05
2025-05-07,45.51,utilities,out,Counterparty_33,21460993.66,2025-04-22,2025-05-25
2025-05-07,2391.44,utilities,out,Counterparty_72,21458602.22,2025-04-09,2025-05-09
2025-05-07,1875.14,credit,in,Counterparty_51,21460477.36,,
2025-05-07,154.06,customer_payment,in,Counterparty_83,21460631.42,,
2025-05-07,3350.27,credit,in,Counterparty_49,21463981.69,,
2025-05-07,3728.15,rent,out,Counterparty_38,21460253.54,2025-04-09,2025-05-05
2025-05-07,393.65,utilities,out,Counterparty_20,21459859.89,2025-03-24,2025-04-28
2025-05-07,4529.31,investment_income,in,Counterparty_27,21464389.2,,
2025-05-07,16456.76,asset_sale,in,Counterparty_68,21480845.96,,
2025-05-07,262.78,customer_payment,in,Counterparty_73,21481108.74,,
2025-05-07,698.36,T&E,out,Counterparty_44,21480410.38,2025-04-06,2025-05-07
2025-05-07,2881.09,customer_payment,in,Counterparty_37,21483291.47,,
2025-05-07,5567.56,investment_income,in,Counterparty_48,21488859.03,,
2025-05-07,1414.34,utilities,out,Counterparty_80,21487444.69,2025-04-03,2025-05-04
2025-05-07,3018.7,investment_income,in,Counterparty_15,21490463.39,,
2025-05-07,1337.16,refund,in,Counterparty_67,21491800.55,,
2025-05-07,6689.07,refund,in,Counterparty_17,21498489.62,,
2025-05-07,3481.4,software_subscription,out,Counterparty_25,21495008.22,2025-04-06,2025-05-04
2025-05-07,525.36,asset_sale,in,Counterparty_40,21495533.58,,
2025-05-07,950.75,rent,out,Counterparty_37,21494582.83,2025-03-28,2025-04-23
2025-05-07,5387.35,marketing_spend,out,Counterparty_80,21489195.48,2025-03-26,2025-04-28
2025-05-07,2444.99,supplier_payment,out,Counterparty_82,21486750.49,2025-03-24,2025-04-25
2025-05-07,1038.93,payroll,out,Counterparty_92,21485711.56,2025-04-16,2025-05-19
2025-05-07,2842.63,utilities,out,Counterparty_51,21482868.93,2025-03-28,2025-04-24
2025-05-07,3400.32,credit,in,Counterparty_28,21486269.25,,
2025-05-07,931.33,credit,in,Counterparty_27,21487200.58,,
2025-05-07,1530.97,software_subscription,out,Counterparty_31,21485669.61,2025-04-22,2025-05-21
2025-05-07,3606.23,marketing_spend,out,Counterparty_40,21482063.38,2025-03-27,2025-04-30
2025-05-07,1718.96,T&E,out,Counterparty_89,21480344.42,2025-04-09,2025-05-15
2025-05-07,4731.53,investment_income,in,Counterparty_39,21485075.95,,
2025-05-07,7071.6,credit,in,Counterparty_76,21492147.55,,
2025-05-07,845.01,utilities,out,Counterparty_42,21491302.54,2025-03-25,2025-04-21
2025-05-07,1106.56,customer_payment,in,Counterparty_48,21492409.1,,
2025-05-07,8003.16,investment_income,in,Counterparty_81,21500412.26,,
2025-05-07,1158.32,tax_payment,out,Counterparty_86,21499253.94,2025-04-06,2025-05-06
2025-05-07,950.23,supplier_payment,out,Counterparty_81,21498303.71,2025-03-29,2025-05-06
2025-05-07,1974.47,investment_income,in,Counterparty_16,21500278.18,,
2025-05-07,1432.13,asset_sale,in,Counterparty_39,21501710.31,,
2025-05-07,1625.33,refund,in,Counterparty_16,21503335.64,,
2025-05-07,388.24,payroll,out,Counterparty_27,21502947.4,2025-04-12,2025-05-14
2025-05-07,2244.09,marketing_spend,out,Counterparty_86,21500703.31,2025-03-30,2025-05-02
2025-05-07,231.12,refund,in,Counterparty_76,21500934.43,,
2025-05-07,464.66,rent,out,Counterparty_11,21500469.77,2025-04-05,2025-05-07
2025-05-07,152.05,customer_payment,in,Counterparty_31,21500621.82,,
2025-05-07,1027.72,loan_repayment,out,Counterparty_55,21499594.1,2025-04-12,2025-05-12
2025-05-07,872.59,credit,in,Counterparty_94,21500466.69,,
2025-05-07,1474.68,credit,in,Counterparty_93,21501941.37,,
2025-05-07,6152.81,credit,in,Counterparty_96,21508094.18,,
2025-05-07,669.52,rent,out,Counterparty_75,21507424.66,2025-04-05,2025-05-13
2025-05-07,2773.58,loan_repayment,out,Counterparty_23,21504651.08,2025-04-10,2025-05-11
2025-05-07,787.61,customer_payment,in,Counterparty_13,21505438.69,,
2025-05-07,522.07,loan_repayment,out,Counterparty_8,21504916.62,2025-03-31,2025-04-25
2025-05-08,779.29,investment_income,in,Counterparty_84,21505695.91,,
2025-05-08,104.48,investment_income,in,Counterparty_3,21505800.39,,
2025-05-08,191.54,tax_payment,out,Counterparty_60,21505608.85,2025-04-13,2025-05-19
2025-05-08,835.08,software_subscription,out,Counterparty_5,21504773.77,2025-04-03,2025-05-10
2025-05-08,5.73,utilities,out,Counterparty_40,21504768.04,2025-04-19,2025-05-25
2025-05-08,13.52,utilities,out,Counterparty_88,21504754.52,2025-04-07,2025-05-12
2025-05-08,1116.15,asset_sale,in,Counterparty_3,21505870.67,,
2025-05-08,1853.2,refund,in,Counterparty_48,21507723.87,,
2025-05-08,143.58,investment_income,in,Counterparty_93,21507867.45,,
2025-05-08,122.56,rent,out,Counterparty_52,21507744.89,2025-04-23,2025-05-21
2025-05-08,1217.4,investment_income,in,Counterparty_59,21508962.29,,
2025-05-08,6973.52,tax_payment,out,Counterparty_64,21501988.77,2025-04-14,2025-05-18
2025-05-08,223.01,customer_payment,in,Counterparty_32,21502211.78,,
2025-05-08,142.13,customer_payment,in,Counterparty_25,21502353.91,,
2025-05-08,1524.95,payroll,out,Counterparty_57,21500828.96,2025-04-05,2025-05-08
2025-05-08,1290.28,credit,in,Counterparty_39,21502119.24,,
2025-05-08,678.05,customer_payment,in,Counterparty_48,21502797.29,,
2025-05-08,1440.46,software_subscription,out,Counterparty_60,21501356.83,2025-04-14,2025-05-22
2025-05-08,1460.26,credit,in,Counterparty_94,21502817.09,,
2025-05-08,1119.79,software_subscription,out,Counterparty_25,21501697.3,2025-04-01,2025-05-10
2025-05-08,1908.57,asset_sale,in,Counterparty_36,21503605.87,,
2025-05-08,3843.37,credit,in,Counterparty_54,21507449.24,,
2025-05-08,3170.19,credit,in,Counterparty_83,21510619.43,,
2025-05-08,2999.78,utilities,out,Counterparty_67,21507619.65,2025-03-26,2025-04-21
2025-05-08,2966.9,tax_payment,out,Counterparty_45,21504652.75,2025-04-21,2025-05-16
2025-05-08,2142.84,customer_payment,in,Counterparty_89,21506795.59,,
2025-05-08,491.13,supplier_payment,out,Counterparty_49,21506304.46,2025-03-26,2025-05-01
2025-05-08,1480.88,credit,in,Counterparty_3,21507785.34,,
2025-05-08,5323.34,customer_payment,in,Counterparty_81,21513108.68,,
2025-05-08,5558.8,loan_repayment,out,Counterparty_38,21507549.88,2025-04-07,2025-05-08
2025-05-08,4739.16,refund,in,Counterparty_93,21512289.04,,
2025-05-08,1964.71,utilities,out,Counterparty_66,21510324.33,2025-04-14,2025-05-16
2025-05-08,454.57,software_subscription,out,Counterparty_80,21509869.76,2025-04-13,2025-05-12
2025-05-08,157.99,T&E,out,Counterparty_9,21509711.77,2025-04-06,2025-05-08
2025-05-08,528.46,tax_payment,out,Counterparty_79,21509183.31,2025-04-05,2025-05-05
2025-05-08,1684.84,credit,in,Counterparty_48,21510868.15,,
2025-05-08,307.97,software_subscription,out,Counterparty_33,21510560.18,2025-04-19,2025-05-20
2025-05-08,445.72,utilities,out,Counterparty_79,21510114.46,2025-03-29,2025-04-28
2025-05-08,4871.79,rent,out,Counterparty_68,21505242.67,2025-03-31,2025-04-25
2025-05-08,846.15,software_subscription,out,Counterparty_15,21504396.52,2025-03-26,2025-04-25
2025-05-08,2302.93,refund,in,Counterparty_20,21506699.45,,
2025-05-08,6789.79,refund,in,Counterparty_52,21513489.24,,
2025-05-08,3446.62,supplier_payment,out,Counterparty_26,21510042.62,2025-04-12,2025-05-15
2025-05-08,165.56,software_subscription,out,Counterparty_75,21509877.06,2025-04-10,2025-05-13
2025-05-08,3064.64,payroll,out,Counterparty_23,21506812.42,2025-04-09,2025-05-09
2025-05-08,5141.4,investment_income,in,Counterparty_3,21511953.82,,
2025-05-08,1738.23,refund,in,Counterparty_44,21513692.05,,
2025-05-08,2668.57,investment_income,in,Counterparty_95,21516360.62,,
2025-05-08,5955.23,tax_payment,out,Counterparty_97,21510405.39,2025-04-01,2025-05-01
2025-05-08,427.4,T&E,out,Counterparty_31,21509977.99,2025-04-14,2025-05-11
2025-05-08,1138.13,customer_payment,in,Counterparty_78,21511116.12,,
2025-05-08,2614.61,investment_income,in,Counterparty_66,21513730.73,,
2025-05-08,3350.66,utilities,out,Counterparty_61,21510380.07,2025-04-12,2025-05-20
2025-05-08,2146.47,refund,in,Counterparty_80,21512526.54,,
2025-05-08,2178.82,supplier_payment,out,Counterparty_69,21510347.72,2025-03-28,2025-04-22
2025-05-08,2857.79,T&E,out,Counterparty_22,21507489.93,2025-04-14,2025-05-12
2025-05-08,202.43,utilities,out,Counterparty_40,21507287.5,2025-04-11,2025-05-07
2025-05-08,2887.1,refund,in,Counterparty_29,21510174.6,,
2025-05-08,1156.32,software_subscription,out,Counterparty_60,21509018.28,2025-04-04,2025-05-11
2025-05-08,2523.16,refund,in,Counterparty_64,21511541.44,,
2025-05-08,512.67,marketing_spend,out,Counterparty_83,21511028.77,2025-04-05,2025-05-01
2025-05-08,2335.1,rent,out,Counterparty_77,21508693.67,2025-04-07,2025-05-10
2025-05-08,1977.55,supplier_payment,out,Counterparty_69,21506716.12,2025-04-14,2025-05-22
2025-05-08,688.0,marketing_spend,out,Counterparty_28,21506028.12,2025-04-05,2025-05-02
2025-05-08,1595.78,asset_sale,in,Counterparty_52,21507623.9,,
2025-05-08,2286.19,software_subscription,out,Counterparty_29,21505337.71,2025-04-13,2025-05-20
2025-05-08,2900.34,customer_payment,in,Counterparty_11,21508238.05,,
2025-05-08,3327.73,refund,in,Counterparty_66,21511565.78,,
2025-05-08,3431.03,refund,in,Counterparty_84,21514996.81,,
2025-05-08,588.9,investment_income,in,Counterparty_53,21515585.71,,
2025-05-09,395.05,tax_payment,out,Counterparty_44,21515190.66,2025-04-14,2025-05-09
2025-05-09,4037.71,investment_income,in,Counterparty_77,21519228.37,,
2025-05-09,1100.8,marketing_spend,out,Counterparty_2,21518127.57,2025-04-23,2025-05-19
2025-05-09,1805.43,refund,in,Counterparty_85,21519933.0,,
2025-05-09,39.34,loan_repayment,out,Counterparty_90,21519893.66,2025-04-11,2025-05-09
2025-05-09,2320.73,software_subscription,out,Counterparty_3,21517572.93,2025-03-29,2025-04-24
2025-05-09,1670.84,marketing_spend,out,Counterparty_38,21515902.09,2025-04-08,2025-05-07
2025-05-09,1367.29,supplier_payment,out,Counterparty_22,21514534.8,2025-04-19,2025-05-24
2025-05-09,659.74,supplier_payment,out,Counterparty_88,21513875.06,2025-04-18,2025-05-25
2025-05-09,10379.0,software_subscription,out,Counterparty_21,21503496.06,2025-04-12,2025-05-20
2025-05-09,1660.85,supplier_payment,out,Counterparty_48,21501835.21,2025-04-05,2025-05-12
2025-05-09,2387.4,software_subscription,out,Counterparty_22,21499447.81,2025-04-15,2025-05-19
2025-05-09,2667.07,loan_repayment,out,Counterparty_13,21496780.74,2025-04-13,2025-05-15
2025-05-09,4517.96,credit,in,Counterparty_87,21501298.7,,
2025-05-09,521.85,credit,in,Counterparty_53,21501820.55,,
2025-05-09,123.31,utilities,out,Counterparty_27,21501697.24,2025-04-21,2025-05-19
2025-05-09,1493.49,investment_income,in,Counterparty_81,21503190.73,,
2025-05-09,179.02,utilities,out,Counterparty_83,21503011.71,2025-04-08,2025-05-13
2025-05-09,4309.55,supplier_payment,out,Counterparty_65,21498702.16,2025-04-23,2025-05-18
2025-05-09,9190.81,T&E,out,Counterparty_98,21489511.35,2025-03-29,2025-05-01
2025-05-09,2596.14,credit,in,Counterparty_82,21492107.49,,
2025-05-09,1346.76,loan_repayment,out,Counterparty_99,21490760.73,2025-03-29,2025-04-25
2025-05-09,2085.32,refund,in,Counterparty_82,21492846.05,,
2025-05-09,823.47,loan_repayment,out,Counterparty_38,21492022.58,2025-04-08,2025-05-08
2025-05-09,2618.69,credit,in,Counterparty_38,21494641.27,,
2025-05-09,4895.94,T&E,out,Counterparty_89,21489745.33,2025-04-24,2025-05-23
2025-05-09,27263.93,customer_payment,in,Counterparty_51,21517009.26,,
2025-05-09,448.74,tax_payment,out,Counterparty_92,21516560.52,2025-04-22,2025-05-20
2025-05-09,717.58,T&E,out,Counterparty_55,21515842.94,2025-04-15,2025-05-13
2025-05-09,424.91,loan_repayment,out,Counterparty_97,21515418.03,2025-04-19,2025-05-25
2025-05-09,11322.0,customer_payment,in,Counterparty_76,21526740.03,,
2025-05-09,1770.34,tax_payment,out,Counterparty_7,21524969.69,2025-04-11,2025-05-16
2025-05-09,2367.5,tax_payment,out,Counterparty_67,21522602.19,2025-04-22,2025-05-18
2025-05-09,1793.16,tax_payment,out,Counterparty_61,21520809.03,2025-04-15,2025-05-10
2025-05-09,2416.14,loan_repayment,out,Counterparty_71,21518392.89,2025-03-30,2025-05-03
2025-05-09,500.76,payroll,out,Counterparty_25,21517892.13,2025-04-07,2025-05-12
2025-05-09,969.84,utilities,out,Counterparty_5,21516922.29,2025-04-22,2025-05-31
2025-05-09,4500.78,payroll,out,Counterparty_29,21512421.51,2025-03-26,2025-04-23
2025-05-09,2087.13,investment_income,in,Counterparty_56,21514508.64,,
2025-05-09,2083.79,customer_payment,in,Counterparty_35,21516592.43,,
2025-05-09,12027.45,refund,in,Counterparty_72,21528619.88,,
2025-05-09,3368.54,loan_repayment,out,Counterparty_34,21525251.34,2025-04-24,2025-05-26
2025-05-09,4550.7,rent,out,Counterparty_36,21520700.64,2025-04-08,2025-05-15
2025-05-09,8497.89,loan_repayment,out,Counterparty_16,21512202.75,2025-04-22,2025-05-31
2025-05-09,101.04,supplier_payment,out,Counterparty_25,21512101.71,2025-04-24,2025-05-23
2025-05-09,1135.51,marketing_spend,out,Counterparty_31,21510966.2,2025-04-18,2025-05-22
2025-05-09,2432.27,tax_payment,out,Counterparty_99,21508533.93,2025-04-20,2025-05-23
2025-05-09,106.35,payroll,out,Counterparty_83,21508427.58,2025-04-21,2025-05-25
2025-05-09,9211.0,utilities,out,Counterparty_81,21499216.58,2025-04-17,2025-05-25
2025-05-09,3032.3,T&E,out,Counterparty_46,21496184.28,2025-04-20,2025-05-21
2025-05-09,447.86,investment_income,in,Counterparty_67,21496632.14,,
2025-05-09,1684.52,marketing_spend,out,Counterparty_61,21494947.62,2025-03-29,2025-05-01
2025-05-10,3100.17,supplier_payment,out,Counterparty_2,21491847.45,2025-04-20,2025-05-22
2025-05-10,3606.46,asset_sale,in,Counterparty_41,21495453.91,,
2025-05-10,3853.3,credit,in,Counterparty_54,21499307.21,,
2025-05-10,97.95,asset_sale,in,Counterparty_22,21499405.16,,
2025-05-10,3838.2,credit,in,Counterparty_4,21503243.36,,
2025-05-10,3905.37,utilities,out,Counterparty_9,21499337.99,2025-04-09,2025-05-13
2025-05-10,3692.05,payroll,out,Counterparty_85,21495645.94,2025-04-01,2025-04-30
2025-05-10,1721.73,utilities,out,Counterparty_76,21493924.21,2025-04-14,2025-05-22
2025-05-10,1204.23,payroll,out,Counterparty_8,21492719.98,2025-04-03,2025-05-07
2025-05-10,4645.26,tax_payment,out,Counterparty_17,21488074.72,2025-04-12,2025-05-09
2025-05-10,120.43,tax_payment,out,Counterparty_88,21487954.29,2025-04-01,2025-05-05
2025-05-10,125.52,loan_repayment,out,Counterparty_76,21487828.77,2025-04-20,2025-05-29
2025-05-10,1308.7,credit,in,Counterparty_45,21489137.47,,
2025-05-10,3341.36,software_subscription,out,Counterparty_74,21485796.11,2025-03-31,2025-04-30
2025-05-10,3104.39,supplier_payment,out,Counterparty_82,21482691.72,2025-04-12,2025-05-18
2025-05-10,514.99,payroll,out,Counterparty_99,21482176.73,2025-04-18,2025-05-15
2025-05-10,4692.52,software_subscription,out,Counterparty_55,21477484.21,2025-04-19,2025-05-24
2025-05-10,33.75,refund,in,Counterparty_92,21477517.96,,
2025-05-10,4721.67,investment_income,in,Counterparty_8,21482239.63,,
2025-05-10,2787.76,tax_payment,out,Counterparty_99,21479451.87,2025-04-15,2025-05-24
2025-05-10,693.87,customer_payment,in,Counterparty_47,21480145.74,,
2025-05-10,5414.03,rent,out,Counterparty_21,21474731.71,2025-04-05,2025-05-13
2025-05-10,4771.14,software_subscription,out,Counterparty_82,21469960.57,2025-04-13,2025-05-09
2025-05-10,1042.46,supplier_payment,out,Counterparty_53,21468918.11,2025-04-21,2025-05-30
2025-05-10,3036.23,T&E,out,Counterparty_43,21465881.88,2025-03-27,2025-04-25
2025-05-10,462.11,refund,in,Counterparty_53,21466343.99,,
2025-05-10,315.48,software_subscription,out,Counterparty_55,21466028.51,2025-03-31,2025-05-03
2025-05-10,352.11,customer_payment,in,Counterparty_14,21466380.62,,
2025-05-10,5579.31,customer_payment,in,Counterparty_8,21471959.93,,
2025-05-10,2735.71,loan_repayment,out,Counterparty_25,21469224.22,2025-04-05,2025-05-04
2025-05-10,3035.77,refund,in,Counterparty_48,21472259.99,,
2025-05-10,2068.92,rent,out,Counterparty_10,21470191.07,2025-04-18,2025-05-23
2025-05-10,2591.62,customer_payment,in,Counterparty_29,21472782.69,,
2025-05-10,901.23,credit,in,Counterparty_65,21473683.92,,
2025-05-10,2432.06,credit,in,Counterparty_52,21476115.98,,
2025-05-10,4187.73,software_subscription,out,Counterparty_72,21471928.25,2025-04-05,2025-05-11
2025-05-10,1084.57,asset_sale,in,Counterparty_2,21473012.82,,
2025-05-10,1158.47,asset_sale,in,Counterparty_14,21474171.29,,
2025-05-10,225.69,asset_sale,in,Counterparty_83,21474396.98,,
2025-05-10,1088.58,payroll,out,Counterparty_91,21473308.4,2025-04-20,2025-05-23
2025-05-10,2672.32,software_subscription,out,Counterparty_21,21470636.08,2025-04-12,2025-05-17
2025-05-10,2809.21,customer_payment,in,Counterparty_72,21473445.29,,
2025-05-10,3920.69,tax_payment,out,Counterparty_75,21469524.6,2025-04-25,2025-05-31
2025-05-10,2345.67,investment_income,in,Counterparty_16,21471870.27,,
2025-05-10,4612.4,customer_payment,in,Counterparty_85,21476482.67,,
2025-05-10,1342.41,marketing_spend,out,Counterparty_68,21475140.26,2025-03-30,2025-04-29
2025-05-10,2022.19,supplier_payment,out,Counterparty_90,21473118.07,2025-04-18,2025-05-15
2025-05-10,7005.79,asset_sale,in,Counterparty_9,21480123.86,,
2025-05-10,891.45,T&E,out,Counterparty_12,21479232.41,2025-03-27,2025-04-26
2025-05-10,2257.46,supplier_payment,out,Counterparty_55,21476974.95,2025-04-25,2025-05-29
2025-05-10,516.57,software_subscription,out,Counterparty_31,21476458.38,2025-04-19,2025-05-17
2025-05-10,5831.73,customer_payment,in,Counterparty_84,21482290.11,,
2025-05-10,4521.5,asset_sale,in,Counterparty_98,21486811.61,,
2025-05-10,2060.06,refund,in,Counterparty_18,21488871.67,,
2025-05-10,1102.52,credit,in,Counterparty_98,21489974.19,,
2025-05-10,2150.38,utilities,out,Counterparty_33,21487823.81,2025-04-23,2025-05-29
2025-05-10,927.19,rent,out,Counterparty_91,21486896.62,2025-04-19,2025-05-17
2025-05-10,4375.54,supplier_payment,out,Counterparty_31,21482521.08,2025-04-05,2025-05-03
2025-05-10,2252.92,utilities,out,Counterparty_58,21480268.16,2025-04-17,2025-05-18
2025-05-11,4239.41,investment_income,in,Counterparty_79,21484507.57,,
2025-05-11,2731.12,customer_payment,in,Counterparty_26,21487238.69,,
2025-05-11,865.66,supplier_payment,out,Counterparty_22,21486373.03,2025-04-10,2025-05-18
2025-05-11,1818.03,asset_sale,in,Counterparty_53,21488191.06,,
2025-05-11,880.38,credit,in,Counterparty_97,21489071.44,,
2025-05-11,118.89,marketing_spend,out,Counterparty_37,21488952.55,2025-04-02,2025-05-04
2025-05-11,4448.28,rent,out,Counterparty_58,21484504.27,2025-04-13,2025-05-15
2025-05-11,1870.8,refund,in,Counterparty_25,21486375.07,,
2025-05-11,603.86,software_subscription,out,Counterparty_50,21485771.21,2025-04-04,2025-05-10
2025-05-11,1888.84,software_subscription,out,Counterparty_94,21483882.37,2025-04-04,2025-05-13
2025-05-11,2978.31,rent,out,Counterparty_99,21480904.06,2025-04-26,2025-05-23
2025-05-11,3815.58,refund,in,Counterparty_94,21484719.64,,
2025-05-11,3675.76,payroll,out,Counterparty_59,21481043.88,2025-04-01,2025-05-01
2025-05-11,3811.32,tax_payment,out,Counterparty_28,21477232.56,2025-04-07,2025-05-10
2025-05-11,4342.48,T&E,out,Counterparty_94,21472890.08,2025-04-02,2025-04-30
2025-05-11,2984.4,payroll,out,Counterparty_26,21469905.68,2025-04-20,2025-05-25
2025-05-11,2442.86,rent,out,Counterparty_27,21467462.82,2025-04-03,2025-05-10
2025-05-11,535.99,rent,out,Counterparty_37,21466926.83,2025-03-31,2025-05-07
2025-05-11,4638.5,asset_sale,in,Counterparty_3,21471565.33,,
2025-05-11,2389.67,asset_sale,in,Counterparty_16,21473955.0,,
2025-05-11,1334.76,loan_repayment,out,Counterparty_26,21472620.24,2025-04-12,2025-05-17
2025-05-11,2048.8,T&E,out,Counterparty_56,21470571.44,2025-04-13,2025-05-09
2025-05-11,175.63,T&E,out,Counterparty_67,21470395.81,2025-04-15,2025-05-14
2025-05-11,11.0,tax_payment,out,Counterparty_52,21470384.81,2025-04-13,2025-05-15
2025-05-11,1002.92,customer_payment,in,Counterparty_57,21471387.73,,
2025-05-11,1741.12,T&E,out,Counterparty_82,21469646.61,2025-04-08,2025-05-04
2025-05-11,2356.38,marketing_spend,out,Counterparty_53,21467290.23,2025-03-30,2025-04-27
2025-05-11,271.32,tax_payment,out,Counterparty_62,21467018.91,2025-04-01,2025-05-03
2025-05-11,2275.23,credit,in,Counterparty_79,21469294.14,,
2025-05-11,980.57,rent,out,Counterparty_13,21468313.57,2025-04-14,2025-05-22
2025-05-11,5997.68,refund,in,Counterparty_79,21474311.25,,
2025-05-11,4210.94,software_subscription,out,Counterparty_21,21470100.31,2025-04-21,2025-05-17
2025-05-11,488.45,customer_payment,in,Counterparty_65,21470588.76,,
2025-05-11,1554.19,credit,in,Counterparty_83,21472142.95,,
2025-05-11,1500.37,investment_income,in,Counterparty_49,21473643.32,,
2025-05-11,339.81,refund,in,Counterparty_7,21473983.13,,
2025-05-11,588.51,marketing_spend,out,Counterparty_24,21473394.62,2025-04-24,2025-05-27
2025-05-11,1698.78,investment_income,in,Counterparty_68,21475093.4,,
2025-05-11,11529.82,refund,in,Counterparty_2,21486623.22,,
2025-05-11,3111.59,customer_payment,in,Counterparty_50,21489734.81,,
2025-05-11,801.61,T&E,out,Counterparty_35,21488933.2,2025-04-15,2025-05-16
2025-05-11,3602.42,investment_income,in,Counterparty_80,21492535.62,,
2025-05-11,45.49,customer_payment,in,Counterparty_63,21492581.11,,
2025-05-11,3950.94,tax_payment,out,Counterparty_68,21488630.17,2025-04-17,2025-05-17
2025-05-11,2039.54,supplier_payment,out,Counterparty_13,21486590.63,2025-04-26,2025-05-25
2025-05-11,2794.88,rent,out,Counterparty_5,21483795.75,2025-03-30,2025-04-28
2025-05-11,669.21,utilities,out,Counterparty_17,21483126.54,2025-04-07,2025-05-15
2025-05-11,3677.02,supplier_payment,out,Counterparty_33,21479449.52,2025-04-11,2025-05-20
2025-05-11,1904.29,software_subscription,out,Counterparty_64,21477545.23,2025-04-02,2025-04-29
2025-05-11,131.37,loan_repayment,out,Counterparty_26,21477413.86,2025-04-22,2025-05-28
2025-05-11,1188.28,marketing_spend,out,Counterparty_65,21476225.58,2025-03-31,2025-04-25
2025-05-11,7109.13,supplier_payment,out,Counterparty_83,21469116.45,2025-04-18,2025-05-16
2025-05-11,3074.37,investment_income,in,Counterparty_8,21472190.82,,
2025-05-11,1974.92,rent,out,Counterparty_46,21470215.9,2025-04-05,2025-05-14
2025-05-11,458.85,supplier_payment,out,Counterparty_74,21469757.05,2025-04-17,2025-05-16
2025-05-11,335.45,rent,out,Counterparty_48,21469421.6,2025-04-02,2025-05-08
2025-05-11,1768.07,customer_payment,in,Counterparty_1,21471189.67,,
2025-05-11,5973.6,refund,in,Counterparty_88,21477163.27,,
2025-05-11,4208.13,refund,in,Counterparty_21,21481371.4,,
2025-05-11,560.96,loan_repayment,out,Counterparty_33,21480810.44,2025-04-11,2025-05-11
2025-05-11,173.66,T&E,out,Counterparty_67,21480636.78,2025-04-03,2025-05-04
2025-05-11,5326.93,supplier_payment,out,Counterparty_69,21475309.85,2025-04-02,2025-05-06
2025-05-11,4787.01,rent,out,Counterparty_56,21470522.84,2025-04-11,2025-05-13
2025-05-11,621.32,asset_sale,in,Counterparty_65,21471144.16,,
2025-05-11,1702.28,software_subscription,out,Counterparty_53,21469441.88,2025-04-22,2025-05-30
2025-05-11,2219.38,customer_payment,in,Counterparty_66,21471661.26,,
2025-05-11,1973.45,T&E,out,Counterparty_12,21469687.81,2025-04-13,2025-05-08
2025-05-12,826.91,payroll,out,Counterparty_10,21468860.9,2025-04-17,2025-05-25
2025-05-12,1802.93,software_subscription,out,Counterparty_58,21467057.97,2025-04-20,2025-05-20
2025-05-12,4573.8,marketing_spend,out,Counterparty_82,21462484.17,2025-04-03,2025-05-05
2025-05-12,2132.46,T&E,out,Counterparty_8,21460351.71,2025-04-15,2025-05-20
2025-05-12,3582.34,payroll,out,Counterparty_89,21456769.37,2025-04-25,2025-06-03
2025-05-12,104.86,payroll,out,Counterparty_76,21456664.51,2025-04-22,2025-05-25
2025-05-12,3652.91,rent,out,Counterparty_4,21453011.6,2025-03-29,2025-04-26
2025-05-12,2474.52,payroll,out,Counterparty_24,21450537.08,2025-04-05,2025-05-03
2025-05-12,1055.17,utilities,out,Counterparty_49,21449481.91,2025-04-08,2025-05-09
2025-05-12,2583.33,marketing_spend,out,Counterparty_47,21446898.58,2025-04-27,2025-06-03
2025-05-12,463.33,software_subscription,out,Counterparty_86,21446435.25,2025-04-04,2025-05-08
2025-05-12,1743.21,utilities,out,Counterparty_91,21444692.04,2025-04-26,2025-06-04
2025-05-12,1098.48,loan_repayment,out,Counterparty_55,21443593.56,2025-04-05,2025-05-11
2025-05-12,1137.36,software_subscription,out,Counterparty_88,21442456.2,2025-04-18,2025-05-26
2025-05-12,485.67,rent,out,Counterparty_68,21441970.53,2025-04-03,2025-05-06
2025-05-12,5598.88,supplier_payment,out,Counterparty_36,21436371.65,2025-04-08,2025-05-06
2025-05-12,2187.18,marketing_spend,out,Counterparty_19,21434184.47,2025-04-15,2025-05-18
2025-05-12,3776.51,T&E,out,Counterparty_20,21430407.96,2025-04-04,2025-05-12
2025-05-12,1373.3,utilities,out,Counterparty_71,21429034.66,2025-04-23,2025-05-18
2025-05-12,1913.49,marketing_spend,out,Counterparty_96,21427121.17,2025-04-05,2025-05-06
2025-05-12,126.26,T&E,out,Counterparty_50,21426994.91,2025-04-15,2025-05-12
2025-05-12,128.33,loan_repayment,out,Counterparty_43,21426866.58,2025-04-18,2025-05-26
2025-05-12,5081.11,rent,out,Counterparty_31,21421785.47,2025-04-12,2025-05-10
2025-05-12,1019.02,rent,out,Counterparty_28,21420766.45,2025-04-03,2025-04-28
2025-05-12,2863.49,utilities,out,Counterparty_2,21417902.96,2025-04-26,2025-05-27
2025-05-12,971.72,payroll,out,Counterparty_22,21416931.24,2025-04-18,2025-05-21
2025-05-12,809.78,utilities,out,Counterparty_2,21416121.46,2025-04-10,2025-05-12
2025-05-12,1690.72,payroll,out,Counterparty_6,21414430.74,2025-04-02,2025-05-10
2025-05-12,5768.64,T&E,out,Counterparty_41,21408662.1,2025-04-26,2025-05-30
2025-05-12,2206.6,loan_repayment,out,Counterparty_41,21406455.5,2025-03-31,2025-04-30
2025-05-12,4368.43,T&E,out,Counterparty_39,21402087.07,2025-03-31,2025-04-28
2025-05-12,1638.14,T&E,out,Counterparty_51,21400448.93,2025-04-24,2025-05-23
2025-05-12,3388.79,marketing_spend,out,Counterparty_8,21397060.14,2025-04-04,2025-04-30
2025-05-12,376.6,software_subscription,out,Counterparty_60,21396683.54,2025-04-20,2025-05-21
2025-05-12,6055.91,payroll,out,Counterparty_33,21390627.63,2025-04-16,2025-05-20
2025-05-12,4657.88,tax_payment,out,Counterparty_68,21385969.75,2025-04-19,2025-05-21
2025-05-12,4397.56,utilities,out,Counterparty_60,21381572.19,2025-04-03,2025-05-12
2025-05-12,5382.69,loan_repayment,out,Counterparty_77,21376189.5,2025-04-01,2025-05-10
2025-05-12,108.13,utilities,out,Counterparty_62,21376081.37,2025-04-01,2025-05-01
2025-05-12,3292.86,T&E,out,Counterparty_57,21372788.51,2025-04-21,2025-05-27
2025-05-12,5500.4,payroll,out,Counterparty_30,21367288.11,2025-04-14,2025-05-21
2025-05-12,670.47,customer_payment,in,Counterparty_20,21367958.58,,
2025-05-12,1823.31,credit,in,Counterparty_87,21369781.89,,
2025-05-12,795.55,asset_sale,in,Counterparty_3,21370577.44,,
2025-05-12,13.03,investment_income,in,Counterparty_47,21370590.47,,
2025-05-12,738.65,customer_payment,in,Counterparty_1,21371329.12,,
2025-05-12,2265.73,credit,in,Counterparty_96,21373594.85,,
2025-05-12,9117.95,customer_payment,in,Counterparty_18,21382712.8,,
2025-05-12,3318.87,utilities,out,Counterparty_32,21379393.93,2025-04-25,2025-05-27
2025-05-12,1399.22,investment_income,in,Counterparty_65,21380793.15,,
2025-05-12,162.33,asset_sale,in,Counterparty_77,21380955.48,,
2025-05-12,260.14,loan_repayment,out,Counterparty_29,21380695.34,2025-04-01,2025-04-28
2025-05-12,3953.5,investment_income,in,Counterparty_20,21384648.84,,
2025-05-12,14784.59,credit,in,Counterparty_71,21399433.43,,
2025-05-12,4511.05,asset_sale,in,Counterparty_54,21403944.48,,
2025-05-12,3640.39,credit,in,Counterparty_59,21407584.87,,
2025-05-12,450.76,supplier_payment,out,Counterparty_26,21407134.11,2025-04-27,2025-05-28
2025-05-12,1041.84,credit,in,Counterparty_39,21408175.95,,
2025-05-12,419.41,customer_payment,in,Counterparty_82,21408595.36,,
2025-05-12,3245.6,customer_payment,in,Counterparty_13,21411840.96,,
2025-05-12,890.23,investment_income,in,Counterparty_17,21412731.19,,
2025-05-12,3209.31,credit,in,Counterparty_23,21415940.5,,
2025-05-12,1664.23,asset_sale,in,Counterparty_21,21417604.73,,
2025-05-12,543.81,customer_payment,in,Counterparty_53,21418148.54,,
2025-05-12,865.49,refund,in,Counterparty_6,21419014.03,,
2025-05-12,6882.28,loan_repayment,out,Counterparty_66,21412131.75,2025-04-16,2025-05-15
2025-05-12,3424.0,asset_sale,in,Counterparty_80,21415555.75,,
2025-05-12,1362.7,investment_income,in,Counterparty_68,21416918.45,,
2025-05-13,954.25,investment_income,in,Counterparty_95,21417872.7,,
2025-05-13,4987.05,refund,in,Counterparty_70,21422859.75,,
2025-05-13,1287.74,credit,in,Counterparty_62,21424147.49,,
2025-05-13,721.08,marketing_spend,out,Counterparty_95,21423426.41,2025-04-28,2025-06-02
2025-05-13,2890.64,refund,in,Counterparty_92,21426317.05,,
2025-05-13,184.94,investment_income,in,Counterparty_58,21426501.99,,
2025-05-13,406.67,utilities,out,Counterparty_75,21426095.32,2025-04-05,2025-05-04
2025-05-13,537.42,credit,in,Counterparty_94,21426632.74,,
2025-05-13,226.66,customer_payment,in,Counterparty_31,21426859.4,,
2025-05-13,5631.3,customer_payment,in,Counterparty_87,21432490.7,,
2025-05-13,2690.42,investment_income,in,Counterparty_10,21435181.12,,
2025-05-13,155.9,supplier_payment,out,Counterparty_52,21435025.22,2025-04-05,2025-05-10
2025-05-13,488.06,loan_repayment,out,Counterparty_34,21434537.16,2025-04-20,2025-05-24
2025-05-13,3606.92,T&E,out,Counterparty_35,21430930.24,2025-04-01,2025-05-01
2025-05-13,2791.81,refund,in,Counterparty_83,21433722.05,,
2025-05-13,2248.89,utilities,out,Counterparty_6,21431473.16,2025-04-18,2025-05-24
2025-05-13,12271.28,investment_income,in,Counterparty_71,21443744.44,,
2025-05-13,3820.86,loan_repayment,out,Counterparty_4,21439923.58,2025-04-16,2025-05-12
2025-05-13,5601.31,investment_income,in,Counterparty_9,21445524.89,,
2025-05-13,447.24,payroll,out,Counterparty_53,21445077.65,2025-04-16,2025-05-18
2025-05-13,2257.19,credit,in,Counterparty_94,21447334.84,,
2025-05-13,3153.29,payroll,out,Counterparty_27,21444181.55,2025-04-08,2025-05-04
2025-05-13,846.08,credit,in,Counterparty_16,21445027.63,,
2025-05-13,1866.14,software_subscription,out,Counterparty_95,21443161.49,2025-04-03,2025-05-03
2025-05-13,5650.66,utilities,out,Counterparty_12,21437510.83,2025-04-07,2025-05-08
2025-05-13,262.8,T&E,out,Counterparty_77,21437248.03,2025-04-15,2025-05-21
2025-05-13,3354.34,loan_repayment,out,Counterparty_44,21433893.69,2025-04-04,2025-05-10
2025-05-13,7429.3,loan_repayment,out,Counterparty_91,21426464.39,2025-03-30,2025-05-01
2025-05-13,1177.09,marketing_spend,out,Counterparty_17,21425287.3,2025-04-11,2025-05-17
2025-05-13,8200.95,refund,in,Counterparty_91,21433488.25,,
2025-05-13,2897.18,supplier_payment,out,Counterparty_63,21430591.07,2025-04-15,2025-05-23
2025-05-13,573.41,rent,out,Counterparty_87,21430017.66,2025-04-08,2025-05-13
2025-05-13,962.65,loan_repayment,out,Counterparty_81,21429055.01,2025-04-21,2025-05-16
2025-05-13,365.8,investment_income,in,Counterparty_62,21429420.81,,
2025-05-13,2922.85,refund,in,Counterparty_83,21432343.66,,
2025-05-13,2527.38,marketing_spend,out,Counterparty_66,21429816.28,2025-04-25,2025-06-01
2025-05-13,3530.74,customer_payment,in,Counterparty_24,21433347.02,,
2025-05-13,1356.48,T&E,out,Counterparty_32,21431990.54,2025-04-13,2025-05-14
2025-05-13,620.41,loan_repayment,out,Counterparty_40,21431370.13,2025-04-20,2025-05-19
2025-05-13,3627.51,supplier_payment,out,Counterparty_34,21427742.62,2025-04-09,2025-05-08
2025-05-13,192.14,rent,out,Counterparty_4,21427550.48,2025-04-23,2025-05-24
2025-05-13,1940.5,T&E,out,Counterparty_78,21425609.98,2025-04-04,2025-05-11
2025-05-13,1630.86,T&E,out,Counterparty_17,21423979.12,2025-04-26,2025-06-01
2025-05-13,4168.52,credit,in,Counterparty_53,21428147.64,,
2025-05-13,1114.5,marketing_spend,out,Counterparty_1,21427033.14,2025-04-20,2025-05-25
2025-05-13,2500.06,T&E,out,Counterparty_51,21424533.08,2025-03-31,2025-04-26
2025-05-13,814.8,tax_payment,out,Counterparty_17,21423718.28,2025-04-26,2025-06-04
2025-05-13,1093.39,software_subscription,out,Counterparty_16,21422624.89,2025-03-31,2025-05-08
2025-05-13,141.31,investment_income,in,Counterparty_42,21422766.2,,
2025-05-13,3078.36,supplier_payment,out,Counterparty_97,21419687.84,2025-04-16,2025-05-22
2025-05-13,731.7,marketing_spend,out,Counterparty_38,21418956.14,2025-04-17,2025-05-25
2025-05-13,2146.27,refund,in,Counterparty_8,21421102.41,,
2025-05-13,2813.72,rent,out,Counterparty_16,21418288.69,2025-04-27,2025-05-30
2025-05-13,44.7,software_subscription,out,Counterparty_94,21418243.99,2025-04-17,2025-05-22
2025-05-13,288.65,marketing_spend,out,Counterparty_41,21417955.34,2025-04-02,2025-05-10
2025-05-13,2093.41,asset_sale,in,Counterparty_15,21420048.75,,
2025-05-13,673.08,customer_payment,in,Counterparty_41,21420721.83,,
2025-05-13,1660.51,supplier_payment,out,Counterparty_27,21419061.32,2025-04-06,2025-05-13
2025-05-14,4.53,T&E,out,Counterparty_66,21419056.79,2025-04-19,2025-05-18
2025-05-14,3876.75,software_subscription,out,Counterparty_92,21415180.04,2025-04-16,2025-05-23
2025-05-14,310.09,utilities,out,Counterparty_9,21414869.95,2025-04-14,2025-05-17
2025-05-14,761.56,rent,out,Counterparty_45,21414108.39,2025-04-22,2025-05-24
2025-05-14,704.32,investment_income,in,Counterparty_41,21414812.71,,
2025-05-14,5324.59,payroll,out,Counterparty_15,21409488.12,2025-04-29,2025-05-29
2025-05-14,4003.01,marketing_spend,out,Counterparty_60,21405485.11,2025-04-26,2025-06-02
2025-05-14,141.72,investment_income,in,Counterparty_73,21405626.83,,
2025-05-14,183.17,software_subscription,out,Counterparty_28,21405443.66,2025-04-28,2025-06-02
2025-05-14,365.89,supplier_payment,out,Counterparty_36,21405077.77,2025-04-06,2025-05-11
2025-05-14,2106.97,customer_payment,in,Counterparty_48,21407184.74,,
2025-05-14,151.75,asset_sale,in,Counterparty_74,21407336.49,,
2025-05-14,740.27,refund,in,Counterparty_26,21408076.76,,
2025-05-14,5445.81,T&E,out,Counterparty_62,21402630.95,2025-04-09,2025-05-06
2025-05-14,3646.04,refund,in,Counterparty_81,21406276.99,,
2025-05-14,131.3,customer_payment,in,Counterparty_30,21406408.29,,
2025-05-14,745.28,payroll,out,Counterparty_84,21405663.01,2025-04-04,2025-04-30
2025-05-14,2304.62,software_subscription,out,Counterparty_36,21403358.39,2025-04-29,2025-06-06
2025-05-14,802.04,utilities,out,Counterparty_96,21402556.35,2025-04-19,2025-05-24
2025-05-14,1500.76,loan_repayment,out,Counterparty_67,21401055.59,2025-04-29,2025-05-29
2025-05-14,2868.67,rent,out,Counterparty_97,21398186.92,2025-04-20,2025-05-25
2025-05-14,4837.88,customer_payment,in,Counterparty_40,21403024.8,,
2025-05-14,934.14,asset_sale,in,Counterparty_91,21403958.94,,
2025-05-14,887.07,software_subscription,out,Counterparty_57,21403071.87,2025-04-24,2025-05-22
2025-05-14,3063.61,tax_payment,out,Counterparty_72,21400008.26,2025-04-12,2025-05-18
2025-05-14,4632.68,customer_payment,in,Counterparty_18,21404640.94,,
2025-05-14,2069.19,supplier_payment,out,Counterparty_83,21402571.75,2025-04-02,2025-05-02
2025-05-14,3551.61,credit,in,Counterparty_95,21406123.36,,
2025-05-14,784.83,investment_income,in,Counterparty_91,21406908.19,,
2025-05-14,2141.38,asset_sale,in,Counterparty_75,21409049.57,,
2025-05-14,578.72,utilities,out,Counterparty_76,21408470.85,2025-04-19,2025-05-15
2025-05-14,5130.69,supplier_payment,out,Counterparty_7,21403340.16,2025-04-08,2025-05-12
2025-05-14,3127.21,asset_sale,in,Counterparty_81,21406467.37,,
2025-05-14,1862.16,marketing_spend,out,Counterparty_52,21404605.21,2025-04-25,2025-05-22
2025-05-14,4180.67,software_subscription,out,Counterparty_80,21400424.54,2025-04-08,2025-05-12
2025-05-14,979.74,customer_payment,in,Counterparty_75,21401404.28,,
2025-05-14,120.68,asset_sale,in,Counterparty_78,21401524.96,,
2025-05-14,1467.83,loan_repayment,out,Counterparty_63,21400057.13,2025-04-16,2025-05-25
2025-05-14,5274.85,payroll,out,Counterparty_61,21394782.28,2025-04-10,2025-05-13
2025-05-14,1114.32,rent,out,Counterparty_10,21393667.96,2025-03-31,2025-05-01
2025-05-14,1684.03,supplier_payment,out,Counterparty_33,21391983.93,2025-04-29,2025-05-31
2025-05-14,37.74,payroll,out,Counterparty_15,21391946.19,2025-03-31,2025-05-06
2025-05-14,313.44,refund,in,Counterparty_82,21392259.63,,
2025-05-14,6008.73,payroll,out,Counterparty_89,21386250.9,2025-04-15,2025-05-21
2025-05-14,3928.0,tax_payment,out,Counterparty_50,21382322.9,2025-04-12,2025-05-17
2025-05-14,4851.5,customer_payment,in,Counterparty_2,21387174.4,,
2025-05-14,954.13,rent,out,Counterparty_75,21386220.27,2025-04-07,2025-05-12
2025-05-14,4269.56,utilities,out,Counterparty_18,21381950.71,2025-04-02,2025-05-07
2025-05-14,1488.25,payroll,out,Counterparty_77,21380462.46,2025-04-01,2025-04-30
2025-05-14,853.4,utilities,out,Counterparty_74,21379609.06,2025-04-03,2025-04-29
2025-05-14,1306.66,rent,out,Counterparty_37,21378302.4,2025-04-14,2025-05-17
2025-05-14,2289.81,tax_payment,out,Counterparty_60,21376012.59,2025-04-05,2025-05-06
2025-05-14,5740.92,refund,in,Counterparty_72,21381753.51,,
2025-05-14,1566.82,utilities,out,Counterparty_4,21380186.69,2025-04-04,2025-05-04
2025-05-15,199.07,supplier_payment,out,Counterparty_55,21379987.62,2025-04-23,2025-05-29
2025-05-15,5156.37,customer_payment,in,Counterparty_92,21385143.99,,
2025-05-15,4350.93,refund,in,Counterparty_70,21389494.92,,
2025-05-15,3661.77,T&E,out,Counterparty_63,21385833.15,2025-04-08,2025-05-06
2025-05-15,460.22,utilities,out,Counterparty_44,21385372.93,2025-04-09,2025-05-05
2025-05-15,2392.15,credit,in,Counterparty_61,21387765.08,,
2025-05-15,8536.3,credit,in,Counterparty_53,21396301.38,,
2025-05-15,3127.94,customer_payment,in,Counterparty_69,21399429.32,,
2025-05-15,4431.21,software_subscription,out,Counterparty_77,21394998.11,2025-04-07,2025-05-05
2025-05-15,1122.37,payroll,out,Counterparty_94,21393875.74,2025-04-17,2025-05-23
2025-05-15,1501.99,rent,out,Counterparty_65,21392373.75,2025-04-08,2025-05-10
2025-05-15,2369.32,T&E,out,Counterparty_79,21390004.43,2025-04-15,2025-05-12
2025-05-15,631.74,payroll,out,Counterparty_83,21389372.69,2025-04-21,2025-05-16
2025-05-15,0.19,T&E,out,Counterparty_48,21389372.5,2025-04-26,2025-06-02
2025-05-15,5758.94,refund,in,Counterparty_6,21395131.44,,
2025-05-15,2759.03,marketing_spend,out,Counterparty_4,21392372.41,2025-04-13,2025-05-19
2025-05-15,110.19,utilities,out,Counterparty_37,21392262.22,2025-04-24,2025-05-27
2025-05-15,236.06,loan_repayment,out,Counterparty_97,21392026.16,2025-04-10,2025-05-12
2025-05-15,1049.96,rent,out,Counterparty_41,21390976.2,2025-04-02,2025-04-28
2025-05-15,3.24,payroll,out,Counterparty_41,21390972.96,2025-04-16,2025-05-21
2025-05-15,144.94,software_subscription,out,Counterparty_61,21390828.02,2025-04-15,2025-05-12
2025-05-15,1382.71,supplier_payment,out,Counterparty_31,21389445.31,2025-04-19,2025-05-25
2025-05-15,389.69,software_subscription,out,Counterparty_46,21389055.62,2025-04-09,2025-05-11
2025-05-15,6862.72,rent,out,Counterparty_19,21382192.9,2025-04-14,2025-05-14
2025-05-15,788.84,refund,in,Counterparty_80,21382981.74,,
2025-05-15,46.59,loan_repayment,out,Counterparty_67,21382935.15,2025-04-28,2025-05-31
2025-05-15,1909.34,T&E,out,Counterparty_11,21381025.81,2025-04-25,2025-05-23
2025-05-15,3425.3,customer_payment,in,Counterparty_57,21384451.11,,
2025-05-15,2081.34,refund,in,Counterparty_33,21386532.45,,
2025-05-15,1564.84,refund,in,Counterparty_13,21388097.29,,
2025-05-15,6623.19,rent,out,Counterparty_50,21381474.1,2025-04-17,2025-05-23
2025-05-15,611.9,refund,in,Counterparty_96,21382086.0,,
2025-05-15,1143.09,investment_income,in,Counterparty_9,21383229.09,,
2025-05-15,299.57,loan_repayment,out,Counterparty_95,21382929.52,2025-04-08,2025-05-05
2025-05-15,742.68,refund,in,Counterparty_71,21383672.2,,
2025-05-15,2809.89,investment_income,in,Counterparty_46,21386482.09,,
2025-05-15,601.09,marketing_spend,out,Counterparty_68,21385881.0,2025-04-19,2025-05-25
2025-05-15,1704.91,credit,in,Counterparty_26,21387585.91,,
2025-05-15,769.6,asset_sale,in,Counterparty_60,21388355.51,,
2025-05-15,649.39,customer_payment,in,Counterparty_28,21389004.9,,
2025-05-15,978.43,payroll,out,Counterparty_52,21388026.47,2025-04-19,2025-05-16
2025-05-15,997.93,loan_repayment,out,Counterparty_69,21387028.54,2025-04-15,2025-05-12
2025-05-15,175.12,payroll,out,Counterparty_67,21386853.42,2025-04-15,2025-05-22
2025-05-15,389.63,asset_sale,in,Counterparty_85,21387243.05,,
2025-05-15,536.17,refund,in,Counterparty_62,21387779.22,,
2025-05-15,205.77,tax_payment,out,Counterparty_11,21387573.45,2025-04-17,2025-05-22
2025-05-15,1030.71,payroll,out,Counterparty_2,21386542.74,2025-04-27,2025-05-30
2025-05-15,1028.33,credit,in,Counterparty_33,21387571.07,,
2025-05-15,5456.8,customer_payment,in,Counterparty_12,21393027.87,,
2025-05-15,984.66,refund,in,Counterparty_9,21394012.53,,
2025-05-15,1497.33,asset_sale,in,Counterparty_49,21395509.86,,
2025-05-15,1310.19,rent,out,Counterparty_78,21394199.67,2025-04-14,2025-05-16
2025-05-15,2759.58,rent,out,Counterparty_74,21391440.09,2025-04-23,2025-05-21
2025-05-15,943.8,payroll,out,Counterparty_29,21390496.29,2025-04-16,2025-05-24
2025-05-15,2272.24,loan_repayment,out,Counterparty_82,21388224.05,2025-04-12,2025-05-13
2025-05-15,1158.87,loan_repayment,out,Counterparty_23,21387065.18,2025-04-29,2025-06-01
2025-05-16,1942.3,credit,in,Counterparty_63,21389007.48,,
2025-05-16,1913.14,payroll,out,Counterparty_84,21387094.34,2025-04-12,2025-05-11
2025-05-16,870.43,payroll,out,Counterparty_27,21386223.91,2025-05-01,2025-06-03
2025-05-16,2872.86,utilities,out,Counterparty_20,21383351.05,2025-04-17,2025-05-24
2025-05-16,2188.57,credit,in,Counterparty_64,21385539.62,,
2025-05-16,4009.38,loan_repayment,out,Counterparty_52,21381530.24,2025-04-28,2025-05-30
2025-05-16,1835.69,investment_income,in,Counterparty_23,21383365.93,,
2025-05-16,3009.14,utilities,out,Counterparty_75,21380356.79,2025-05-01,2025-05-26
2025-05-16,2155.15,credit,in,Counterparty_62,21382511.94,,
2025-05-16,9711.45,asset_sale,in,Counterparty_58,21392223.39,,
2025-05-16,4802.96,credit,in,Counterparty_99,21397026.35,,
2025-05-16,534.79,credit,in,Counterparty_31,21397561.14,,
2025-05-16,3135.93,tax_payment,out,Counterparty_28,21394425.21,2025-04-13,2025-05-16
2025-05-16,4516.99,marketing_spend,out,Counterparty_78,21389908.22,2025-04-14,2025-05-11
2025-05-16,8250.67,loan_repayment,out,Counterparty_90,21381657.55,2025-04-15,2025-05-20
2025-05-16,10667.43,customer_payment,in,Counterparty_24,21392324.98,,
2025-05-16,1993.5,asset_sale,in,Counterparty_16,21394318.48,,
2025-05-16,8433.89,loan_repayment,out,Counterparty_78,21385884.59,2025-04-02,2025-05-05
2025-05-16,1379.06,investment_income,in,Counterparty_64,21387263.65,,
2025-05-16,2294.65,customer_payment,in,Counterparty_35,21389558.3,,
2025-05-16,306.94,payroll,out,Counterparty_18,21389251.36,2025-04-10,2025-05-06
2025-05-16,2425.22,utilities,out,Counterparty_19,21386826.14,2025-04-02,2025-05-06
2025-05-16,6461.91,tax_payment,out,Counterparty_67,21380364.23,2025-04-27,2025-06-03
2025-05-16,1284.74,T&E,out,Counterparty_65,21379079.49,2025-04-15,2025-05-22
2025-05-16,1193.35,loan_repayment,out,Counterparty_28,21377886.14,2025-04-10,2025-05-13
2025-05-16,389.08,customer_payment,in,Counterparty_26,21378275.22,,
2025-05-16,5624.36,tax_payment,out,Counterparty_41,21372650.86,2025-04-13,2025-05-13
2025-05-16,1415.26,refund,in,Counterparty_14,21374066.12,,
2025-05-16,858.48,utilities,out,Counterparty_72,21373207.64,2025-04-24,2025-05-19
2025-05-16,1740.25,credit,in,Counterparty_43,21374947.89,,
2025-05-16,962.44,software_subscription,out,Counterparty_19,21373985.45,2025-04-24,2025-05-29
2025-05-16,727.38,software_subscription,out,Counterparty_92,21373258.07,2025-04-02,2025-05-02
2025-05-16,2970.76,customer_payment,in,Counterparty_27,21376228.83,,
2025-05-16,732.82,software_subscription,out,Counterparty_47,21375496.01,2025-05-01,2025-05-28
2025-05-16,3065.89,T&E,out,Counterparty_53,21372430.12,2025-04-13,2025-05-10
2025-05-16,7682.03,supplier_payment,out,Counterparty_32,21364748.09,2025-04-21,2025-05-24
2025-05-16,359.18,software_subscription,out,Counterparty_1,21364388.91,2025-04-07,2025-05-03
2025-05-16,150.77,supplier_payment,out,Counterparty_35,21364238.14,2025-04-18,2025-05-14
2025-05-16,1045.74,utilities,out,Counterparty_20,21363192.4,2025-04-24,2025-05-19
2025-05-16,404.42,credit,in,Counterparty_3,21363596.82,,
2025-05-16,938.97,investment_income,in,Counterparty_60,21364535.79,,
2025-05-16,446.97,T&E,out,Counterparty_45,21364088.82,2025-04-25,2025-05-23
2025-05-16,1376.3,rent,out,Counterparty_39,21362712.52,2025-04-02,2025-05-04
2025-05-16,1328.59,tax_payment,out,Counterparty_68,21361383.93,2025-04-21,2025-05-24
2025-05-16,1177.64,customer_payment,in,Counterparty_15,21362561.57,,
2025-05-16,233.32,T&E,out,Counterparty_78,21362328.25,2025-04-05,2025-05-12
2025-05-16,1160.41,payroll,out,Counterparty_53,21361167.84,2025-04-15,2025-05-24
2025-05-16,3134.25,software_subscription,out,Counterparty_41,21358033.59,2025-04-30,2025-05-27
2025-05-16,2993.42,marketing_spend,out,Counterparty_6,21355040.17,2025-04-14,2025-05-15
2025-05-16,5408.75,tax_payment,out,Counterparty_44,21349631.42,2025-04-20,2025-05-18
2025-05-16,874.79,supplier_payment,out,Counterparty_67,21348756.63,2025-04-29,2025-06-02
2025-05-16,908.77,investment_income,in,Counterparty_39,21349665.4,,
2025-05-16,734.39,tax_payment,out,Counterparty_33,21348931.01,2025-04-18,2025-05-14
2025-05-16,529.62,utilities,out,Counterparty_84,21348401.39,2025-04-28,2025-05-25
2025-05-16,6156.57,customer_payment,in,Counterparty_27,21354557.96,,
2025-05-16,533.92,loan_repayment,out,Counterparty_72,21354024.04,2025-04-20,2025-05-21
2025-05-16,646.51,loan_repayment,out,Counterparty_17,21353377.53,2025-04-23,2025-05-24
2025-05-16,40.86,nsf_fee,out,Counterparty_71,21353336.67,2025-04-02,2025-05-03
2025-05-16,714.83,software_subscription,out,Counterparty_2,21352621.84,2025-04-19,2025-05-16
2025-05-16,3024.14,tax_payment,out,Counterparty_59,21349597.7,2025-04-27,2025-05-31
2025-05-16,1868.58,loan_repayment,out,Counterparty_88,21347729.12,2025-04-09,2025-05-16
2025-05-16,1802.73,investment_income,in,Counterparty_52,21349531.85,,
2025-05-16,174.21,T&E,out,Counterparty_41,21349357.64,2025-04-11,2025-05-09
2025-05-16,4704.59,credit,in,Counterparty_72,21354062.23,,
2025-05-16,4297.67,supplier_payment,out,Counterparty_78,21349764.56,2025-04-04,2025-05-01
2025-05-16,233.92,rent,out,Counterparty_20,21349530.64,2025-04-11,2025-05-20
2025-05-16,6924.77,credit,in,Counterparty_89,21356455.41,,
2025-05-16,881.13,investment_income,in,Counterparty_30,21357336.54,,
2025-05-16,3743.25,credit,in,Counterparty_38,21361079.79,,
2025-05-16,3496.58,asset_sale,in,Counterparty_72,21364576.37,,
2025-05-16,4142.38,customer_payment,in,Counterparty_49,21368718.75,,
2025-05-16,5733.66,asset_sale,in,Counterparty_36,21374452.41,,
2025-05-16,2847.86,credit,in,Counterparty_96,21377300.27,,
2025-05-16,1449.86,loan_repayment,out,Counterparty_69,21375850.41,2025-04-26,2025-05-24
2025-05-16,2064.1,T&E,out,Counterparty_42,21373786.31,2025-04-18,2025-05-19
2025-05-16,2849.51,credit,in,Counterparty_1,21376635.82,,
2025-05-16,7439.74,asset_sale,in,Counterparty_83,21384075.56,,
2025-05-16,450.25,payroll,out,Counterparty_74,21383625.31,2025-04-13,2025-05-21
2025-05-17,1060.32,refund,in,Counterparty_80,21384685.63,,
2025-05-17,2509.57,tax_payment,out,Counterparty_69,21382176.06,2025-04-06,2025-05-05
2025-05-17,5495.85,asset_sale,in,Counterparty_37,21387671.91,,
2025-05-17,3454.62,tax_payment,out,Counterparty_56,21384217.29,2025-04-30,2025-06-06
2025-05-17,2751.81,software_subscription,out,Counterparty_39,21381465.48,2025-04-21,2025-05-27
2025-05-17,259.77,loan_repayment,out,Counterparty_4,21381205.71,2025-04-19,2025-05-23
2025-05-17,4613.85,utilities,out,Counterparty_76,21376591.86,2025-04-06,2025-05-04
2025-05-17,88.39,loan_repayment,out,Counterparty_93,21376503.47,2025-04-13,2025-05-12
2025-05-17,2207.29,refund,in,Counterparty_50,21378710.76,,
2025-05-17,1072.99,marketing_spend,out,Counterparty_93,21377637.77,2025-04-20,2025-05-22
2025-05-17,8178.2,rent,out,Counterparty_50,21369459.57,2025-04-25,2025-06-02
2025-05-17,1380.36,T&E,out,Counterparty_17,21368079.21,2025-04-29,2025-06-03
2025-05-17,533.81,payroll,out,Counterparty_22,21367545.4,2025-04-29,2025-05-30
2025-05-17,1550.56,T&E,out,Counterparty_49,21365994.84,2025-04-16,2025-05-19
2025-05-17,182.38,rent,out,Counterparty_98,21365812.46,2025-04-26,2025-05-26
2025-05-17,585.79,investment_income,in,Counterparty_81,21366398.25,,
2025-05-17,9859.37,refund,in,Counterparty_85,21376257.62,,
2025-05-17,1577.44,asset_sale,in,Counterparty_87,21377835.06,,
2025-05-17,5643.21,investment_income,in,Counterparty_54,21383478.27,,
2025-05-17,472.46,investment_income,in,Counterparty_94,21383950.73,,
2025-05-17,1154.26,software_subscription,out,Counterparty_25,21382796.47,2025-04-13,2025-05-18
2025-05-17,1610.26,rent,out,Counterparty_2,21381186.21,2025-04-21,2025-05-22
2025-05-17,1066.38,supplier_payment,out,Counterparty_42,21380119.83,2025-04-26,2025-05-28
2025-05-17,138.59,T&E,out,Counterparty_44,21379981.24,2025-04-26,2025-05-25
2025-05-17,2610.1,utilities,out,Counterparty_63,21377371.14,2025-04-08,2025-05-11
2025-05-17,185.11,marketing_spend,out,Counterparty_47,21377186.03,2025-04-10,2025-05-13
2025-05-17,1670.58,rent,out,Counterparty_11,21375515.45,2025-05-01,2025-06-07
2025-05-17,554.73,refund,in,Counterparty_43,21376070.18,,
2025-05-17,3217.64,customer_payment,in,Counterparty_32,21379287.82,,
2025-05-17,641.3,T&E,out,Counterparty_66,21378646.52,2025-04-10,2025-05-12
2025-05-17,2111.9,utilities,out,Counterparty_93,21376534.62,2025-04-04,2025-05-03
2025-05-17,3404.63,refund,in,Counterparty_86,21379939.25,,
2025-05-17,2801.67,utilities,out,Counterparty_64,21377137.58,2025-04-19,2025-05-17
2025-05-17,1172.39,credit,in,Counterparty_30,21378309.97,,
2025-05-17,3587.32,software_subscription,out,Counterparty_42,21374722.65,2025-04-06,2025-05-04
2025-05-17,697.73,software_subscription,out,Counterparty_71,21374024.92,2025-04-23,2025-06-01
2025-05-17,2815.32,supplier_payment,out,Counterparty_85,21371209.6,2025-04-13,2025-05-12
2025-05-17,4863.92,supplier_payment,out,Counterparty_99,21366345.68,2025-04-09,2025-05-15
2025-05-17,2623.68,software_subscription,out,Counterparty_92,21363722.0,2025-04-07,2025-05-09
2025-05-17,12873.22,credit,in,Counterparty_20,21376595.22,,
2025-05-17,1126.88,customer_payment,in,Counterparty_2,21377722.1,,
2025-05-17,4449.08,asset_sale,in,Counterparty_26,21382171.18,,
2025-05-17,2697.69,utilities,out,Counterparty_39,21379473.49,2025-04-25,2025-05-27
2025-05-17,3520.65,refund,in,Counterparty_27,21382994.14,,
2025-05-17,343.7,tax_payment,out,Counterparty_8,21382650.44,2025-04-20,2025-05-27
2025-05-17,3107.1,marketing_spend,out,Counterparty_58,21379543.34,2025-04-06,2025-05-05
2025-05-17,7061.59,refund,in,Counterparty_73,21386604.93,,
2025-05-17,1006.14,customer_payment,in,Counterparty_29,21387611.07,,
2025-05-17,74.61,refund,in,Counterparty_89,21387685.68,,
2025-05-17,1833.42,rent,out,Counterparty_66,21385852.26,2025-04-17,2025-05-18
2025-05-17,3924.89,investment_income,in,Counterparty_84,21389777.15,,
2025-05-17,5871.94,asset_sale,in,Counterparty_39,21395649.09,,
2025-05-17,1829.24,refund,in,Counterparty_31,21397478.33,,
2025-05-17,422.49,asset_sale,in,Counterparty_77,21397900.82,,
2025-05-17,5169.34,software_subscription,out,Counterparty_54,21392731.48,2025-04-08,2025-05-04
2025-05-18,1732.18,loan_repayment,out,Counterparty_11,21390999.3,2025-04-13,2025-05-08
2025-05-18,285.25,tax_payment,out,Counterparty_6,21390714.05,2025-04-17,2025-05-26
2025-05-18,2049.36,investment_income,in,Counterparty_50,21392763.41,,
2025-05-18,6996.53,refund,in,Counterparty_77,21399759.94,,
2025-05-18,1114.68,asset_sale,in,Counterparty_96,21400874.62,,
2025-05-18,2465.4,T&E,out,Counterparty_92,21398409.22,2025-05-02,2025-06-08
2025-05-18,1120.79,marketing_spend,out,Counterparty_84,21397288.43,2025-04-28,2025-06-01
2025-05-18,27.98,supplier_payment,out,Counterparty_12,21397260.45,2025-04-10,2025-05-07
2025-05-18,2525.58,credit,in,Counterparty_42,21399786.03,,
2025-05-18,2601.01,asset_sale,in,Counterparty_23,21402387.04,,
2025-05-18,4434.75,customer_payment,in,Counterparty_41,21406821.79,,
2025-05-18,4527.0,rent,out,Counterparty_52,21402294.79,2025-04-07,2025-05-14
2025-05-18,1375.65,asset_sale,in,Counterparty_5,21403670.44,,
2025-05-18,4198.04,loan_repayment,out,Counterparty_31,21399472.4,2025-04-26,2025-05-26
2025-05-18,118.01,investment_income,in,Counterparty_41,21399590.41,,
2025-05-18,3510.79,investment_income,in,Counterparty_41,21403101.2,,
2025-05-18,6411.48,customer_payment,in,Counterparty_21,21409512.68,,
2025-05-18,1043.45,loan_repayment,out,Counterparty_10,21408469.23,2025-04-19,2025-05-17
2025-05-18,1623.55,refund,in,Counterparty_40,21410092.78,,
2025-05-18,1918.96,utilities,out,Counterparty_39,21408173.82,2025-04-10,2025-05-09
2025-05-18,591.62,utilities,out,Counterparty_93,21407582.2,2025-04-14,2025-05-23
2025-05-18,3506.51,asset_sale,in,Counterparty_48,21411088.71,,
2025-05-18,206.98,utilities,out,Counterparty_48,21410881.73,2025-04-05,2025-05-13
2025-05-18,108.03,rent,out,Counterparty_83,21410773.7,2025-04-30,2025-06-05
2025-05-18,1449.09,utilities,out,Counterparty_30,21409324.61,2025-04-29,2025-05-27
2025-05-18,1335.39,utilities,out,Counterparty_48,21407989.22,2025-04-23,2025-05-27
2025-05-18,116.87,customer_payment,in,Counterparty_92,21408106.09,,
2025-05-18,1811.83,refund,in,Counterparty_79,21409917.92,,
2025-05-18,650.99,payroll,out,Counterparty_98,21409266.93,2025-04-21,2025-05-30
2025-05-18,1340.43,marketing_spend,out,Counterparty_53,21407926.5,2025-04-20,2025-05-24
2025-05-18,2388.65,asset_sale,in,Counterparty_82,21410315.15,,
2025-05-18,1154.51,refund,in,Counterparty_18,21411469.66,,
2025-05-18,2116.96,payroll,out,Counterparty_80,21409352.7,2025-04-25,2025-05-28
2025-05-18,1985.12,loan_repayment,out,Counterparty_40,21407367.58,2025-04-16,2025-05-13
2025-05-18,190.48,credit,in,Counterparty_76,21407558.06,,
2025-05-18,10431.61,marketing_spend,out,Counterparty_11,21397126.45,2025-04-26,2025-05-29
2025-05-18,1092.01,marketing_spend,out,Counterparty_48,21396034.44,2025-04-26,2025-05-23
2025-05-18,3591.43,customer_payment,in,Counterparty_91,21399625.87,,
2025-05-18,62.43,T&E,out,Counterparty_52,21399563.44,2025-04-28,2025-05-27
2025-05-18,3499.62,asset_sale,in,Counterparty_85,21403063.06,,
2025-05-18,1773.17,customer_payment,in,Counterparty_75,21404836.23,,
2025-05-18,4192.83,asset_sale,in,Counterparty_24,21409029.06,,
2025-05-18,442.06,loan_repayment,out,Counterparty_72,21408587.0,2025-04-12,2025-05-17
2025-05-18,35.05,marketing_spend,out,Counterparty_41,21408551.95,2025-04-26,2025-05-21
2025-05-18,870.78,asset_sale,in,Counterparty_14,21409422.73,,
2025-05-18,1203.86,supplier_payment,out,Counterparty_61,21408218.87,2025-04-10,2025-05-14
2025-05-18,5494.11,supplier_payment,out,Counterparty_84,21402724.76,2025-04-20,2025-05-26
2025-05-18,821.42,marketing_spend,out,Counterparty_74,21401903.34,2025-04-21,2025-05-30
2025-05-18,2098.68,asset_sale,in,Counterparty_3,21404002.02,,
2025-05-18,2182.98,supplier_payment,out,Counterparty_34,21401819.04,2025-04-12,2025-05-09
2025-05-18,932.81,supplier_payment,out,Counterparty_9,21400886.23,2025-04-12,2025-05-20
2025-05-18,544.98,rent,out,Counterparty_54,21400341.25,2025-04-06,2025-05-01
2025-05-18,3494.66,refund,in,Counterparty_9,21403835.91,,
2025-05-18,601.57,marketing_spend,out,Counterparty_63,21403234.34,2025-04-08,2025-05-10
2025-05-18,5692.56,supplier_payment,out,Counterparty_6,21397541.78,2025-04-29,2025-05-27
2025-05-18,269.53,loan_repayment,out,Counterparty_73,21397272.25,2025-04-15,2025-05-24
2025-05-19,1696.51,loan_repayment,out,Counterparty_17,21395575.74,2025-04-15,2025-05-22
2025-05-19,2803.71,T&E,out,Counterparty_52,21392772.03,2025-04-19,2025-05-26
2025-05-19,415.82,supplier_payment,out,Counterparty_4,21392356.21,2025-05-02,2025-06-10
2025-05-19,4056.1,refund,in,Counterparty_5,21396412.31,,
2025-05-19,819.61,loan_repayment,out,Counterparty_68,21395592.7,2025-05-01,2025-06-04
2025-05-19,6819.07,payroll,out,Counterparty_1,21388773.63,2025-04-18,2025-05-26
2025-05-19,530.79,rent,out,Counterparty_79,21388242.84,2025-05-02,2025-05-27
2025-05-19,2570.16,tax_payment,out,Counterparty_48,21385672.68,2025-04-22,2025-05-28
2025-05-19,4640.23,asset_sale,in,Counterparty_84,21390312.91,,
2025-05-19,5453.87,software_subscription,out,Counterparty_79,21384859.04,2025-04-18,2025-05-18
2025-05-19,919.19,refund,in,Counterparty_73,21385778.23,,
2025-05-19,802.56,supplier_payment,out,Counterparty_96,21384975.67,2025-04-16,2025-05-21
2025-05-19,1032.47,loan_repayment,out,Counterparty_51,21383943.2,2025-04-14,2025-05-23
2025-05-19,2040.88,investment_income,in,Counterparty_84,21385984.08,,
2025-05-19,2053.72,asset_sale,in,Counterparty_82,21388037.8,,
2025-05-19,418.98,T&E,out,Counterparty_22,21387618.82,2025-04-22,2025-05-19
2025-05-19,1299.6,payroll,out,Counterparty_45,21386319.22,2025-04-19,2025-05-23
2025-05-19,2010.09,software_subscription,out,Counterparty_1,21384309.13,2025-04-26,2025-06-04
2025-05-19,4559.18,rent,out,Counterparty_77,21379749.95,2025-05-01,2025-06-05
2025-05-19,2485.3,marketing_spend,out,Counterparty_24,21377264.65,2025-04-30,2025-05-26
2025-05-19,2668.66,investment_income,in,Counterparty_48,21379933.31,,
2025-05-19,1548.93,refund,in,Counterparty_89,21381482.24,,
2025-05-19,7988.72,tax_payment,out,Counterparty_34,21373493.52,2025-04-05,2025-05-09
2025-05-19,844.09,tax_payment,out,Counterparty_4,21372649.43,2025-04-07,2025-05-10
2025-05-19,1061.89,utilities,out,Counterparty_18,21371587.54,2025-04-07,2025-05-02
2025-05-19,2288.84,supplier_payment,out,Counterparty_78,21369298.7,2025-04-23,2025-05-21
2025-05-19,3067.69,tax_payment,out,Counterparty_19,21366231.01,2025-04-16,2025-05-17
2025-05-19,977.61,rent,out,Counterparty_76,21365253.4,2025-04-09,2025-05-11
2025-05-19,2115.6,tax_payment,out,Counterparty_93,21363137.8,2025-04-12,2025-05-08
2025-05-19,2001.89,customer_payment,in,Counterparty_3,21365139.69,,
2025-05-19,6464.69,credit,in,Counterparty_24,21371604.38,,
2025-05-19,4158.3,payroll,out,Counterparty_43,21367446.08,2025-05-03,2025-06-08
2025-05-19,363.25,refund,in,Counterparty_22,21367809.33,,
2025-05-19,4722.97,credit,in,Counterparty_57,21372532.3,,
2025-05-19,446.0,investment_income,in,Counterparty_84,21372978.3,,
2025-05-19,884.29,software_subscription,out,Counterparty_36,21372094.01,2025-05-01,2025-05-29
2025-05-19,5914.66,utilities,out,Counterparty_36,21366179.35,2025-04-05,2025-05-11
2025-05-19,2921.16,loan_repayment,out,Counterparty_30,21363258.19,2025-04-11,2025-05-10
2025-05-19,2849.17,payroll,out,Counterparty_89,21360409.02,2025-04-12,2025-05-13
2025-05-19,3903.93,credit,in,Counterparty_32,21364312.95,,
2025-05-19,1929.4,loan_repayment,out,Counterparty_98,21362383.55,2025-04-30,2025-05-31
2025-05-19,256.52,T&E,out,Counterparty_62,21362127.03,2025-04-25,2025-05-29
2025-05-19,1759.94,supplier_payment,out,Counterparty_67,21360367.09,2025-04-13,2025-05-22
2025-05-19,127.04,loan_repayment,out,Counterparty_43,21360240.05,2025-04-11,2025-05-11
2025-05-19,2831.92,supplier_payment,out,Counterparty_52,21357408.13,2025-04-23,2025-06-01
2025-05-19,7467.25,asset_sale,in,Counterparty_70,21364875.38,,
2025-05-19,37.07,refund,in,Counterparty_59,21364912.45,,
2025-05-19,872.14,supplier_payment,out,Counterparty_45,21364040.31,2025-04-14,2025-05-16
2025-05-19,2286.46,software_subscription,out,Counterparty_14,21361753.85,2025-04-16,2025-05-20
2025-05-19,1778.79,asset_sale,in,Counterparty_8,21363532.64,,
2025-05-19,938.41,refund,in,Counterparty_1,21364471.05,,
2025-05-20,525.97,software_subscription,out,Counterparty_42,21363945.08,2025-04-26,2025-05-21
2025-05-20,4732.97,credit,in,Counterparty_21,21368678.05,,
2025-05-20,6188.08,investment_income,in,Counterparty_80,21374866.13,,
2025-05-20,308.45,investment_income,in,Counterparty_41,21375174.58,,
2025-05-20,715.72,utilities,out,Counterparty_55,21374458.86,2025-04-15,2025-05-14
2025-05-20,481.84,rent,out,Counterparty_74,21373977.02,2025-04-11,2025-05-13
2025-05-20,1542.96,asset_sale,in,Counterparty_8,21375519.98,,
2025-05-20,223.57,credit,in,Counterparty_81,21375743.55,,
2025-05-20,3318.84,investment_income,in,Counterparty_61,21379062.39,,
2025-05-20,5322.32,asset_sale,in,Counterparty_98,21384384.71,,
2025-05-20,229.05,tax_payment,out,Counterparty_85,21384155.66,2025-04-25,2025-05-28
2025-05-20,2094.77,investment_income,in,Counterparty_91,21386250.43,,
2025-05-20,174.16,tax_payment,out,Counterparty_36,21386076.27,2025-04-09,2025-05-06
2025-05-20,4443.16,refund,in,Counterparty_94,21390519.43,,
2025-05-20,786.91,marketing_spend,out,Counterparty_4,21389732.52,2025-04-29,2025-05-28
2025-05-20,483.28,marketing_spend,out,Counterparty_7,21389249.24,2025-05-02,2025-06-05
2025-05-20,4390.18,supplier_payment,out,Counterparty_35,21384859.06,2025-04-24,2025-05-31
2025-05-20,357.78,marketing_spend,out,Counterparty_51,21384501.28,2025-04-21,2025-05-25
2025-05-20,1171.86,tax_payment,out,Counterparty_96,21383329.42,2025-05-02,2025-06-09
2025-05-20,1997.44,rent,out,Counterparty_64,21381331.98,2025-04-19,2025-05-16
2025-05-20,1724.64,T&E,out,Counterparty_46,21379607.34,2025-04-12,2025-05-15
2025-05-20,752.75,supplier_payment,out,Counterparty_8,21378854.59,2025-04-08,2025-05-11
2025-05-20,4225.97,marketing_spend,out,Counterparty_39,21374628.62,2025-04-14,2025-05-15
2025-05-20,2174.4,loan_repayment,out,Counterparty_56,21372454.22,2025-04-16,2025-05-15
2025-05-20,1463.67,supplier_payment,out,Counterparty_91,21370990.55,2025-04-28,2025-06-01
2025-05-20,1408.95,marketing_spend,out,Counterparty_2,21369581.6,2025-04-12,2025-05-21
2025-05-20,1948.35,tax_payment,out,Counterparty_71,21367633.25,2025-04-15,2025-05-21
2025-05-20,826.63,software_subscription,out,Counterparty_84,21366806.62,2025-04-06,2025-05-01
2025-05-20,20172.12,credit,in,Counterparty_83,21386978.74,,
2025-05-20,1164.63,payroll,out,Counterparty_18,21385814.11,2025-04-13,2025-05-14
2025-05-20,2174.48,investment_income,in,Counterparty_3,21387988.59,,
2025-05-20,119.91,marketing_spend,out,Counterparty_61,21387868.68,2025-04-28,2025-06-03
2025-05-20,2039.08,utilities,out,Counterparty_91,21385829.6,2025-05-05,2025-06-05
2025-05-20,172.94,tax_payment,out,Counterparty_16,21385656.66,2025-05-04,2025-06-02
2025-05-20,2360.96,asset_sale,in,Counterparty_86,21388017.62,,
2025-05-20,4647.0,credit,in,Counterparty_29,21392664.62,,
2025-05-20,10502.8,tax_payment,out,Counterparty_33,21382161.82,2025-04-06,2025-05-15
2025-05-20,2343.81,customer_payment,in,Counterparty_34,21384505.63,,
2025-05-20,5458.75,tax_payment,out,Counterparty_21,21379046.88,2025-05-04,2025-05-31
2025-05-20,333.32,loan_repayment,out,Counterparty_8,21378713.56,2025-04-16,2025-05-22
2025-05-20,729.79,software_subscription,out,Counterparty_12,21377983.77,2025-04-12,2025-05-14
2025-05-20,1226.24,loan_repayment,out,Counterparty_25,21376757.53,2025-04-15,2025-05-19
2025-05-20,3708.27,credit,in,Counterparty_99,21380465.8,,
2025-05-20,3436.23,payroll,out,Counterparty_10,21377029.57,2025-04-13,2025-05-15
2025-05-20,2190.38,customer_payment,in,Counterparty_7,21379219.95,,
2025-05-20,1569.33,rent,out,Counterparty_91,21377650.62,2025-04-09,2025-05-10
2025-05-20,4599.41,customer_payment,in,Counterparty_5,21382250.03,,
2025-05-20,413.79,T&E,out,Counterparty_46,21381836.24,2025-04-22,2025-05-20
2025-05-20,10.01,rent,out,Counterparty_8,21381826.23,2025-04-15,2025-05-21
2025-05-20,1591.65,T&E,out,Counterparty_50,21380234.58,2025-04-30,2025-05-31
2025-05-20,158.95,tax_payment,out,Counterparty_77,21380075.63,2025-05-02,2025-06-07
2025-05-20,7423.91,T&E,out,Counterparty_67,21372651.72,2025-05-02,2025-06-10
2025-05-20,434.07,rent,out,Counterparty_61,21372217.65,2025-05-02,2025-06-01
2025-05-20,1269.76,payroll,out,Counterparty_26,21370947.89,2025-04-27,2025-05-26
2025-05-20,4996.81,refund,in,Counterparty_65,21375944.7,,
2025-05-20,1270.54,marketing_spend,out,Counterparty_64,21374674.16,2025-04-21,2025-05-29
2025-05-20,1271.44,loan_repayment,out,Counterparty_27,21373402.72,2025-04-27,2025-05-31
2025-05-20,1562.05,asset_sale,in,Counterparty_32,21374964.77,,
2025-05-21,232.34,payroll,out,Counterparty_6,21374732.43,2025-04-09,2025-05-06
2025-05-21,739.42,asset_sale,in,Counterparty_47,21375471.85,,
2025-05-21,235.12,asset_sale,in,Counterparty_97,21375706.97,,
2025-05-21,2864.12,software_subscription,out,Counterparty_55,21372842.85,2025-04-28,2025-05-27
2025-05-21,2978.19,loan_repayment,out,Counterparty_98,21369864.66,2025-05-03,2025-06-11
2025-05-21,604.43,credit,in,Counterparty_64,21370469.09,,
2025-05-21,12516.19,refund,in,Counterparty_47,21382985.28,,
2025-05-21,5852.15,supplier_payment,out,Counterparty_1,21377133.13,2025-04-09,2025-05-08
2025-05-21,1937.48,software_subscription,out,Counterparty_80,21375195.65,2025-04-11,2025-05-08
2025-05-21,2571.43,customer_payment,in,Counterparty_48,21377767.08,,
2025-05-21,894.39,marketing_spend,out,Counterparty_26,21376872.69,2025-04-30,2025-06-04
2025-05-21,202.63,T&E,out,Counterparty_98,21376670.06,2025-04-14,2025-05-13
2025-05-21,66.92,marketing_spend,out,Counterparty_49,21376603.14,2025-04-17,2025-05-24
2025-05-21,1723.63,payroll,out,Counterparty_55,21374879.51,2025-05-03,2025-05-31
2025-05-21,449.05,software_subscription,out,Counterparty_91,21374430.46,2025-04-17,2025-05-21
2025-05-21,5949.24,marketing_spend,out,Counterparty_66,21368481.22,2025-04-11,2025-05-18
2025-05-21,1608.77,payroll,out,Counterparty_49,21366872.45,2025-04-15,2025-05-21
2025-05-21,1685.4,supplier_payment,out,Counterparty_66,21365187.05,2025-04-23,2025-05-21
2025-05-21,2583.83,refund,in,Counterparty_56,21367770.88,,
2025-05-21,4822.81,credit,in,Counterparty_84,21372593.69,,
2025-05-21,604.42,marketing_spend,out,Counterparty_17,21371989.27,2025-04-30,2025-06-04
2025-05-21,1852.0,refund,in,Counterparty_26,21373841.27,,
2025-05-21,4064.18,asset_sale,in,Counterparty_37,21377905.45,,
2025-05-21,2348.52,investment_income,in,Counterparty_94,21380253.97,,
2025-05-21,263.17,rent,out,Counterparty_40,21379990.8,2025-05-04,2025-06-09
2025-05-21,1119.87,payroll,out,Counterparty_66,21378870.93,2025-04-21,2025-05-25
2025-05-21,756.06,payroll,out,Counterparty_69,21378114.87,2025-04-24,2025-05-24
2025-05-21,3779.72,tax_payment,out,Counterparty_21,21374335.15,2025-04-21,2025-05-27
2025-05-21,2963.32,customer_payment,in,Counterparty_46,21377298.47,,
2025-05-21,636.42,marketing_spend,out,Counterparty_66,21376662.05,2025-04-18,2025-05-17
2025-05-21,3833.85,utilities,out,Counterparty_14,21372828.2,2025-04-20,2025-05-23
2025-05-21,1469.31,credit,in,Counterparty_35,21374297.51,,
2025-05-21,345.13,utilities,out,Counterparty_47,21373952.38,2025-04-22,2025-05-24
2025-05-21,1556.14,loan_repayment,out,Counterparty_94,21372396.24,2025-05-01,2025-05-31
2025-05-21,2901.6,investment_income,in,Counterparty_96,21375297.84,,
2025-05-21,385.12,utilities,out,Counterparty_70,21374912.72,2025-04-18,2025-05-14
2025-05-21,3627.1,credit,in,Counterparty_46,21378539.82,,
2025-05-21,8571.36,utilities,out,Counterparty_92,21369968.46,2025-04-08,2025-05-09
2025-05-21,797.23,tax_payment,out,Counterparty_65,21369171.23,2025-04-26,2025-05-30
2025-05-21,2721.02,rent,out,Counterparty_12,21366450.21,2025-04-24,2025-05-29
2025-05-21,264.28,asset_sale,in,Counterparty_83,21366714.49,,
2025-05-21,1388.95,payroll,out,Counterparty_94,21365325.54,2025-04-27,2025-05-31
2025-05-21,1814.45,customer_payment,in,Counterparty_87,21367139.99,,
2025-05-21,3881.29,customer_payment,in,Counterparty_25,21371021.28,,
2025-05-21,6370.6,T&E,out,Counterparty_84,21364650.68,2025-04-21,2025-05-17
2025-05-21,1348.64,loan_repayment,out,Counterparty_75,21363302.04,2025-04-22,2025-05-18
2025-05-21,4995.65,tax_payment,out,Counterparty_39,21358306.39,2025-05-03,2025-06-07
2025-05-21,6862.11,asset_sale,in,Counterparty_79,21365168.5,,
2025-05-21,261.44,T&E,out,Counterparty_86,21364907.06,2025-05-01,2025-05-28
2025-05-21,1810.17,asset_sale,in,Counterparty_51,21366717.23,,
2025-05-21,915.12,tax_payment,out,Counterparty_85,21365802.11,2025-05-03,2025-06-10
2025-05-21,873.98,rent,out,Counterparty_96,21364928.13,2025-05-01,2025-05-30
2025-05-21,9687.25,refund,in,Counterparty_71,21374615.38,,
2025-05-21,5.55,rent,out,Counterparty_91,21374609.83,2025-05-04,2025-06-04
2025-05-21,15072.96,investment_income,in,Counterparty_31,21389682.79,,
2025-05-21,4487.29,tax_payment,out,Counterparty_28,21385195.5,2025-04-14,2025-05-11
2025-05-21,573.1,supplier_payment,out,Counterparty_10,21384622.4,2025-05-02,2025-06-02
2025-05-21,0.85,software_subscription,out,Counterparty_17,21384621.55,2025-04-28,2025-06-06
2025-05-21,2142.45,refund,in,Counterparty_92,21386764.0,,
2025-05-21,2862.3,tax_payment,out,Counterparty_8,21383901.7,2025-04-22,2025-05-27
2025-05-21,4817.26,loan_repayment,out,Counterparty_50,21379084.44,2025-04-07,2025-05-13
2025-05-21,4202.19,tax_payment,out,Counterparty_86,21374882.25,2025-04-30,2025-05-31
2025-05-21,245.74,marketing_spend,out,Counterparty_41,21374636.51,2025-05-03,2025-06-03
2025-05-21,1919.5,payroll,out,Counterparty_1,21372717.01,2025-04-30,2025-06-07
2025-05-21,1371.77,marketing_spend,out,Counterparty_73,21371345.24,2025-04-28,2025-05-27
2025-05-21,2792.41,credit,in,Counterparty_34,21374137.65,,
2025-05-21,931.81,software_subscription,out,Counterparty_50,21373205.84,2025-05-02,2025-06-01
2025-05-21,323.79,credit,in,Counterparty_8,21373529.63,,
2025-05-21,244.26,software_subscription,out,Counterparty_53,21373285.37,2025-04-16,2025-05-20
2025-05-21,123.89,marketing_spend,out,Counterparty_96,21373161.48,2025-04-13,2025-05-22
2025-05-21,457.71,refund,in,Counterparty_73,21373619.19,,
2025-05-21,405.79,credit,in,Counterparty_69,21374024.98,,
2025-05-21,3.84,investment_income,in,Counterparty_51,21374028.82,,
2025-05-21,3752.37,payroll,out,Counterparty_41,21370276.45,2025-05-04,2025-05-29
2025-05-21,2603.56,utilities,out,Counterparty_73,21367672.89,2025-04-09,2025-05-16
2025-05-22,759.85,refund,in,Counterparty_40,21368432.74,,
2025-05-22,652.81,supplier_payment,out,Counterparty_96,21367779.93,2025-04-15,2025-05-10
2025-05-22,6181.92,investment_income,in,Counterparty_87,21373961.85,,
2025-05-22,1397.26,customer_payment,in,Counterparty_27,21375359.11,,
2025-05-22,2159.99,tax_payment,out,Counterparty_83,21373199.12,2025-04-29,2025-05-31
2025-05-22,4360.14,marketing_spend,out,Counterparty_2,21368838.98,2025-04-17,2025-05-12
2025-05-22,1086.52,customer_payment,in,Counterparty_31,21369925.5,,
2025-05-22,10672.58,asset_sale,in,Counterparty_11,21380598.08,,
2025-05-22,1610.65,supplier_payment,out,Counterparty_65,21378987.43,2025-04-15,2025-05-22
2025-05-22,3743.41,rent,out,Counterparty_61,21375244.02,2025-04-22,2025-05-22
2025-05-22,4868.33,refund,in,Counterparty_35,21380112.35,,
2025-05-22,1034.42,payroll,out,Counterparty_87,21379077.93,2025-04-16,2025-05-17
2025-05-22,2048.15,investment_income,in,Counterparty_68,21381126.08,,
2025-05-22,119.31,T&E,out,Counterparty_46,21381006.77,2025-05-07,2025-06-02
2025-05-22,2580.37,utilities,out,Counterparty_30,21378426.4,2025-04-28,2025-05-25
2025-05-22,2016.71,credit,in,Counterparty_13,21380443.11,,
2025-05-22,1366.99,refund,in,Counterparty_2,21381810.1,,
2025-05-22,3710.83,rent,out,Counterparty_2,21378099.27,2025-04-24,2025-05-20
2025-05-22,644.23,investment_income,in,Counterparty_27,21378743.5,,
2025-05-22,3489.11,refund,in,Counterparty_19,21382232.61,,
2025-05-22,1742.63,refund,in,Counterparty_45,21383975.24,,
2025-05-22,2287.09,T&E,out,Counterparty_25,21381688.15,2025-04-10,2025-05-10
2025-05-22,34.71,asset_sale,in,Counterparty_19,21381722.86,,
2025-05-22,1545.93,T&E,out,Counterparty_61,21380176.93,2025-04-24,2025-05-28
2025-05-22,1870.7,utilities,out,Counterparty_69,21378306.23,2025-04-12,2025-05-14
2025-05-22,1415.13,asset_sale,in,Counterparty_14,21379721.36,,
2025-05-22,2914.08,utilities,out,Counterparty_40,21376807.28,2025-04-27,2025-05-28
2025-05-22,4937.85,refund,in,Counterparty_6,21381745.13,,
2025-05-22,1652.99,utilities,out,Counterparty_2,21380092.14,2025-04-11,2025-05-17
2025-05-22,290.27,T&E,out,Counterparty_57,21379801.87,2025-05-04,2025-06-05
2025-05-22,2953.86,customer_payment,in,Counterparty_78,21382755.73,,
2025-05-22,2588.67,refund,in,Counterparty_23,21385344.4,,
2025-05-22,277.51,investment_income,in,Counterparty_10,21385621.91,,
2025-05-22,3257.73,refund,in,Counterparty_42,21388879.64,,
2025-05-22,1385.56,investment_income,in,Counterparty_7,21390265.2,,
2025-05-22,3552.44,supplier_payment,out,Counterparty_7,21386712.76,2025-04-17,2025-05-20
2025-05-22,828.56,rent,out,Counterparty_38,21385884.2,2025-04-26,2025-05-21
2025-05-22,5237.43,investment_income,in,Counterparty_59,21391121.63,,
2025-05-22,743.93,customer_payment,in,Counterparty_11,21391865.56,,
2025-05-22,4355.22,refund,in,Counterparty_75,21396220.78,,
2025-05-22,1859.36,marketing_spend,out,Counterparty_36,21394361.42,2025-04-30,2025-05-29
2025-05-22,2979.96,asset_sale,in,Counterparty_89,21397341.38,,
2025-05-22,265.26,loan_repayment,out,Counterparty_70,21397076.12,2025-04-10,2025-05-08
2025-05-22,2327.06,tax_payment,out,Counterparty_11,21394749.06,2025-05-06,2025-06-07
2025-05-22,509.86,utilities,out,Counterparty_40,21394239.2,2025-04-13,2025-05-17
2025-05-22,238.89,credit,in,Counterparty_81,21394478.09,,
2025-05-22,469.3,asset_sale,in,Counterparty_91,21394947.39,,
2025-05-22,1222.91,marketing_spend,out,Counterparty_87,21393724.48,2025-04-10,2025-05-19
2025-05-22,146.0,software_subscription,out,Counterparty_74,21393578.48,2025-04-12,2025-05-10
2025-05-22,1099.03,asset_sale,in,Counterparty_32,21394677.51,,
2025-05-23,77.59,T&E,out,Counterparty_19,21394599.92,2025-05-05,2025-06-08
2025-05-23,332.76,supplier_payment,out,Counterparty_17,21394267.16,2025-04-14,2025-05-09
2025-05-23,443.1,utilities,out,Counterparty_30,21393824.06,2025-05-05,2025-06-02
2025-05-23,100.5,loan_repayment,out,Counterparty_81,21393723.56,2025-05-06,2025-06-11
2025-05-23,682.24,utilities,out,Counterparty_15,21393041.32,2025-04-11,2025-05-17
2025-05-23,142.44,refund,in,Counterparty_70,21393183.76,,
2025-05-23,10983.29,tax_payment,out,Counterparty_91,21382200.47,2025-04-19,2025-05-24
2025-05-23,3781.31,customer_payment,in,Counterparty_86,21385981.78,,
2025-05-23,1286.49,marketing_spend,out,Counterparty_27,21384695.29,2025-04-20,2025-05-17
2025-05-23,75.22,payroll,out,Counterparty_65,21384620.07,2025-05-01,2025-05-26
2025-05-23,846.77,tax_payment,out,Counterparty_96,21383773.3,2025-04-25,2025-06-03
2025-05-23,800.82,investment_income,in,Counterparty_31,21384574.12,,
2025-05-23,2114.49,tax_payment,out,Counterparty_81,21382459.63,2025-04-09,2025-05-05
2025-05-23,767.01,marketing_spend,out,Counterparty_94,21381692.62,2025-04-22,2025-05-17
2025-05-23,486.61,tax_payment,out,Counterparty_85,21381206.01,2025-04-29,2025-06-04
2025-05-23,1022.27,utilities,out,Counterparty_85,21380183.74,2025-05-07,2025-06-11
2025-05-23,3200.28,asset_sale,in,Counterparty_44,21383384.02,,
2025-05-23,1895.33,payroll,out,Counterparty_11,21381488.69,2025-04-25,2025-05-25
2025-05-23,921.7,loan_repayment,out,Counterparty_58,21380566.99,2025-04-28,2025-05-23
2025-05-23,1420.28,payroll,out,Counterparty_80,21379146.71,2025-05-07,2025-06-09
2025-05-23,4249.95,payroll,out,Counterparty_29,21374896.76,2025-04-25,2025-05-21
2025-05-23,3259.92,supplier_payment,out,Counterparty_18,21371636.84,2025-04-28,2025-06-01
2025-05-23,65.97,refund,in,Counterparty_23,21371702.81,,
2025-05-23,246.07,refund,in,Counterparty_77,21371948.88,,
2025-05-23,696.06,investment_income,in,Counterparty_98,21372644.94,,
2025-05-23,1698.83,marketing_spend,out,Counterparty_71,21370946.11,2025-04-13,2025-05-12
2025-05-23,794.46,marketing_spend,out,Counterparty_82,21370151.65,2025-04-11,2025-05-10
2025-05-23,2016.87,investment_income,in,Counterparty_26,21372168.52,,
2025-05-23,1055.3,payroll,out,Counterparty_2,21371113.22,2025-04-11,2025-05-13
2025-05-23,5921.48,payroll,out,Counterparty_87,21365191.74,2025-04-24,2025-05-28
2025-05-23,5882.02,refund,in,Counterparty_40,21371073.76,,
2025-05-23,767.7,T&E,out,Counterparty_85,21370306.06,2025-04-13,2025-05-22
2025-05-23,1898.97,marketing_spend,out,Counterparty_48,21368407.09,2025-04-16,2025-05-22
2025-05-23,416.98,software_subscription,out,Counterparty_56,21367990.11,2025-04-27,2025-05-27
2025-05-23,2382.13,utilities,out,Counterparty_2,21365607.98,2025-04-22,2025-05-24
2025-05-23,240.22,utilities,out,Counterparty_66,21365367.76,2025-04-26,2025-06-03
2025-05-23,6489.46,loan_repayment,out,Counterparty_52,21358878.3,2025-04-16,2025-05-16
2025-05-23,949.32,loan_repayment,out,Counterparty_76,21357928.98,2025-05-07,2025-06-01
2025-05-23,5750.98,software_subscription,out,Counterparty_45,21352178.0,2025-04-12,2025-05-15
2025-05-23,4515.11,supplier_payment,out,Counterparty_57,21347662.89,2025-04-23,2025-05-19
2025-05-23,31.98,investment_income,in,Counterparty_81,21347694.87,,
2025-05-23,1877.6,asset_sale,in,Counterparty_20,21349572.47,,
2025-05-23,626.55,supplier_payment,out,Counterparty_24,21348945.92,2025-04-18,2025-05-16
2025-05-23,5353.56,customer_payment,in,Counterparty_75,21354299.48,,
2025-05-23,1257.93,refund,in,Counterparty_77,21355557.41,,
2025-05-23,1356.35,marketing_spend,out,Counterparty_75,21354201.06,2025-05-05,2025-06-04
2025-05-23,4301.45,marketing_spend,out,Counterparty_80,21349899.61,2025-04-15,2025-05-17
2025-05-23,5566.53,marketing_spend,out,Counterparty_11,21344333.08,2025-04-17,2025-05-21
2025-05-23,223.22,asset_sale,in,Counterparty_74,21344556.3,,
2025-05-23,1828.36,credit,in,Counterparty_46,21346384.66,,
2025-05-23,5292.82,asset_sale,in,Counterparty_6,21351677.48,,
2025-05-23,4496.06,utilities,out,Counterparty_17,21347181.42,2025-04-30,2025-05-28
2025-05-23,2002.51,utilities,out,Counterparty_9,21345178.91,2025-04-26,2025-05-26
2025-05-23,2854.85,supplier_payment,out,Counterparty_44,21342324.06,2025-04-18,2025-05-20
2025-05-23,688.9,refund,in,Counterparty_90,21343012.96,,
2025-05-23,2958.37,tax_payment,out,Counterparty_19,21340054.59,2025-04-11,2025-05-11
2025-05-23,2488.03,asset_sale,in,Counterparty_78,21342542.62,,
2025-05-24,1707.09,refund,in,Counterparty_15,21344249.71,,
2025-05-24,1360.29,customer_payment,in,Counterparty_60,21345610.0,,
2025-05-24,1329.89,rent,out,Counterparty_5,21344280.11,2025-04-12,2025-05-09
2025-05-24,8465.6,customer_payment,in,Counterparty_53,21352745.71,,
2025-05-24,2389.81,asset_sale,in,Counterparty_70,21355135.52,,
2025-05-24,613.74,loan_repayment,out,Counterparty_41,21354521.78,2025-04-25,2025-06-01
2025-05-24,2247.46,utilities,out,Counterparty_97,21352274.32,2025-05-01,2025-06-04
2025-05-24,509.36,utilities,out,Counterparty_79,21351764.96,2025-04-12,2025-05-10
2025-05-24,1128.26,customer_payment,in,Counterparty_73,21352893.22,,
2025-05-24,125.71,software_subscription,out,Counterparty_71,21352767.51,2025-04-15,2025-05-19
2025-05-24,266.84,payroll,out,Counterparty_7,21352500.67,2025-04-25,2025-05-20
2025-05-24,1661.4,investment_income,in,Counterparty_73,21354162.07,,
2025-05-24,81.29,asset_sale,in,Counterparty_78,21354243.36,,
2025-05-24,7120.8,customer_payment,in,Counterparty_10,21361364.16,,
2025-05-24,626.52,supplier_payment,out,Counterparty_90,21360737.64,2025-04-30,2025-06-05
2025-05-24,1214.43,rent,out,Counterparty_69,21359523.21,2025-04-18,2025-05-15
2025-05-24,688.16,rent,out,Counterparty_67,21358835.05,2025-04-14,2025-05-11
2025-05-24,4131.43,loan_repayment,out,Counterparty_37,21354703.62,2025-04-22,2025-05-19
2025-05-24,1581.05,tax_payment,out,Counterparty_16,21353122.57,2025-05-07,2025-06-08
2025-05-24,1858.83,refund,in,Counterparty_83,21354981.4,,
2025-05-24,2270.44,utilities,out,Counterparty_51,21352710.96,2025-04-23,2025-05-31
2025-05-24,423.23,rent,out,Counterparty_86,21352287.73,2025-05-08,2025-06-08
2025-05-24,4492.76,asset_sale,in,Counterparty_31,21356780.49,,
2025-05-24,2584.75,asset_sale,in,Counterparty_80,21359365.24,,
2025-05-24,744.38,asset_sale,in,Counterparty_75,21360109.62,,
2025-05-24,1127.4,rent,out,Counterparty_59,21358982.22,2025-04-29,2025-06-04
2025-05-24,980.28,customer_payment,in,Counterparty_6,21359962.5,,
2025-05-24,544.36,software_subscription,out,Counterparty_17,21359418.14,2025-04-14,2025-05-13
2025-05-24,6567.05,refund,in,Counterparty_94,21365985.19,,
2025-05-24,160.11,software_subscription,out,Counterparty_65,21365825.08,2025-04-29,2025-05-29
2025-05-24,2907.65,tax_payment,out,Counterparty_29,21362917.43,2025-05-07,2025-06-07
2025-05-24,6410.92,utilities,out,Counterparty_92,21356506.51,2025-04-11,2025-05-09
2025-05-24,2280.64,customer_payment,in,Counterparty_79,21358787.15,,
2025-05-24,4532.5,investment_income,in,Counterparty_85,21363319.65,,
2025-05-24,151.93,utilities,out,Counterparty_65,21363167.72,2025-04-30,2025-05-31
2025-05-24,1173.1,tax_payment,out,Counterparty_55,21361994.62,2025-05-09,2025-06-12
2025-05-24,785.18,loan_repayment,out,Counterparty_58,21361209.44,2025-04-20,2025-05-29
2025-05-24,2018.45,credit,in,Counterparty_94,21363227.89,,
2025-05-24,442.36,investment_income,in,Counterparty_79,21363670.25,,
2025-05-24,2219.27,T&E,out,Counterparty_59,21361450.98,2025-04-18,2025-05-15
2025-05-24,3441.23,loan_repayment,out,Counterparty_66,21358009.75,2025-04-14,2025-05-13
2025-05-24,1276.26,asset_sale,in,Counterparty_90,21359286.01,,
2025-05-24,1002.83,credit,in,Counterparty_37,21360288.84,,
2025-05-24,1763.52,T&E,out,Counterparty_93,21358525.32,2025-05-09,2025-06-12
2025-05-24,1155.96,software_subscription,out,Counterparty_87,21357369.36,2025-04-14,2025-05-09
2025-05-24,719.82,customer_payment,in,Counterparty_26,21358089.18,,
2025-05-24,5.77,loan_repayment,out,Counterparty_3,21358083.41,2025-04-27,2025-06-01
2025-05-24,8029.15,payroll,out,Counterparty_16,21350054.26,2025-04-18,2025-05-27
2025-05-24,2732.05,payroll,out,Counterparty_41,21347322.21,2025-04-13,2025-05-21
2025-05-24,636.45,supplier_payment,out,Counterparty_94,21346685.76,2025-04-13,2025-05-15
2025-05-24,3625.37,loan_repayment,out,Counterparty_69,21343060.39,2025-05-09,2025-06-16
2025-05-24,886.31,supplier_payment,out,Counterparty_74,21342174.08,2025-04-29,2025-05-26
2025-05-24,4528.36,marketing_spend,out,Counterparty_47,21337645.72,2025-04-26,2025-05-21
2025-05-24,1773.2,utilities,out,Counterparty_58,21335872.52,2025-04-20,2025-05-22
2025-05-24,4812.55,rent,out,Counterparty_97,21331059.97,2025-05-01,2025-05-30
2025-05-24,316.13,software_subscription,out,Counterparty_69,21330743.84,2025-04-17,2025-05-17
2025-05-24,633.09,asset_sale,in,Counterparty_72,21331376.93,,
2025-05-24,2998.85,refund,in,Counterparty_20,21334375.78,,
2025-05-24,134.42,utilities,out,Counterparty_52,21334241.36,2025-04-29,2025-05-26
2025-05-24,2991.12,tax_payment,out,Counterparty_77,21331250.24,2025-05-03,2025-06-10
2025-05-24,2037.36,tax_payment,out,Counterparty_96,21329212.88,2025-04-30,2025-05-27
2025-05-24,4716.25,investment_income,in,Counterparty_71,21333929.13,,
2025-05-24,207.11,rent,out,Counterparty_49,21333722.02,2025-04-22,2025-05-26
2025-05-24,1291.16,supplier_payment,out,Counterparty_61,21332430.86,2025-04-10,2025-05-14
2025-05-24,857.72,rent,out,Counterparty_48,21331573.14,2025-05-03,2025-06-10
2025-05-24,1058.59,marketing_spend,out,Counterparty_90,21330514.55,2025-05-06,2025-06-14
2025-05-24,417.16,supplier_payment,out,Counterparty_11,21330097.39,2025-04-15,2025-05-12
2025-05-24,647.33,marketing_spend,out,Counterparty_70,21329450.06,2025-04-10,2025-05-08
2025-05-24,4934.21,asset_sale,in,Counterparty_28,21334384.27,,
2025-05-25,2868.05,software_subscription,out,Counterparty_25,21331516.22,2025-05-02,2025-06-09
2025-05-25,370.3,refund,in,Counterparty_79,21331886.52,,
2025-05-25,2514.18,asset_sale,in,Counterparty_33,21334400.7,,
2025-05-25,1857.7,utilities,out,Counterparty_10,21332543.0,2025-04-19,2025-05-19
2025-05-25,2559.11,tax_payment,out,Counterparty_26,21329983.89,2025-05-03,2025-06-11
2025-05-25,385.95,tax_payment,out,Counterparty_22,21329597.94,2025-04-29,2025-05-25
2025-05-25,1183.47,loan_repayment,out,Counterparty_24,21328414.47,2025-04-16,2025-05-11
2025-05-25,2835.45,supplier_payment,out,Counterparty_88,21325579.02,2025-05-09,2025-06-09
2025-05-25,1804.07,customer_payment,in,Counterparty_44,21327383.09,,
2025-05-25,2509.35,software_subscription,out,Counterparty_5,21324873.74,2025-05-10,2025-06-04
2025-05-25,9324.99,customer_payment,in,Counterparty_97,21334198.73,,
2025-05-25,2511.84,loan_repayment,out,Counterparty_2,21331686.89,2025-04-29,2025-05-31
2025-05-25,1.75,software_subscription,out,Counterparty_54,21331685.14,2025-04-30,2025-05-25
2025-05-25,1766.87,software_subscription,out,Counterparty_1,21329918.27,2025-04-20,2025-05-23
2025-05-25,1151.36,investment_income,in,Counterparty_32,21331069.63,,
2025-05-25,231.27,supplier_payment,out,Counterparty_85,21330838.36,2025-04-19,2025-05-28
2025-05-25,392.67,software_subscription,out,Counterparty_57,21330445.69,2025-05-10,2025-06-15
2025-05-25,137.09,software_subscription,out,Counterparty_19,21330308.6,2025-05-10,2025-06-16
2025-05-25,2481.78,software_subscription,out,Counterparty_26,21327826.82,2025-04-15,2025-05-18
2025-05-25,1901.65,refund,in,Counterparty_61,21329728.47,,
2025-05-25,5097.69,refund,in,Counterparty_99,21334826.16,,
2025-05-25,113.71,refund,in,Counterparty_87,21334939.87,,
2025-05-25,405.71,rent,out,Counterparty_65,21334534.16,2025-04-15,2025-05-22
2025-05-25,524.02,T&E,out,Counterparty_84,21334010.14,2025-05-08,2025-06-06
2025-05-25,607.23,refund,in,Counterparty_81,21334617.37,,
2025-05-25,1461.9,customer_payment,in,Counterparty_40,21336079.27,,
2025-05-25,3386.0,tax_payment,out,Counterparty_85,21332693.27,2025-04-27,2025-06-01
2025-05-25,3756.53,asset_sale,in,Counterparty_43,21336449.8,,
2025-05-25,1237.63,payroll,out,Counterparty_47,21335212.17,2025-04-15,2025-05-21
2025-05-25,481.01,tax_payment,out,Counterparty_9,21334731.16,2025-04-28,2025-06-05
2025-05-25,1767.38,marketing_spend,out,Counterparty_26,21332963.78,2025-05-08,2025-06-08
2025-05-25,2881.23,loan_repayment,out,Counterparty_5,21330082.55,2025-04-12,2025-05-21
2025-05-25,4252.69,credit,in,Counterparty_40,21334335.24,,
2025-05-25,1669.81,rent,out,Counterparty_24,21332665.43,2025-05-04,2025-05-31
2025-05-25,2673.78,payroll,out,Counterparty_52,21329991.65,2025-04-15,2025-05-23
2025-05-25,5875.13,supplier_payment,out,Counterparty_19,21324116.52,2025-04-28,2025-06-04
2025-05-25,2426.48,rent,out,Counterparty_74,21321690.04,2025-05-01,2025-06-02
2025-05-25,862.06,refund,in,Counterparty_76,21322552.1,,
2025-05-25,382.4,rent,out,Counterparty_92,21322169.7,2025-04-20,2025-05-26
2025-05-25,917.7,utilities,out,Counterparty_25,21321252.0,2025-04-17,2025-05-17
2025-05-25,14204.38,asset_sale,in,Counterparty_34,21335456.38,,
2025-05-25,4272.23,T&E,out,Counterparty_30,21331184.15,2025-04-29,2025-05-24
2025-05-25,2159.04,marketing_spend,out,Counterparty_43,21329025.11,2025-05-03,2025-06-02
2025-05-25,314.5,supplier_payment,out,Counterparty_41,21328710.61,2025-04-22,2025-05-17
2025-05-25,361.51,utilities,out,Counterparty_59,21328349.1,2025-04-24,2025-05-31
2025-05-25,1792.16,asset_sale,in,Counterparty_44,21330141.26,,
2025-05-25,7046.85,asset_sale,in,Counterparty_67,21337188.11,,
2025-05-25,5077.06,investment_income,in,Counterparty_52,21342265.17,,
2025-05-25,150.48,supplier_payment,out,Counterparty_50,21342114.69,2025-05-10,2025-06-16
2025-05-25,275.39,loan_repayment,out,Counterparty_84,21341839.3,2025-04-17,2025-05-25
2025-05-25,943.86,rent,out,Counterparty_74,21340895.44,2025-04-17,2025-05-12
2025-05-25,8320.35,payroll,out,Counterparty_36,21332575.09,2025-04-27,2025-05-25
2025-05-25,1484.4,refund,in,Counterparty_6,21334059.49,,
2025-05-25,244.38,supplier_payment,out,Counterparty_9,21333815.11,2025-04-15,2025-05-22
2025-05-25,517.71,rent,out,Counterparty_93,21333297.4,2025-04-26,2025-05-28
2025-05-25,249.35,credit,in,Counterparty_64,21333546.75,,
2025-05-25,2641.95,utilities,out,Counterparty_82,21330904.8,2025-04-20,2025-05-20
2025-05-26,3497.53,tax_payment,out,Counterparty_61,21327407.27,2025-04-18,2025-05-13
2025-05-26,3174.46,payroll,out,Counterparty_83,21324232.81,2025-04-14,2025-05-11
2025-05-26,4351.7,T&E,out,Counterparty_54,21319881.11,2025-05-07,2025-06-04
2025-05-26,126.19,utilities,out,Counterparty_98,21319754.92,2025-04-13,2025-05-18
2025-05-26,9596.31,utilities,out,Counterparty_7,21310158.61,2025-05-08,2025-06-13
2025-05-26,943.0,marketing_spend,out,Counterparty_93,21309215.61,2025-04-16,2025-05-23
2025-05-26,449.8,loan_repayment,out,Counterparty_22,21308765.81,2025-04-29,2025-06-06
2025-05-26,649.57,utilities,out,Counterparty_41,21308116.24,2025-04-30,2025-06-08
2025-05-26,163.32,marketing_spend,out,Counterparty_55,21307952.92,2025-05-08,2025-06-04
2025-05-26,1357.62,marketing_spend,out,Counterparty_41,21306595.3,2025-05-09,2025-06-06
2025-05-26,2136.8,marketing_spend,out,Counterparty_77,21304458.5,2025-04-16,2025-05-16
2025-05-26,2896.46,supplier_payment,out,Counterparty_32,21301562.04,2025-05-11,2025-06-07
2025-05-26,1564.95,supplier_payment,out,Counterparty_48,21299997.09,2025-04-27,2025-05-23
2025-05-26,3278.74,T&E,out,Counterparty_12,21296718.35,2025-05-07,2025-06-13
2025-05-26,147.58,customer_payment,in,Counterparty_71,21296865.93,,
2025-05-26,1079.59,software_subscription,out,Counterparty_7,21295786.34,2025-04-17,2025-05-21
2025-05-26,3.95,customer_payment,in,Counterparty_86,21295790.29,,
2025-05-26,1371.91,rent,out,Counterparty_65,21294418.38,2025-04-21,2025-05-24
2025-05-26,436.14,loan_repayment,out,Counterparty_21,21293982.24,2025-04-13,2025-05-18
2025-05-26,88.38,software_subscription,out,Counterparty_59,21293893.86,2025-04-17,2025-05-12
2025-05-26,759.3,T&E,out,Counterparty_8,21293134.56,2025-04-29,2025-05-29
2025-05-26,2197.88,software_subscription,out,Counterparty_25,21290936.68,2025-04-14,2025-05-21
2025-05-26,6720.5,refund,in,Counterparty_70,21297657.18,,
2025-05-26,157.05,customer_payment,in,Counterparty_6,21297814.23,,
2025-05-26,1818.25,marketing_spend,out,Counterparty_50,21295995.98,2025-04-18,2025-05-26
2025-05-26,4632.37,tax_payment,out,Counterparty_91,21291363.61,2025-04-23,2025-05-28
2025-05-26,488.06,customer_payment,in,Counterparty_90,21291851.67,,
2025-05-26,7296.57,refund,in,Counterparty_32,21299148.24,,
2025-05-26,392.79,supplier_payment,out,Counterparty_6,21298755.45,2025-04-25,2025-06-02
2025-05-26,776.53,software_subscription,out,Counterparty_54,21297978.92,2025-04-27,2025-05-26
2025-05-26,702.49,T&E,out,Counterparty_19,21297276.43,2025-04-17,2025-05-14
2025-05-26,1645.73,investment_income,in,Counterparty_78,21298922.16,,
2025-05-26,2002.0,supplier_payment,out,Counterparty_25,21296920.16,2025-04-21,2025-05-24
2025-05-26,1964.38,asset_sale,in,Counterparty_54,21298884.54,,
2025-05-26,1249.31,supplier_payment,out,Counterparty_60,21297635.23,2025-05-09,2025-06-08
2025-05-26,853.94,software_subscription,out,Counterparty_71,21296781.29,2025-05-10,2025-06-17
2025-05-26,1419.49,asset_sale,in,Counterparty_76,21298200.78,,
2025-05-26,1545.15,investment_income,in,Counterparty_41,21299745.93,,
2025-05-26,1386.87,investment_income,in,Counterparty_12,21301132.8,,
2025-05-26,2280.41,payroll,out,Counterparty_44,21298852.39,2025-04-27,2025-05-30
2025-05-26,5922.24,marketing_spend,out,Counterparty_12,21292930.15,2025-05-09,2025-06-05
2025-05-26,721.34,credit,in,Counterparty_92,21293651.49,,
2025-05-26,11.3,payroll,out,Counterparty_48,21293640.19,2025-05-03,2025-06-06
2025-05-26,2789.22,refund,in,Counterparty_52,21296429.41,,
2025-05-26,2670.97,asset_sale,in,Counterparty_52,21299100.38,,
2025-05-26,509.99,investment_income,in,Counterparty_35,21299610.37,,
2025-05-26,4575.31,loan_repayment,out,Counterparty_14,21295035.06,2025-04-23,2025-05-29
2025-05-26,1631.52,payroll,out,Counterparty_57,21293403.54,2025-04-15,2025-05-19
2025-05-26,3932.14,investment_income,in,Counterparty_62,21297335.68,,
2025-05-26,7117.28,investment_income,in,Counterparty_23,21304452.96,,
2025-05-26,647.3,credit,in,Counterparty_66,21305100.26,,
2025-05-26,1470.23,customer_payment,in,Counterparty_28,21306570.49,,
2025-05-26,1041.49,asset_sale,in,Counterparty_24,21307611.98,,
2025-05-26,1630.37,asset_sale,in,Counterparty_52,21309242.35,,
2025-05-26,583.89,refund,in,Counterparty_37,21309826.24,,
2025-05-26,1409.56,supplier_payment,out,Counterparty_82,21308416.68,2025-05-07,2025-06-03
2025-05-26,2387.81,customer_payment,in,Counterparty_34,21310804.49,,
2025-05-26,2088.61,T&E,out,Counterparty_64,21308715.88,2025-05-05,2025-06-11
2025-05-26,190.87,credit,in,Counterparty_5,21308906.75,,
2025-05-26,1536.6,investment_income,in,Counterparty_96,21310443.35,,
2025-05-26,2909.24,customer_payment,in,Counterparty_19,21313352.59,,
2025-05-27,299.65,supplier_payment,out,Counterparty_11,21313052.94,2025-05-01,2025-05-31
2025-05-27,874.68,asset_sale,in,Counterparty_58,21313927.62,,
2025-05-27,2596.07,tax_payment,out,Counterparty_36,21311331.55,2025-04-22,2025-05-29
2025-05-27,1038.02,software_subscription,out,Counterparty_72,21310293.53,2025-04-20,2025-05-15
2025-05-27,8129.43,refund,in,Counterparty_25,21318422.96,,
2025-05-27,634.07,T&E,out,Counterparty_93,21317788.89,2025-04-29,2025-06-07
2025-05-27,5889.2,investment_income,in,Counterparty_21,21323678.09,,
2025-05-27,4919.38,payroll,out,Counterparty_2,21318758.71,2025-04-14,2025-05-14
2025-05-27,1024.13,utilities,out,Counterparty_74,21317734.58,2025-04-16,2025-05-12
2025-05-27,3965.6,supplier_payment,out,Counterparty_9,21313768.98,2025-04-18,2025-05-26
2025-05-27,4247.79,investment_income,in,Counterparty_34,21318016.77,,
2025-05-27,25.71,customer_payment,in,Counterparty_6,21318042.48,,
2025-05-27,42.56,payroll,out,Counterparty_23,21317999.92,2025-04-18,2025-05-23
2025-05-27,2510.37,customer_payment,in,Counterparty_24,21320510.29,,
2025-05-27,1476.42,credit,in,Counterparty_71,21321986.71,,
2025-05-27,434.93,credit,in,Counterparty_77,21322421.64,,
2025-05-27,399.4,utilities,out,Counterparty_37,21322022.24,2025-05-06,2025-06-05
2025-05-27,496.65,refund,in,Counterparty_8,21322518.89,,
2025-05-27,4852.1,credit,in,Counterparty_78,21327370.99,,
2025-05-27,1358.08,rent,out,Counterparty_15,21326012.91,2025-04-22,2025-05-22
2025-05-27,3302.73,payroll,out,Counterparty_94,21322710.18,2025-04-16,2025-05-19
2025-05-27,7881.92,supplier_payment,out,Counterparty_8,21314828.26,2025-05-06,2025-06-09
2025-05-27,1853.1,asset_sale,in,Counterparty_2,21316681.36,,
2025-05-27,1152.49,loan_repayment,out,Counterparty_31,21315528.87,2025-05-02,2025-05-27
2025-05-27,462.11,utilities,out,Counterparty_22,21315066.76,2025-04-23,2025-05-28
2025-05-27,769.47,customer_payment,in,Counterparty_62,21315836.23,,
2025-05-27,10340.21,customer_payment,in,Counterparty_23,21326176.44,,
2025-05-27,1874.97,payroll,out,Counterparty_14,21324301.47,2025-04-30,2025-06-05
2025-05-27,1034.35,software_subscription,out,Counterparty_49,21323267.12,2025-04-20,2025-05-27
2025-05-27,2786.48,T&E,out,Counterparty_48,21320480.64,2025-04-23,2025-05-19
2025-05-27,815.2,utilities,out,Counterparty_12,21319665.44,2025-04-29,2025-06-06
2025-05-27,4771.56,tax_payment,out,Counterparty_48,21314893.88,2025-04-24,2025-05-21
2025-05-27,2233.68,rent,out,Counterparty_41,21312660.2,2025-04-17,2025-05-12
2025-05-27,2441.32,software_subscription,out,Counterparty_80,21310218.88,2025-04-22,2025-05-17
2025-05-27,1101.33,loan_repayment,out,Counterparty_62,21309117.55,2025-04-23,2025-05-25
2025-05-27,4420.3,T&E,out,Counterparty_74,21304697.25,2025-05-09,2025-06-09
2025-05-27,4020.85,credit,in,Counterparty_36,21308718.1,,
2025-05-27,573.73,marketing_spend,out,Counterparty_51,21308144.37,2025-04-15,2025-05-21
2025-05-27,1980.04,rent,out,Counterparty_45,21306164.33,2025-05-06,2025-06-11
2025-05-27,5115.01,asset_sale,in,Counterparty_27,21311279.34,,
2025-05-27,5787.56,T&E,out,Counterparty_7,21305491.78,2025-04-13,2025-05-12
2025-05-27,668.82,software_subscription,out,Counterparty_54,21304822.96,2025-05-08,2025-06-15
2025-05-27,492.87,utilities,out,Counterparty_46,21304330.09,2025-04-13,2025-05-14
2025-05-27,400.04,loan_repayment,out,Counterparty_2,21303930.05,2025-04-16,2025-05-15
2025-05-27,217.28,loan_repayment,out,Counterparty_82,21303712.77,2025-04-26,2025-05-22
2025-05-27,418.41,investment_income,in,Counterparty_27,21304131.18,,
2025-05-27,577.91,investment_income,in,Counterparty_2,21304709.09,,
2025-05-27,2838.06,T&E,out,Counterparty_18,21301871.03,2025-05-07,2025-06-09
2025-05-27,3155.3,utilities,out,Counterparty_91,21298715.73,2025-04-19,2025-05-19
2025-05-27,2781.81,payroll,out,Counterparty_17,21295933.92,2025-04-16,2025-05-17
2025-05-27,4255.31,marketing_spend,out,Counterparty_10,21291678.61,2025-05-05,2025-06-05
2025-05-27,2318.73,marketing_spend,out,Counterparty_26,21289359.88,2025-04-14,2025-05-23
2025-05-27,1332.07,credit,in,Counterparty_80,21290691.95,,
2025-05-27,950.77,supplier_payment,out,Counterparty_6,21289741.18,2025-04-14,2025-05-10
2025-05-27,1865.31,rent,out,Counterparty_4,21287875.87,2025-05-11,2025-06-14
2025-05-27,55.46,payroll,out,Counterparty_84,21287820.41,2025-04-14,2025-05-17
2025-05-27,60.11,software_subscription,out,Counterparty_74,21287760.3,2025-04-26,2025-06-04
2025-05-27,1826.5,supplier_payment,out,Counterparty_48,21285933.8,2025-05-04,2025-06-12
2025-05-27,6005.64,credit,in,Counterparty_31,21291939.44,,
2025-05-27,194.09,tax_payment,out,Counterparty_91,21291745.35,2025-05-09,2025-06-13
2025-05-27,496.82,loan_repayment,out,Counterparty_69,21291248.53,2025-04-25,2025-05-21
2025-05-28,5991.19,refund,in,Counterparty_69,21297239.72,,
2025-05-28,1186.46,tax_payment,out,Counterparty_94,21296053.26,2025-05-09,2025-06-10
2025-05-28,30.94,rent,out,Counterparty_88,21296022.32,2025-04-15,2025-05-16
2025-05-28,249.06,software_subscription,out,Counterparty_21,21295773.26,2025-04-16,2025-05-22
2025-05-28,954.05,payroll,out,Counterparty_99,21294819.21,2025-04-23,2025-05-28
2025-05-28,9535.0,asset_sale,in,Counterparty_6,21304354.21,,
2025-05-28,649.55,software_subscription,out,Counterparty_68,21303704.66,2025-04-25,2025-05-20
2025-05-28,2572.62,loan_repayment,out,Counterparty_18,21301132.04,2025-04-28,2025-05-30
2025-05-28,4159.42,payroll,out,Counterparty_20,21296972.62,2025-05-07,2025-06-01
2025-05-28,468.12,asset_sale,in,Counterparty_42,21297440.74,,
2025-05-28,5300.35,utilities,out,Counterparty_96,21292140.39,2025-05-04,2025-06-03
2025-05-28,236.32,marketing_spend,out,Counterparty_90,21291904.07,2025-05-12,2025-06-19
2025-05-28,656.35,rent,out,Counterparty_12,21291247.72,2025-05-09,2025-06-06
2025-05-28,4382.92,investment_income,in,Counterparty_76,21295630.64,,
2025-05-28,526.91,rent,out,Counterparty_3,21295103.73,2025-04-24,2025-05-31
2025-05-28,3379.44,asset_sale,in,Counterparty_64,21298483.17,,
2025-05-28,1983.43,asset_sale,in,Counterparty_31,21300466.6,,
2025-05-28,436.38,payroll,out,Counterparty_50,21300030.22,2025-04-23,2025-05-22
2025-05-28,1397.87,customer_payment,in,Counterparty_24,21301428.09,,
2025-05-28,3234.19,utilities,out,Counterparty_89,21298193.9,2025-04-22,2025-05-21
2025-05-28,900.69,investment_income,in,Counterparty_37,21299094.59,,
2025-05-28,896.62,marketing_spend,out,Counterparty_30,21298197.97,2025-04-28,2025-06-02
2025-05-28,2671.95,software_subscription,out,Counterparty_12,21295526.02,2025-04-19,2025-05-24
2025-05-28,11.4,customer_payment,in,Counterparty_32,21295537.42,,
2025-05-28,1427.35,investment_income,in,Counterparty_5,21296964.77,,
2025-05-28,4101.29,tax_payment,out,Counterparty_51,21292863.48,2025-05-02,2025-05-28
2025-05-28,3359.96,credit,in,Counterparty_21,21296223.44,,
2025-05-28,2370.77,payroll,out,Counterparty_20,21293852.67,2025-05-06,2025-06-12
2025-05-28,1105.03,utilities,out,Counterparty_85,21292747.64,2025-04-21,2025-05-20
2025-05-28,1787.57,investment_income,in,Counterparty_9,21294535.21,,
2025-05-28,1723.67,tax_payment,out,Counterparty_99,21292811.54,2025-05-05,2025-06-02
2025-05-28,2477.47,T&E,out,Counterparty_9,21290334.07,2025-05-10,2025-06-08
2025-05-28,3907.6,utilities,out,Counterparty_95,21286426.47,2025-04-16,2025-05-11
2025-05-28,1929.75,investment_income,in,Counterparty_54,21288356.22,,
2025-05-28,311.21,rent,out,Counterparty_88,21288045.01,2025-04-24,2025-05-25
2025-05-28,1908.08,T&E,out,Counterparty_59,21286136.93,2025-04-16,2025-05-17
2025-05-28,547.58,credit,in,Counterparty_47,21286684.51,,
2025-05-28,511.68,tax_payment,out,Counterparty_7,21286172.83,2025-05-08,2025-06-14
2025-05-28,1094.19,rent,out,Counterparty_43,21285078.64,2025-04-22,2025-05-18
2025-05-28,884.14,rent,out,Counterparty_8,21284194.5,2025-05-10,2025-06-12
2025-05-28,2607.68,T&E,out,Counterparty_48,21281586.82,2025-05-05,2025-06-09
2025-05-28,2111.66,marketing_spend,out,Counterparty_74,21279475.16,2025-05-09,2025-06-15
2025-05-28,601.68,software_subscription,out,Counterparty_61,21278873.48,2025-05-01,2025-05-26
2025-05-28,193.57,payroll,out,Counterparty_21,21278679.91,2025-05-04,2025-05-29
2025-05-28,1008.43,utilities,out,Counterparty_77,21277671.48,2025-04-27,2025-06-05
2025-05-28,566.52,supplier_payment,out,Counterparty_15,21277104.96,2025-04-23,2025-05-24
2025-05-28,468.25,investment_income,in,Counterparty_46,21277573.21,,
2025-05-28,261.87,tax_payment,out,Counterparty_82,21277311.34,2025-05-08,2025-06-12
2025-05-28,8755.73,customer_payment,in,Counterparty_93,21286067.07,,
2025-05-28,3228.05,refund,in,Counterparty_12,21289295.12,,
2025-05-28,392.15,utilities,out,Counterparty_8,21288902.97,2025-04-24,2025-05-29
2025-05-28,6327.06,asset_sale,in,Counterparty_57,21295230.03,,
2025-05-28,626.91,software_subscription,out,Counterparty_65,21294603.12,2025-04-17,2025-05-22
2025-05-28,185.64,supplier_payment,out,Counterparty_28,21294417.48,2025-05-04,2025-05-29
2025-05-28,1323.14,asset_sale,in,Counterparty_88,21295740.62,,
2025-05-28,443.87,T&E,out,Counterparty_58,21295296.75,2025-05-12,2025-06-07
2025-05-28,348.96,T&E,out,Counterparty_55,21294947.79,2025-04-30,2025-06-01
2025-05-28,1954.42,utilities,out,Counterparty_81,21292993.37,2025-04-30,2025-05-27
2025-05-28,768.12,asset_sale,in,Counterparty_38,21293761.49,,
2025-05-28,935.31,software_subscription,out,Counterparty_63,21292826.18,2025-05-04,2025-06-08
2025-05-28,5556.87,tax_payment,out,Counterparty_29,21287269.31,2025-05-08,2025-06-12
2025-05-28,2772.58,rent,out,Counterparty_68,21284496.73,2025-04-24,2025-05-22
2025-05-28,4942.79,investment_income,in,Counterparty_39,21289439.52,,
2025-05-29,1912.68,supplier_payment,out,Counterparty_22,21287526.84,2025-05-08,2025-06-02
2025-05-29,1519.0,investment_income,in,Counterparty_21,21289045.84,,
2025-05-29,211.81,refund,in,Counterparty_34,21289257.65,,
2025-05-29,1937.45,investment_income,in,Counterparty_83,21291195.1,,
2025-05-29,6974.47,credit,in,Counterparty_24,21298169.57,,
2025-05-29,1751.6,asset_sale,in,Counterparty_48,21299921.17,,
2025-05-29,4146.36,asset_sale,in,Counterparty_20,21304067.53,,
2025-05-29,1001.12,rent,out,Counterparty_68,21303066.41,2025-05-05,2025-06-13
2025-05-29,377.52,customer_payment,in,Counterparty_27,21303443.93,,
2025-05-29,1048.0,utilities,out,Counterparty_55,21302395.93,2025-04-25,2025-05-26
2025-05-29,1236.23,T&E,out,Counterparty_11,21301159.7,2025-05-12,2025-06-13
2025-05-29,73.39,investment_income,in,Counterparty_95,21301233.09,,
2025-05-29,172.72,refund,in,Counterparty_37,21301405.81,,
2025-05-29,1621.91,software_subscription,out,Counterparty_11,21299783.9,2025-04-15,2025-05-24
2025-05-29,607.55,utilities,out,Counterparty_99,21299176.35,2025-04-17,2025-05-19
2025-05-29,2799.62,T&E,out,Counterparty_39,21296376.73,2025-04-22,2025-05-17
2025-05-29,3602.39,refund,in,Counterparty_19,21299979.12,,
2025-05-29,3779.94,payroll,out,Counterparty_48,21296199.18,2025-04-19,2025-05-23
2025-05-29,838.57,payroll,out,Counterparty_23,21295360.61,2025-05-07,2025-06-12
2025-05-29,15294.96,refund,in,Counterparty_95,21310655.57,,
2025-05-29,1567.62,credit,in,Counterparty_60,21312223.19,,
2025-05-29,1582.9,investment_income,in,Counterparty_12,21313806.09,,
2025-05-29,5882.73,tax_payment,out,Counterparty_39,21307923.36,2025-05-02,2025-06-04
2025-05-29,735.05,utilities,out,Counterparty_91,21307188.31,2025-05-06,2025-06-01
2025-05-29,1890.02,supplier_payment,out,Counterparty_69,21305298.29,2025-04-26,2025-05-27
2025-05-29,1058.09,software_subscription,out,Counterparty_91,21304240.2,2025-04-28,2025-05-30
2025-05-29,1576.49,payroll,out,Counterparty_50,21302663.71,2025-04-27,2025-06-04
2025-05-29,634.26,tax_payment,out,Counterparty_3,21302029.45,2025-04-16,2025-05-17
2025-05-29,2021.84,tax_payment,out,Counterparty_17,21300007.61,2025-04-15,2025-05-24
2025-05-29,1227.19,loan_repayment,out,Counterparty_45,21298780.42,2025-04-20,2025-05-20
2025-05-29,1280.72,investment_income,in,Counterparty_67,21300061.14,,
2025-05-29,913.07,tax_payment,out,Counterparty_32,21299148.07,2025-04-29,2025-05-30
2025-05-29,445.15,rent,out,Counterparty_95,21298702.92,2025-04-19,2025-05-14
2025-05-29,6365.97,customer_payment,in,Counterparty_5,21305068.89,,
2025-05-29,1699.19,payroll,out,Counterparty_78,21303369.7,2025-05-06,2025-06-10
2025-05-29,1134.39,loan_repayment,out,Counterparty_62,21302235.31,2025-04-27,2025-05-23
2025-05-29,5737.96,tax_payment,out,Counterparty_85,21296497.35,2025-04-27,2025-06-04
2025-05-29,2144.66,utilities,out,Counterparty_93,21294352.69,2025-04-15,2025-05-21
2025-05-29,6929.82,supplier_payment,out,Counterparty_37,21287422.87,2025-05-08,2025-06-12
2025-05-29,1463.56,utilities,out,Counterparty_32,21285959.31,2025-05-11,2025-06-16
2025-05-29,3266.11,software_subscription,out,Counterparty_23,21282693.2,2025-04-24,2025-05-29
2025-05-29,1135.6,tax_payment,out,Counterparty_74,21281557.6,2025-05-13,2025-06-16
2025-05-29,1572.93,payroll,out,Counterparty_11,21279984.67,2025-05-01,2025-06-01
2025-05-29,903.45,software_subscription,out,Counterparty_10,21279081.22,2025-05-03,2025-06-03
2025-05-29,1653.5,T&E,out,Counterparty_40,21277427.72,2025-04-29,2025-06-04
2025-05-29,8544.78,marketing_spend,out,Counterparty_2,21268882.94,2025-04-17,2025-05-23
2025-05-29,4353.25,payroll,out,Counterparty_66,21264529.69,2025-05-14,2025-06-20
2025-05-29,870.37,investment_income,in,Counterparty_52,21265400.06,,
2025-05-29,3861.36,credit,in,Counterparty_57,21269261.42,,
2025-05-29,1140.78,tax_payment,out,Counterparty_97,21268120.64,2025-05-05,2025-06-08
2025-05-29,2432.7,payroll,out,Counterparty_52,21265687.94,2025-05-14,2025-06-22
2025-05-29,3932.0,marketing_spend,out,Counterparty_99,21261755.94,2025-04-23,2025-05-29
2025-05-29,543.15,software_subscription,out,Counterparty_93,21261212.79,2025-04-17,2025-05-14
2025-05-29,136.82,supplier_payment,out,Counterparty_87,21261075.97,2025-04-30,2025-05-29
2025-05-29,2101.24,software_subscription,out,Counterparty_1,21258974.73,2025-05-14,2025-06-08
2025-05-29,2556.19,asset_sale,in,Counterparty_78,21261530.92,,
2025-05-29,6189.98,loan_repayment,out,Counterparty_18,21255340.94,2025-04-19,2025-05-23
2025-05-29,4894.35,asset_sale,in,Counterparty_14,21260235.29,,
2025-05-29,827.03,supplier_payment,out,Counterparty_30,21259408.26,2025-04-26,2025-05-30
2025-05-29,409.18,marketing_spend,out,Counterparty_62,21258999.08,2025-04-22,2025-05-26
2025-05-29,474.35,loan_repayment,out,Counterparty_21,21258524.73,2025-05-09,2025-06-13
2025-05-29,1084.87,credit,in,Counterparty_16,21259609.6,,
2025-05-29,93.61,software_subscription,out,Counterparty_6,21259515.99,2025-05-11,2025-06-05
2025-05-29,7279.96,asset_sale,in,Counterparty_38,21266795.95,,
2025-05-30,41.31,rent,out,Counterparty_46,21266754.64,2025-04-16,2025-05-23
2025-05-30,6018.64,credit,in,Counterparty_19,21272773.28,,
2025-05-30,1024.08,credit,in,Counterparty_3,21273797.36,,
2025-05-30,4227.32,investment_income,in,Counterparty_69,21278024.68,,
2025-05-30,371.74,customer_payment,in,Counterparty_95,21278396.42,,
2025-05-30,5591.9,asset_sale,in,Counterparty_41,21283988.32,,
2025-05-30,1352.32,investment_income,in,Counterparty_34,21285340.64,,
2025-05-30,1534.81,asset_sale,in,Counterparty_67,21286875.45,,
2025-05-30,1759.53,credit,in,Counterparty_25,21288634.98,,
2025-05-30,5063.11,credit,in,Counterparty_9,21293698.09,,
2025-05-30,52.75,investment_income,in,Counterparty_60,21293750.84,,
2025-05-30,681.35,customer_payment,in,Counterparty_98,21294432.19,,
2025-05-30,2305.61,T&E,out,Counterparty_32,21292126.58,2025-05-04,2025-06-05
2025-05-30,2272.85,refund,in,Counterparty_13,21294399.43,,
2025-05-30,2540.94,asset_sale,in,Counterparty_71,21296940.37,,
2025-05-30,507.23,credit,in,Counterparty_43,21297447.6,,
2025-05-30,1536.88,asset_sale,in,Counterparty_45,21298984.48,,
2025-05-30,13896.81,credit,in,Counterparty_77,21312881.29,,
2025-05-30,589.2,credit,in,Counterparty_73,21313470.49,,
2025-05-30,162.25,tax_payment,out,Counterparty_21,21313308.24,2025-04-25,2025-06-02
2025-05-30,443.79,refund,in,Counterparty_63,21313752.03,,
2025-05-30,2284.53,customer_payment,in,Counterparty_26,21316036.56,,
2025-05-30,2019.82,payroll,out,Counterparty_36,21314016.74,2025-04-21,2025-05-20
2025-05-30,4651.06,tax_payment,out,Counterparty_69,21309365.68,2025-04-29,2025-05-24
2025-05-30,535.05,marketing_spend,out,Counterparty_17,21308830.63,2025-04-26,2025-05-21
2025-05-30,32.34,supplier_payment,out,Counterparty_79,21308798.29,2025-04-19,2025-05-28
2025-05-30,7709.16,rent,out,Counterparty_3,21301089.13,2025-05-06,2025-06-11
2025-05-30,1548.34,software_subscription,out,Counterparty_26,21299540.79,2025-05-05,2025-06-06
2025-05-30,103.04,T&E,out,Counterparty_56,21299437.75,2025-05-01,2025-05-31
2025-05-30,36.07,marketing_spend,out,Counterparty_14,21299401.68,2025-05-05,2025-06-11
2025-05-30,1723.52,payroll,out,Counterparty_69,21297678.16,2025-05-04,2025-06-10
2025-05-30,821.38,loan_repayment,out,Counterparty_12,21296856.78,2025-05-03,2025-06-02
2025-05-30,797.23,marketing_spend,out,Counterparty_58,21296059.55,2025-05-11,2025-06-05
2025-05-30,177.63,utilities,out,Counterparty_76,21295881.92,2025-05-12,2025-06-06
2025-05-30,7238.17,rent,out,Counterparty_70,21288643.75,2025-04-26,2025-05-28
2025-05-30,2134.56,T&E,out,Counterparty_48,21286509.19,2025-04-25,2025-06-01
2025-05-30,4127.93,supplier_payment,out,Counterparty_34,21282381.26,2025-04-19,2025-05-27
2025-05-30,640.51,loan_repayment,out,Counterparty_13,21281740.75,2025-04-30,2025-05-25
2025-05-30,1557.74,marketing_spend,out,Counterparty_38,21280183.01,2025-05-02,2025-06-09
2025-05-30,386.37,supplier_payment,out,Counterparty_31,21279796.64,2025-05-02,2025-06-06
2025-05-30,2248.86,tax_payment,out,Counterparty_98,21277547.78,2025-04-18,2025-05-15
2025-05-30,3907.53,payroll,out,Counterparty_32,21273640.25,2025-04-28,2025-05-23
2025-05-30,1294.97,software_subscription,out,Counterparty_86,21272345.28,2025-05-04,2025-06-01
2025-05-30,31.31,payroll,out,Counterparty_39,21272313.97,2025-05-05,2025-05-30
2025-05-30,1113.01,marketing_spend,out,Counterparty_84,21271200.96,2025-05-15,2025-06-17
2025-05-30,2286.29,loan_repayment,out,Counterparty_12,21268914.67,2025-04-27,2025-06-03
2025-05-30,4798.88,loan_repayment,out,Counterparty_28,21264115.79,2025-04-23,2025-05-31
2025-05-30,3646.37,rent,out,Counterparty_5,21260469.42,2025-04-28,2025-06-05
2025-05-30,2903.75,supplier_payment,out,Counterparty_71,21257565.67,2025-04-21,2025-05-25
2025-05-30,3432.79,refund,in,Counterparty_15,21260998.46,,
2025-05-30,4117.53,marketing_spend,out,Counterparty_45,21256880.93,2025-05-11,2025-06-10
2025-05-30,540.51,customer_payment,in,Counterparty_32,21257421.44,,
2025-05-30,473.12,investment_income,in,Counterparty_98,21257894.56,,
2025-05-30,722.43,utilities,out,Counterparty_34,21257172.13,2025-05-08,2025-06-09
2025-05-30,2576.57,customer_payment,in,Counterparty_28,21259748.7,,
2025-05-30,1392.0,investment_income,in,Counterparty_15,21261140.7,,
2025-05-30,4519.8,supplier_payment,out,Counterparty_7,21256620.9,2025-04-16,2025-05-19
2025-05-30,2676.66,asset_sale,in,Counterparty_35,21259297.56,,
2025-05-30,1528.71,software_subscription,out,Counterparty_4,21257768.85,2025-05-14,2025-06-18
2025-05-30,211.15,customer_payment,in,Counterparty_40,21257980.0,,
2025-05-30,2740.94,asset_sale,in,Counterparty_17,21260720.94,,
2025-05-30,239.44,T&E,out,Counterparty_73,21260481.5,2025-05-08,2025-06-04
2025-05-30,3146.2,refund,in,Counterparty_6,21263627.7,,
2025-05-30,506.77,marketing_spend,out,Counterparty_72,21263120.93,2025-04-27,2025-05-23
2025-05-30,987.02,T&E,out,Counterparty_13,21262133.91,2025-05-12,2025-06-06
2025-05-30,2690.35,investment_income,in,Counterparty_76,21264824.26,,
2025-05-30,223.22,payroll,out,Counterparty_91,21264601.04,2025-04-19,2025-05-14
2025-05-30,5528.02,rent,out,Counterparty_81,21259073.02,2025-05-12,2025-06-16
2025-05-30,844.16,tax_payment,out,Counterparty_49,21258228.86,2025-05-03,2025-05-28
2025-05-30,2202.62,customer_payment,in,Counterparty_87,21260431.48,,
2025-05-30,629.05,customer_payment,in,Counterparty_93,21261060.53,,
2025-05-30,2961.88,refund,in,Counterparty_18,21264022.41,,
2025-05-31,4242.23,marketing_spend,out,Counterparty_36,21259780.18,2025-05-01,2025-05-30
2025-05-31,1080.73,asset_sale,in,Counterparty_82,21260860.91,,
2025-05-31,4277.4,tax_payment,out,Counterparty_14,21256583.51,2025-05-05,2025-06-10
2025-05-31,382.77,tax_payment,out,Counterparty_6,21256200.74,2025-05-01,2025-06-01
2025-05-31,2004.11,rent,out,Counterparty_30,21254196.63,2025-05-16,2025-06-22
2025-05-31,2143.31,investment_income,in,Counterparty_48,21256339.94,,
2025-05-31,2109.47,T&E,out,Counterparty_25,21254230.47,2025-04-30,2025-06-03
2025-05-31,561.49,customer_payment,in,Counterparty_19,21254791.96,,
2025-05-31,117.89,utilities,out,Counterparty_46,21254674.07,2025-04-25,2025-05-20
2025-05-31,1264.12,software_subscription,out,Counterparty_65,21253409.95,2025-04-27,2025-06-02
2025-05-31,610.32,loan_repayment,out,Counterparty_71,21252799.63,2025-05-16,2025-06-10
2025-05-31,549.18,tax_payment,out,Counterparty_53,21252250.45,2025-05-04,2025-06-09
2025-05-31,2067.41,payroll,out,Counterparty_12,21250183.04,2025-05-12,2025-06-10
2025-05-31,2615.9,payroll,out,Counterparty_72,21247567.14,2025-05-13,2025-06-13
2025-05-31,2548.07,loan_repayment,out,Counterparty_69,21245019.07,2025-04-20,2025-05-20
2025-05-31,3231.19,utilities,out,Counterparty_68,21241787.88,2025-05-11,2025-06-17
2025-05-31,2619.41,tax_payment,out,Counterparty_33,21239168.47,2025-05-13,2025-06-10
2025-05-31,64.7,rent,out,Counterparty_42,21239103.77,2025-04-23,2025-06-01
2025-05-31,69.3,customer_payment,in,Counterparty_10,21239173.07,,
2025-05-31,4495.1,refund,in,Counterparty_47,21243668.17,,
2025-05-31,1391.26,utilities,out,Counterparty_48,21242276.91,2025-04-19,2025-05-14
2025-05-31,174.47,credit,in,Counterparty_50,21242451.38,,
2025-05-31,12723.79,credit,in,Counterparty_64,21255175.17,,
2025-05-31,1523.71,credit,in,Counterparty_40,21256698.88,,
2025-05-31,31.18,refund,in,Counterparty_9,21256730.06,,
2025-05-31,2957.38,investment_income,in,Counterparty_68,21259687.44,,
2025-05-31,807.32,refund,in,Counterparty_83,21260494.76,,
2025-05-31,699.46,refund,in,Counterparty_3,21261194.22,,
2025-05-31,439.52,asset_sale,in,Counterparty_63,21261633.74,,
2025-05-31,197.02,credit,in,Counterparty_76,21261830.76,,
2025-05-31,9710.58,marketing_spend,out,Counterparty_80,21252120.18,2025-05-15,2025-06-12
2025-05-31,1854.1,refund,in,Counterparty_51,21253974.28,,
2025-05-31,1728.56,refund,in,Counterparty_77,21255702.84,,
2025-05-31,396.87,supplier_payment,out,Counterparty_72,21255305.97,2025-05-11,2025-06-19
2025-05-31,5140.72,rent,out,Counterparty_62,21250165.25,2025-05-11,2025-06-12
2025-05-31,817.43,loan_repayment,out,Counterparty_50,21249347.82,2025-04-29,2025-06-06
2025-05-31,1165.06,credit,in,Counterparty_77,21250512.88,,
2025-05-31,1998.01,utilities,out,Counterparty_64,21248514.87,2025-05-03,2025-06-09
2025-05-31,911.39,utilities,out,Counterparty_99,21247603.48,2025-05-04,2025-06-09
2025-05-31,1614.78,T&E,out,Counterparty_23,21245988.7,2025-05-11,2025-06-09
2025-05-31,2255.76,utilities,out,Counterparty_3,21243732.94,2025-05-11,2025-06-16
2025-05-31,189.38,T&E,out,Counterparty_92,21243543.56,2025-04-30,2025-05-31
2025-05-31,1806.61,refund,in,Counterparty_17,21245350.17,,
2025-05-31,1652.56,investment_income,in,Counterparty_3,21247002.73,,
2025-05-31,24.17,software_subscription,out,Counterparty_55,21246978.56,2025-05-09,2025-06-11
2025-05-31,6403.03,software_subscription,out,Counterparty_64,21240575.53,2025-05-01,2025-05-29
2025-05-31,7405.89,investment_income,in,Counterparty_52,21247981.42,,
2025-05-31,10525.28,marketing_spend,out,Counterparty_41,21237456.14,2025-05-09,2025-06-11
2025-06-01,398.74,customer_payment,in,Counterparty_7,21237854.88,,
2025-06-01,490.8,T&E,out,Counterparty_56,21237364.08,2025-04-23,2025-05-18
2025-06-01,1636.49,rent,out,Counterparty_57,21235727.59,2025-05-15,2025-06-16
2025-06-01,1671.22,investment_income,in,Counterparty_70,21237398.81,,
2025-06-01,3109.04,investment_income,in,Counterparty_26,21240507.85,,
2025-06-01,410.56,tax_payment,out,Counterparty_60,21240097.29,2025-04-27,2025-05-27
2025-06-01,4972.3,credit,in,Counterparty_76,21245069.59,,
2025-06-01,4129.37,utilities,out,Counterparty_21,21240940.22,2025-05-02,2025-06-04
2025-06-01,830.89,rent,out,Counterparty_59,21240109.33,2025-05-03,2025-05-30
2025-06-01,1230.03,payroll,out,Counterparty_2,21238879.3,2025-04-30,2025-05-30
2025-06-01,7651.16,software_subscription,out,Counterparty_5,21231228.14,2025-04-27,2025-05-29
2025-06-01,4361.98,credit,in,Counterparty_52,21235590.12,,
2025-06-01,1646.39,tax_payment,out,Counterparty_35,21233943.73,2025-05-06,2025-06-13
2025-06-01,2665.71,loan_repayment,out,Counterparty_12,21231278.02,2025-05-15,2025-06-17
2025-06-01,662.23,refund,in,Counterparty_8,21231940.25,,
2025-06-01,2301.41,marketing_spend,out,Counterparty_23,21229638.84,2025-04-26,2025-05-26
2025-06-01,1905.57,software_subscription,out,Counterparty_76,21227733.27,2025-04-25,2025-06-02
2025-06-01,387.61,customer_payment,in,Counterparty_87,21228120.88,,
2025-06-01,2255.64,customer_payment,in,Counterparty_4,21230376.52,,
2025-06-01,1477.25,investment_income,in,Counterparty_41,21231853.77,,
2025-06-01,292.01,T&E,out,Counterparty_64,21231561.76,2025-05-11,2025-06-08
2025-06-01,2941.05,rent,out,Counterparty_99,21228620.71,2025-05-05,2025-05-30
2025-06-01,77.11,tax_payment,out,Counterparty_67,21228543.6,2025-04-24,2025-06-01
2025-06-01,1837.16,utilities,out,Counterparty_96,21226706.44,2025-04-21,2025-05-16
2025-06-01,3099.16,payroll,out,Counterparty_71,21223607.28,2025-04-20,2025-05-25
2025-06-01,4190.46,tax_payment,out,Counterparty_70,21219416.82,2025-05-02,2025-05-29
2025-06-01,1815.96,credit,in,Counterparty_79,21221232.78,,
2025-06-01,2287.13,tax_payment,out,Counterparty_26,21218945.65,2025-05-05,2025-06-01
2025-06-01,903.86,credit,in,Counterparty_24,21219849.51,,
2025-06-01,543.2,credit,in,Counterparty_69,21220392.71,,
2025-06-01,6087.53,credit,in,Counterparty_26,21226480.24,,
2025-06-01,3509.32,investment_income,in,Counterparty_1,21229989.56,,
2025-06-01,2571.25,credit,in,Counterparty_36,21232560.81,,
2025-06-01,81.28,credit,in,Counterparty_10,21232642.09,,
2025-06-01,4649.6,software_subscription,out,Counterparty_11,21227992.49,2025-05-17,2025-06-24
2025-06-01,882.38,credit,in,Counterparty_83,21228874.87,,
2025-06-01,1573.33,tax_payment,out,Counterparty_28,21227301.54,2025-04-27,2025-06-01
2025-06-01,1708.11,marketing_spend,out,Counterparty_26,21225593.43,2025-04-24,2025-05-28
2025-06-01,5109.44,investment_income,in,Counterparty_85,21230702.87,,
2025-06-01,4165.94,software_subscription,out,Counterparty_69,21226536.93,2025-04-29,2025-06-05
2025-06-01,107.79,tax_payment,out,Counterparty_33,21226429.14,2025-05-16,2025-06-19
2025-06-01,4604.91,refund,in,Counterparty_27,21231034.05,,
2025-06-01,5154.04,rent,out,Counterparty_66,21225880.01,2025-05-01,2025-05-28
2025-06-01,2175.2,refund,in,Counterparty_14,21228055.21,,
2025-06-01,1768.71,asset_sale,in,Counterparty_81,21229823.92,,
2025-06-01,1487.05,credit,in,Counterparty_79,21231310.97,,
2025-06-01,349.52,T&E,out,Counterparty_93,21230961.45,2025-05-17,2025-06-19
2025-06-01,1788.44,customer_payment,in,Counterparty_79,21232749.89,,
2025-06-01,8800.33,software_subscription,out,Counterparty_95,21223949.56,2025-04-18,2025-05-27
2025-06-01,1470.97,asset_sale,in,Counterparty_10,21225420.53,,
2025-06-01,2110.94,T&E,out,Counterparty_97,21223309.59,2025-05-07,2025-06-02
2025-06-01,2752.38,credit,in,Counterparty_73,21226061.97,,
2025-06-01,5890.38,customer_payment,in,Counterparty_83,21231952.35,,
2025-06-01,2180.29,customer_payment,in,Counterparty_94,21234132.64,,
2025-06-01,2300.96,supplier_payment,out,Counterparty_39,21231831.68,2025-05-10,2025-06-11
2025-06-01,547.24,refund,in,Counterparty_49,21232378.92,,
2025-06-01,1553.85,investment_income,in,Counterparty_30,21233932.77,,
2025-06-01,698.42,payroll,out,Counterparty_89,21233234.35,2025-04-25,2025-06-02
2025-06-01,1321.92,asset_sale,in,Counterparty_12,21234556.27,,
2025-06-01,905.13,asset_sale,in,Counterparty_98,21235461.4,,
2025-06-01,198.21,refund,in,Counterparty_25,21235659.61,,
2025-06-02,15186.99,customer_payment,in,Counterparty_59,21250846.6,,
2025-06-02,6283.72,utilities,out,Counterparty_56,21244562.88,2025-04-23,2025-05-23
2025-06-02,2208.17,investment_income,in,Counterparty_84,21246771.05,,
2025-06-02,172.61,asset_sale,in,Counterparty_6,21246943.66,,
2025-06-02,3287.43,loan_repayment,out,Counterparty_7,21243656.23,2025-04-23,2025-05-20
2025-06-02,15748.48,rent,out,Counterparty_24,21227907.75,2025-05-09,2025-06-15
2025-06-02,7651.92,utilities,out,Counterparty_49,21220255.83,2025-05-17,2025-06-19
2025-06-02,3774.16,supplier_payment,out,Counterparty_52,21216481.67,2025-05-17,2025-06-18
2025-06-02,287.68,asset_sale,in,Counterparty_72,21216769.35,,
2025-06-02,3650.21,loan_repayment,out,Counterparty_38,21213119.14,2025-04-25,2025-05-24
2025-06-02,3689.8,supplier_payment,out,Counterparty_19,21209429.34,2025-05-13,2025-06-18
2025-06-02,5019.02,investment_income,in,Counterparty_73,21214448.36,,
2025-06-02,4258.63,customer_payment,in,Counterparty_75,21218706.99,,
2025-06-02,653.7,marketing_spend,out,Counterparty_5,21218053.29,2025-05-09,2025-06-16
2025-06-02,2121.5,utilities,out,Counterparty_73,21215931.79,2025-04-28,2025-06-01
2025-06-02,3960.29,asset_sale,in,Counterparty_89,21219892.08,,
2025-06-02,334.41,tax_payment,out,Counterparty_31,21219557.67,2025-05-01,2025-05-31
2025-06-02,4737.12,T&E,out,Counterparty_27,21214820.55,2025-04-25,2025-05-31
2025-06-02,2676.65,refund,in,Counterparty_3,21217497.2,,
2025-06-02,43.61,software_subscription,out,Counterparty_76,21217453.59,2025-04-28,2025-06-04
2025-06-02,4174.89,investment_income,in,Counterparty_33,21221628.48,,
2025-06-02,661.75,utilities,out,Counterparty_10,21220966.73,2025-04-21,2025-05-20
2025-06-02,972.4,investment_income,in,Counterparty_77,21221939.13,,
2025-06-02,491.79,rent,out,Counterparty_35,21221447.34,2025-05-11,2025-06-19
2025-06-02,2602.83,customer_payment,in,Counterparty_99,21224050.17,,
2025-06-02,4575.16,T&E,out,Counterparty_75,21219475.01,2025-05-11,2025-06-14
2025-06-02,674.44,software_subscription,out,Counterparty_75,21218800.57,2025-05-17,2025-06-21
2025-06-02,2735.22,asset_sale,in,Counterparty_80,21221535.79,,
2025-06-02,919.07,investment_income,in,Counterparty_37,21222454.86,,
2025-06-02,143.64,T&E,out,Counterparty_87,21222311.22,2025-05-18,2025-06-23
2025-06-02,3398.2,investment_income,in,Counterparty_23,21225709.42,,
2025-06-02,1443.23,investment_income,in,Counterparty_60,21227152.65,,
2025-06-02,2480.55,credit,in,Counterparty_58,21229633.2,,
2025-06-02,1149.0,asset_sale,in,Counterparty_78,21230782.2,,
2025-06-02,4402.96,refund,in,Counterparty_40,21235185.16,,
2025-06-02,8510.71,refund,in,Counterparty_46,21243695.87,,
2025-06-02,2397.03,supplier_payment,out,Counterparty_21,21241298.84,2025-05-05,2025-06-02
2025-06-02,419.03,supplier_payment,out,Counterparty_62,21240879.81,2025-05-18,2025-06-13
2025-06-02,8962.65,customer_payment,in,Counterparty_18,21249842.46,,
2025-06-02,2481.52,marketing_spend,out,Counterparty_53,21247360.94,2025-04-27,2025-05-28
2025-06-02,1788.87,marketing_spend,out,Counterparty_12,21245572.07,2025-05-16,2025-06-12
2025-06-02,108.11,marketing_spend,out,Counterparty_24,21245463.96,2025-05-02,2025-05-27
2025-06-02,3050.06,credit,in,Counterparty_55,21248514.02,,
2025-06-02,65.25,T&E,out,Counterparty_25,21248448.77,2025-05-09,2025-06-14
2025-06-02,1167.33,utilities,out,Counterparty_68,21247281.44,2025-05-04,2025-06-10
2025-06-02,504.16,marketing_spend,out,Counterparty_47,21246777.28,2025-04-27,2025-05-25
2025-06-02,2536.98,customer_payment,in,Counterparty_73,21249314.26,,
2025-06-02,4100.15,asset_sale,in,Counterparty_46,21253414.41,,
2025-06-02,1580.93,credit,in,Counterparty_90,21254995.34,,
2025-06-02,1680.0,credit,in,Counterparty_47,21256675.34,,
2025-06-02,925.71,refund,in,Counterparty_35,21257601.05,,
2025-06-03,912.17,customer_payment,in,Counterparty_52,21258513.22,,
2025-06-03,1076.18,supplier_payment,out,Counterparty_66,21257437.04,2025-05-15,2025-06-13
2025-06-03,1709.85,software_subscription,out,Counterparty_38,21255727.19,2025-04-23,2025-05-22
2025-06-03,673.13,loan_repayment,out,Counterparty_6,21255054.06,2025-05-13,2025-06-12
2025-06-03,5830.8,loan_repayment,out,Counterparty_20,21249223.26,2025-05-02,2025-06-04
2025-06-03,2958.25,tax_payment,out,Counterparty_98,21246265.01,2025-05-12,2025-06-14
2025-06-03,1190.38,payroll,out,Counterparty_70,21245074.63,2025-05-05,2025-06-07
2025-06-03,2764.11,payroll,out,Counterparty_90,21242310.52,2025-04-29,2025-06-03
2025-06-03,3569.06,investment_income,in,Counterparty_56,21245879.58,,
2025-06-03,1968.4,refund,in,Counterparty_17,21247847.98,,
2025-06-03,2967.98,rent,out,Counterparty_56,21244880.0,2025-05-02,2025-06-09
2025-06-03,2160.98,loan_repayment,out,Counterparty_9,21242719.02,2025-04-29,2025-05-28
2025-06-03,3253.11,rent,out,Counterparty_67,21239465.91,2025-04-30,2025-06-05
2025-06-03,5081.54,investment_income,in,Counterparty_65,21244547.45,,
2025-06-03,4356.11,credit,in,Counterparty_54,21248903.56,,
2025-06-03,1063.43,investment_income,in,Counterparty_60,21249966.99,,
2025-06-03,4184.67,asset_sale,in,Counterparty_46,21254151.66,,
2025-06-03,4958.79,customer_payment,in,Counterparty_51,21259110.45,,
2025-06-03,3115.28,asset_sale,in,Counterparty_62,21262225.73,,
2025-06-03,437.7,asset_sale,in,Counterparty_26,21262663.43,,
2025-06-03,1108.14,credit,in,Counterparty_98,21263771.57,,
2025-06-03,12093.6,customer_payment,in,Counterparty_16,21275865.17,,
2025-06-03,1149.38,investment_income,in,Counterparty_65,21277014.55,,
2025-06-03,2740.13,customer_payment,in,Counterparty_91,21279754.68,,
2025-06-03,2159.34,customer_payment,in,Counterparty_67,21281914.02,,
2025-06-03,2249.66,refund,in,Counterparty_89,21284163.68,,
2025-06-03,901.81,marketing_spend,out,Counterparty_10,21283261.87,2025-05-18,2025-06-21
2025-06-03,1651.09,investment_income,in,Counterparty_72,21284912.96,,
2025-06-03,6723.41,T&E,out,Counterparty_79,21278189.55,2025-05-16,2025-06-10
2025-06-03,973.67,payroll,out,Counterparty_76,21277215.88,2025-05-13,2025-06-17
2025-06-03,922.95,software_subscription,out,Counterparty_98,21276292.93,2025-05-16,2025-06-13
2025-06-03,7386.43,tax_payment,out,Counterparty_58,21268906.5,2025-04-30,2025-05-31
2025-06-03,1129.87,customer_payment,in,Counterparty_8,21270036.37,,
2025-06-03,14180.91,tax_payment,out,Counterparty_24,21255855.46,2025-05-19,2025-06-24
2025-06-03,2482.17,investment_income,in,Counterparty_54,21258337.63,,
2025-06-03,311.92,supplier_payment,out,Counterparty_10,21258025.71,2025-04-23,2025-05-20
2025-06-03,724.31,marketing_spend,out,Counterparty_31,21257301.4,2025-05-09,2025-06-14
2025-06-03,962.02,utilities,out,Counterparty_59,21256339.38,2025-05-03,2025-06-06
2025-06-03,2077.41,utilities,out,Counterparty_68,21254261.97,2025-04-21,2025-05-26
2025-06-03,6796.3,investment_income,in,Counterparty_75,21261058.27,,
2025-06-03,3437.85,marketing_spend,out,Counterparty_63,21257620.42,2025-05-19,2025-06-18
2025-06-03,3154.65,investment_income,in,Counterparty_33,21260775.07,,
2025-06-03,8272.07,tax_payment,out,Counterparty_24,21252503.0,2025-05-10,2025-06-11
2025-06-03,1765.81,investment_income,in,Counterparty_53,21254268.81,,
2025-06-03,502.46,rent,out,Counterparty_13,21253766.35,2025-04-21,2025-05-19
2025-06-03,389.86,investment_income,in,Counterparty_45,21254156.21,,
2025-06-03,5746.43,T&E,out,Counterparty_59,21248409.78,2025-04-22,2025-05-31
2025-06-03,9544.4,customer_payment,in,Counterparty_8,21257954.18,,
2025-06-03,934.74,supplier_payment,out,Counterparty_80,21257019.44,2025-05-11,2025-06-06
2025-06-03,1094.8,T&E,out,Counterparty_55,21255924.64,2025-04-22,2025-05-25
2025-06-03,4539.17,asset_sale,in,Counterparty_44,21260463.81,,
2025-06-03,9404.0,payroll,out,Counterparty_13,21251059.81,2025-05-01,2025-05-29
2025-06-03,2749.17,payroll,out,Counterparty_20,21248310.64,2025-04-25,2025-05-22
2025-06-03,3387.08,rent,out,Counterparty_17,21244923.56,2025-05-03,2025-06-07
2025-06-03,953.06,marketing_spend,out,Counterparty_33,21243970.5,2025-05-07,2025-06-10
2025-06-03,5000.74,payroll,out,Counterparty_5,21238969.76,2025-05-10,2025-06-10
2025-06-03,381.1,payroll,out,Counterparty_84,21238588.66,2025-04-26,2025-05-29
2025-06-03,1593.58,utilities,out,Counterparty_67,21236995.08,2025-04-24,2025-05-22
2025-06-03,1286.72,loan_repayment,out,Counterparty_87,21235708.36,2025-05-10,2025-06-18
2025-06-03,4645.56,loan_repayment,out,Counterparty_50,21231062.8,2025-05-04,2025-06-08
2025-06-03,4731.8,credit,in,Counterparty_66,21235794.6,,
2025-06-03,716.44,loan_repayment,out,Counterparty_31,21235078.16,2025-05-14,2025-06-08
2025-06-03,663.85,refund,in,Counterparty_62,21235742.01,,
2025-06-03,286.77,loan_repayment,out,Counterparty_55,21235455.24,2025-04-28,2025-05-26
2025-06-03,2106.09,payroll,out,Counterparty_32,21233349.15,2025-04-22,2025-05-23
2025-06-03,1098.56,investment_income,in,Counterparty_66,21234447.71,,
2025-06-04,857.85,rent,out,Counterparty_33,21233589.86,2025-05-01,2025-06-02
2025-06-04,3112.29,asset_sale,in,Counterparty_72,21236702.15,,
2025-06-04,1225.92,rent,out,Counterparty_20,21235476.23,2025-05-03,2025-06-04
2025-06-04,5409.46,credit,in,Counterparty_33,21240885.69,,
2025-06-04,4808.41,loan_repayment,out,Counterparty_21,21236077.28,2025-04-21,2025-05-22
2025-06-04,1768.89,T&E,out,Counterparty_70,21234308.39,2025-05-18,2025-06-16
2025-06-04,104.25,marketing_spend,out,Counterparty_96,21234204.14,2025-05-18,2025-06-20
2025-06-04,1828.81,customer_payment,in,Counterparty_4,21236032.95,,
2025-06-04,4790.79,asset_sale,in,Counterparty_77,21240823.74,,
2025-06-04,3235.52,software_subscription,out,Counterparty_95,21237588.22,2025-05-02,2025-06-01
2025-06-04,2661.12,tax_payment,out,Counterparty_89,21234927.1,2025-05-16,2025-06-24
2025-06-04,1004.57,T&E,out,Counterparty_44,21233922.53,2025-05-10,2025-06-17
2025-06-04,395.17,rent,out,Counterparty_18,21233527.36,2025-05-12,2025-06-07
2025-06-04,4393.32,marketing_spend,out,Counterparty_16,21229134.04,2025-05-19,2025-06-27
2025-06-04,6659.14,payroll,out,Counterparty_72,21222474.9,2025-05-18,2025-06-19
2025-06-04,3699.88,asset_sale,in,Counterparty_14,21226174.78,,
2025-06-04,3677.02,marketing_spend,out,Counterparty_86,21222497.76,2025-04-23,2025-05-20
2025-06-04,4395.26,asset_sale,in,Counterparty_86,21226893.02,,
2025-06-04,698.02,credit,in,Counterparty_65,21227591.04,,
2025-06-04,2548.72,asset_sale,in,Counterparty_58,21230139.76,,
2025-06-04,1517.23,credit,in,Counterparty_33,21231656.99,,
2025-06-04,8273.49,credit,in,Counterparty_89,21239930.48,,
2025-06-04,2800.66,payroll,out,Counterparty_54,21237129.82,2025-04-27,2025-05-31
2025-06-04,2848.93,credit,in,Counterparty_39,21239978.75,,
2025-06-04,155.48,payroll,out,Counterparty_92,21239823.27,2025-04-24,2025-05-25
2025-06-04,5041.54,T&E,out,Counterparty_22,21234781.73,2025-05-17,2025-06-20
2025-06-04,1598.44,investment_income,in,Counterparty_91,21236380.17,,
2025-06-04,1201.01,utilities,out,Counterparty_54,21235179.16,2025-05-18,2025-06-24
2025-06-04,7696.98,loan_repayment,out,Counterparty_46,21227482.18,2025-04-21,2025-05-25
2025-06-04,6823.84,customer_payment,in,Counterparty_46,21234306.02,,
2025-06-04,1681.49,asset_sale,in,Counterparty_14,21235987.51,,
2025-06-04,1851.11,refund,in,Counterparty_85,21237838.62,,
2025-06-04,968.94,supplier_payment,out,Counterparty_73,21236869.68,2025-05-03,2025-06-04
2025-06-04,108.55,asset_sale,in,Counterparty_68,21236978.23,,
2025-06-04,2257.57,asset_sale,in,Counterparty_4,21239235.8,,
2025-06-04,4809.52,credit,in,Counterparty_18,21244045.32,,
2025-06-04,789.19,marketing_spend,out,Counterparty_48,21243256.13,2025-04-26,2025-05-28
2025-06-04,4344.05,T&E,out,Counterparty_99,21238912.08,2025-05-11,2025-06-10
2025-06-04,4290.12,supplier_payment,out,Counterparty_26,21234621.96,2025-05-11,2025-06-06
2025-06-04,1621.99,utilities,out,Counterparty_71,21232999.97,2025-05-15,2025-06-13
2025-06-04,515.6,loan_repayment,out,Counterparty_55,21232484.37,2025-05-11,2025-06-06
2025-06-04,608.93,utilities,out,Counterparty_64,21231875.44,2025-05-15,2025-06-20
2025-06-04,4198.68,T&E,out,Counterparty_88,21227676.76,2025-05-15,2025-06-12
2025-06-04,99.92,supplier_payment,out,Counterparty_24,21227576.84,2025-04-28,2025-06-03
2025-06-04,8759.78,loan_repayment,out,Counterparty_3,21218817.06,2025-05-03,2025-06-05
2025-06-04,1932.64,credit,in,Counterparty_16,21220749.7,,
2025-06-04,451.76,marketing_spend,out,Counterparty_43,21220297.94,2025-04-25,2025-05-29
2025-06-04,854.57,marketing_spend,out,Counterparty_94,21219443.37,2025-04-30,2025-05-26
2025-06-04,1570.99,tax_payment,out,Counterparty_68,21217872.38,2025-05-08,2025-06-16
2025-06-04,439.76,supplier_payment,out,Counterparty_15,21217432.62,2025-05-19,2025-06-20
2025-06-04,4130.99,supplier_payment,out,Counterparty_33,21213301.63,2025-05-06,2025-06-09
2025-06-04,351.75,supplier_payment,out,Counterparty_85,21212949.88,2025-05-09,2025-06-07
2025-06-04,111.45,credit,in,Counterparty_69,21213061.33,,
2025-06-04,82.05,investment_income,in,Counterparty_79,21213143.38,,
2025-06-04,1159.72,marketing_spend,out,Counterparty_35,21211983.66,2025-05-03,2025-05-31
2025-06-04,304.06,refund,in,Counterparty_69,21212287.72,,
2025-06-04,633.55,utilities,out,Counterparty_81,21211654.17,2025-05-20,2025-06-18
2025-06-04,228.33,payroll,out,Counterparty_66,21211425.84,2025-04-26,2025-05-27
2025-06-04,1725.52,customer_payment,in,Counterparty_75,21213151.36,,
2025-06-04,1219.55,software_subscription,out,Counterparty_84,21211931.81,2025-05-11,2025-06-07
2025-06-04,3361.76,investment_income,in,Counterparty_15,21215293.57,,
2025-06-04,3688.59,customer_payment,in,Counterparty_68,21218982.16,,
2025-06-04,6039.48,asset_sale,in,Counterparty_82,21225021.64,,
2025-06-04,3457.1,asset_sale,in,Counterparty_10,21228478.74,,
2025-06-04,1849.12,refund,in,Counterparty_32,21230327.86,,
2025-06-04,1966.89,asset_sale,in,Counterparty_26,21232294.75,,
2025-06-05,1919.84,asset_sale,in,Counterparty_54,21234214.59,,
2025-06-05,1463.7,refund,in,Counterparty_69,21235678.29,,
2025-06-05,724.26,investment_income,in,Counterparty_38,21236402.55,,
2025-06-05,2977.92,payroll,out,Counterparty_48,21233424.63,2025-05-13,2025-06-07
2025-06-05,1953.25,asset_sale,in,Counterparty_11,21235377.88,,
2025-06-05,4502.35,tax_payment,out,Counterparty_70,21230875.53,2025-05-21,2025-06-26
2025-06-05,1052.87,credit,in,Counterparty_77,21231928.4,,
2025-06-05,1617.36,investment_income,in,Counterparty_38,21233545.76,,
2025-06-05,598.01,refund,in,Counterparty_51,21234143.77,,
2025-06-05,6635.81,tax_payment,out,Counterparty_88,21227507.96,2025-05-17,2025-06-13
2025-06-05,4747.68,rent,out,Counterparty_51,21222760.28,2025-05-04,2025-06-04
2025-06-05,403.69,credit,in,Counterparty_29,21223163.97,,
2025-06-05,1615.73,customer_payment,in,Counterparty_84,21224779.7,,
2025-06-05,921.5,credit,in,Counterparty_90,21225701.2,,
2025-06-05,5059.28,customer_payment,in,Counterparty_25,21230760.48,,
2025-06-05,147.35,customer_payment,in,Counterparty_15,21230907.83,,
2025-06-05,1610.7,software_subscription,out,Counterparty_16,21229297.13,2025-05-07,2025-06-15
2025-06-05,263.62,tax_payment,out,Counterparty_18,21229033.51,2025-04-23,2025-05-29
2025-06-05,1849.26,credit,in,Counterparty_40,21230882.77,,
2025-06-05,1442.76,customer_payment,in,Counterparty_72,21232325.53,,
2025-06-05,667.47,utilities,out,Counterparty_21,21231658.06,2025-05-19,2025-06-26
2025-06-05,253.72,marketing_spend,out,Counterparty_1,21231404.34,2025-04-30,2025-06-05
2025-06-05,1162.78,credit,in,Counterparty_85,21232567.12,,
2025-06-05,13284.44,marketing_spend,out,Counterparty_63,21219282.68,2025-04-26,2025-05-28
2025-06-05,3176.81,marketing_spend,out,Counterparty_98,21216105.87,2025-05-21,2025-06-24
2025-06-05,602.38,asset_sale,in,Counterparty_4,21216708.25,,
2025-06-05,5690.5,T&E,out,Counterparty_22,21211017.75,2025-04-22,2025-05-23
2025-06-05,3823.04,asset_sale,in,Counterparty_37,21214840.79,,
2025-06-05,8072.47,utilities,out,Counterparty_56,21206768.32,2025-04-30,2025-05-27
2025-06-05,4305.13,tax_payment,out,Counterparty_19,21202463.19,2025-04-24,2025-05-26
2025-06-05,779.01,asset_sale,in,Counterparty_41,21203242.2,,
2025-06-05,3098.98,software_subscription,out,Counterparty_29,21200143.22,2025-05-01,2025-06-08
2025-06-05,342.36,rent,out,Counterparty_5,21199800.86,2025-05-05,2025-05-31
2025-06-05,1043.88,loan_repayment,out,Counterparty_80,21198756.98,2025-05-07,2025-06-10
2025-06-05,1957.33,supplier_payment,out,Counterparty_60,21196799.65,2025-04-26,2025-06-04
2025-06-05,1404.88,tax_payment,out,Counterparty_66,21195394.77,2025-05-20,2025-06-26
2025-06-05,3848.7,credit,in,Counterparty_39,21199243.47,,
2025-06-05,2797.78,asset_sale,in,Counterparty_55,21202041.25,,
2025-06-05,2418.01,T&E,out,Counterparty_65,21199623.24,2025-05-11,2025-06-19
2025-06-05,4133.04,customer_payment,in,Counterparty_17,21203756.28,,
2025-06-05,905.43,investment_income,in,Counterparty_99,21204661.71,,
2025-06-05,1301.9,utilities,out,Counterparty_88,21203359.81,2025-04-28,2025-05-24
2025-06-05,1244.4,utilities,out,Counterparty_32,21202115.41,2025-04-30,2025-06-08
2025-06-05,1727.83,payroll,out,Counterparty_92,21200387.58,2025-05-07,2025-06-05
2025-06-05,4211.98,software_subscription,out,Counterparty_90,21196175.6,2025-05-02,2025-06-10
2025-06-05,2473.85,supplier_payment,out,Counterparty_47,21193701.75,2025-04-30,2025-06-08
2025-06-06,3890.19,marketing_spend,out,Counterparty_5,21189811.56,2025-04-29,2025-06-02
2025-06-06,4413.51,customer_payment,in,Counterparty_20,21194225.07,,
2025-06-06,8872.64,customer_payment,in,Counterparty_99,21203097.71,,
2025-06-06,240.53,credit,in,Counterparty_65,21203338.24,,
2025-06-06,14056.57,utilities,out,Counterparty_23,21189281.67,2025-05-04,2025-06-08
2025-06-06,3989.74,credit,in,Counterparty_3,21193271.41,,
2025-06-06,683.53,asset_sale,in,Counterparty_54,21193954.94,,
2025-06-06,852.08,payroll,out,Counterparty_20,21193102.86,2025-05-19,2025-06-25
2025-06-06,63.38,utilities,out,Counterparty_90,21193039.48,2025-04-26,2025-05-22
2025-06-06,2710.89,loan_repayment,out,Counterparty_3,21190328.59,2025-05-10,2025-06-06
2025-06-06,422.96,utilities,out,Counterparty_74,21189905.63,2025-05-06,2025-06-12
2025-06-06,3495.04,refund,in,Counterparty_57,21193400.67,,
2025-06-06,4374.1,investment_income,in,Counterparty_45,21197774.77,,
2025-06-06,2133.89,supplier_payment,out,Counterparty_79,21195640.88,2025-05-01,2025-06-01
2025-06-06,240.98,customer_payment,in,Counterparty_55,21195881.86,,
2025-06-06,3872.96,refund,in,Counterparty_14,21199754.82,,
2025-06-06,627.83,customer_payment,in,Counterparty_82,21200382.65,,
2025-06-06,1812.69,supplier_payment,out,Counterparty_56,21198569.96,2025-05-11,2025-06-11
2025-06-06,1050.1,rent,out,Counterparty_45,21197519.86,2025-05-21,2025-06-29
2025-06-06,1211.77,investment_income,in,Counterparty_46,21198731.63,,
2025-06-06,90.53,tax_payment,out,Counterparty_65,21198641.1,2025-04-30,2025-05-30
2025-06-06,4446.65,tax_payment,out,Counterparty_30,21194194.45,2025-05-08,2025-06-02
2025-06-06,8268.78,credit,in,Counterparty_20,21202463.23,,
2025-06-06,959.91,asset_sale,in,Counterparty_50,21203423.14,,
2025-06-06,10655.14,credit,in,Counterparty_67,21214078.28,,
2025-06-06,4776.82,rent,out,Counterparty_90,21209301.46,2025-05-19,2025-06-14
2025-06-06,1418.03,supplier_payment,out,Counterparty_83,21207883.43,2025-05-04,2025-06-10
2025-06-06,9226.62,rent,out,Counterparty_3,21198656.81,2025-04-27,2025-05-25
2025-06-06,3422.84,credit,in,Counterparty_92,21202079.65,,
2025-06-06,3412.08,refund,in,Counterparty_97,21205491.73,,
2025-06-06,648.29,tax_payment,out,Counterparty_88,21204843.44,2025-05-16,2025-06-17
2025-06-06,254.66,tax_payment,out,Counterparty_70,21204588.78,2025-04-24,2025-05-21
2025-06-06,378.36,asset_sale,in,Counterparty_69,21204967.14,,
2025-06-06,3437.09,customer_payment,in,Counterparty_76,21208404.23,,
2025-06-06,2798.89,supplier_payment,out,Counterparty_5,21205605.34,2025-05-21,2025-06-25
2025-06-06,1080.71,loan_repayment,out,Counterparty_73,21204524.63,2025-05-10,2025-06-11
2025-06-06,508.54,software_subscription,out,Counterparty_91,21204016.09,2025-04-30,2025-06-03
2025-06-06,4976.81,tax_payment,out,Counterparty_24,21199039.28,2025-05-21,2025-06-19
2025-06-06,4825.0,supplier_payment,out,Counterparty_22,21194214.28,2025-05-11,2025-06-05
2025-06-06,828.62,loan_repayment,out,Counterparty_11,21193385.66,2025-05-17,2025-06-11
2025-06-06,2598.68,customer_payment,in,Counterparty_29,21195984.34,,
2025-06-06,32.48,loan_repayment,out,Counterparty_28,21195951.86,2025-05-17,2025-06-23
2025-06-06,2280.99,rent,out,Counterparty_93,21193670.87,2025-04-27,2025-05-29
2025-06-06,4864.75,customer_payment,in,Counterparty_35,21198535.62,,
2025-06-06,4770.19,investment_income,in,Counterparty_57,21203305.81,,
2025-06-06,142.95,rent,out,Counterparty_77,21203162.86,2025-05-21,2025-06-15
2025-06-06,9144.46,tax_payment,out,Counterparty_89,21194018.4,2025-05-18,2025-06-18
2025-06-06,1519.09,refund,in,Counterparty_5,21195537.49,,
2025-06-06,622.94,payroll,out,Counterparty_46,21194914.55,2025-04-27,2025-05-28
2025-06-06,1709.24,investment_income,in,Counterparty_19,21196623.79,,
2025-06-06,1831.48,tax_payment,out,Counterparty_58,21194792.31,2025-05-15,2025-06-16
2025-06-06,611.74,software_subscription,out,Counterparty_32,21194180.57,2025-04-26,2025-06-01
2025-06-06,496.11,rent,out,Counterparty_95,21193684.46,2025-05-09,2025-06-07
2025-06-06,4071.04,loan_repayment,out,Counterparty_88,21189613.42,2025-05-16,2025-06-14
2025-06-06,3105.77,marketing_spend,out,Counterparty_65,21186507.65,2025-04-29,2025-06-06
2025-06-06,158.37,T&E,out,Counterparty_98,21186349.28,2025-05-21,2025-06-23
2025-06-06,1776.58,software_subscription,out,Counterparty_64,21184572.7,2025-05-02,2025-06-06
2025-06-06,4316.14,rent,out,Counterparty_88,21180256.56,2025-05-19,2025-06-26
2025-06-06,7353.15,refund,in,Counterparty_92,21187609.71,,
2025-06-06,3134.85,refund,in,Counterparty_70,21190744.56,,
2025-06-06,12179.32,supplier_payment,out,Counterparty_12,21178565.24,2025-05-16,2025-06-24
2025-06-07,2168.94,credit,in,Counterparty_81,21180734.18,,
2025-06-07,4818.93,asset_sale,in,Counterparty_79,21185553.11,,
2025-06-07,5140.64,refund,in,Counterparty_79,21190693.75,,
2025-06-07,706.6,asset_sale,in,Counterparty_61,21191400.35,,
2025-06-07,6285.42,credit,in,Counterparty_13,21197685.77,,
2025-06-07,1356.35,refund,in,Counterparty_39,21199042.12,,
2025-06-07,1739.1,payroll,out,Counterparty_72,21197303.02,2025-05-02,2025-05-31
2025-06-07,1051.93,refund,in,Counterparty_62,21198354.95,,
2025-06-07,983.69,credit,in,Counterparty_84,21199338.64,,
2025-06-07,2471.28,refund,in,Counterparty_41,21201809.92,,
2025-06-07,358.28,customer_payment,in,Counterparty_60,21202168.2,,
2025-06-07,260.2,marketing_spend,out,Counterparty_62,21201908.0,2025-04-24,2025-05-27
2025-06-07,2443.18,utilities,out,Counterparty_21,21199464.82,2025-05-05,2025-06-03
2025-06-07,3063.8,payroll,out,Counterparty_66,21196401.02,2025-05-19,2025-06-19
2025-06-07,682.41,utilities,out,Counterparty_87,21195718.61,2025-05-03,2025-05-28
2025-06-07,9543.87,refund,in,Counterparty_8,21205262.48,,
2025-06-07,9030.9,payroll,out,Counterparty_77,21196231.58,2025-05-21,2025-06-27
2025-06-07,2855.95,payroll,out,Counterparty_34,21193375.63,2025-04-30,2025-06-08
2025-06-07,1969.17,supplier_payment,out,Counterparty_73,21191406.46,2025-05-01,2025-06-05
2025-06-07,4779.45,T&E,out,Counterparty_62,21186627.01,2025-05-09,2025-06-09
2025-06-07,3805.8,payroll,out,Counterparty_97,21182821.21,2025-04-29,2025-06-05
2025-06-07,989.42,tax_payment,out,Counterparty_77,21181831.79,2025-05-01,2025-05-29
2025-06-07,1614.41,marketing_spend,out,Counterparty_61,21180217.38,2025-05-15,2025-06-22
2025-06-07,5489.07,payroll,out,Counterparty_37,21174728.31,2025-05-17,2025-06-23
2025-06-07,902.84,rent,out,Counterparty_54,21173825.47,2025-04-24,2025-05-28
2025-06-07,3763.78,payroll,out,Counterparty_14,21170061.69,2025-05-11,2025-06-18
2025-06-07,2096.52,credit,in,Counterparty_90,21172158.21,,
2025-06-07,46.24,loan_repayment,out,Counterparty_17,21172111.97,2025-05-22,2025-06-28
2025-06-07,12192.28,marketing_spend,out,Counterparty_69,21159919.69,2025-05-10,2025-06-09
2025-06-07,1455.12,rent,out,Counterparty_29,21158464.57,2025-05-04,2025-06-01
2025-06-07,75.18,investment_income,in,Counterparty_74,21158539.75,,
2025-06-07,16762.46,marketing_spend,out,Counterparty_22,21141777.29,2025-04-26,2025-05-23
2025-06-07,5196.83,T&E,out,Counterparty_98,21136580.46,2025-05-10,2025-06-16
2025-06-07,1683.98,rent,out,Counterparty_73,21134896.48,2025-05-21,2025-06-16
2025-06-07,93.09,credit,in,Counterparty_32,21134989.57,,
2025-06-07,2072.85,tax_payment,out,Counterparty_53,21132916.72,2025-05-13,2025-06-07
2025-06-07,2936.86,marketing_spend,out,Counterparty_33,21129979.86,2025-05-09,2025-06-12
2025-06-07,1565.22,loan_repayment,out,Counterparty_42,21128414.64,2025-05-14,2025-06-18
2025-06-07,2534.82,asset_sale,in,Counterparty_46,21130949.46,,
2025-06-07,6876.81,credit,in,Counterparty_40,21137826.27,,
2025-06-07,2386.48,customer_payment,in,Counterparty_3,21140212.75,,
2025-06-07,2424.9,investment_income,in,Counterparty_55,21142637.65,,
2025-06-07,1670.12,T&E,out,Counterparty_36,21140967.53,2025-04-28,2025-05-27
2025-06-07,1799.37,marketing_spend,out,Counterparty_77,21139168.16,2025-04-26,2025-05-22
2025-06-07,463.7,asset_sale,in,Counterparty_81,21139631.86,,
2025-06-07,374.39,supplier_payment,out,Counterparty_44,21139257.47,2025-05-20,2025-06-28
2025-06-07,1873.56,software_subscription,out,Counterparty_84,21137383.91,2025-05-20,2025-06-18
2025-06-07,2993.77,loan_repayment,out,Counterparty_67,21134390.14,2025-05-06,2025-06-03
2025-06-08,198.79,investment_income,in,Counterparty_43,21134588.93,,
2025-06-08,127.12,payroll,out,Counterparty_72,21134461.81,2025-05-11,2025-06-11
2025-06-08,16468.89,credit,in,Counterparty_83,21150930.7,,
2025-06-08,579.91,rent,out,Counterparty_70,21150350.79,2025-04-25,2025-05-20
2025-06-08,5027.71,marketing_spend,out,Counterparty_17,21145323.08,2025-05-17,2025-06-16
2025-06-08,853.66,investment_income,in,Counterparty_33,21146176.74,,
2025-06-08,4375.62,refund,in,Counterparty_57,21150552.36,,
2025-06-08,1604.4,loan_repayment,out,Counterparty_51,21148947.96,2025-05-07,2025-06-10
2025-06-08,631.12,payroll,out,Counterparty_47,21148316.84,2025-05-16,2025-06-11
2025-06-08,966.52,customer_payment,in,Counterparty_47,21149283.36,,
2025-06-08,4752.1,customer_payment,in,Counterparty_14,21154035.46,,
2025-06-08,308.31,supplier_payment,out,Counterparty_42,21153727.15,2025-05-01,2025-06-03
2025-06-08,1330.79,payroll,out,Counterparty_46,21152396.36,2025-05-01,2025-06-05
2025-06-08,6997.86,supplier_payment,out,Counterparty_52,21145398.5,2025-05-22,2025-06-19
2025-06-08,78.12,rent,out,Counterparty_69,21145320.38,2025-05-03,2025-06-09
2025-06-08,4070.97,rent,out,Counterparty_60,21141249.41,2025-05-24,2025-06-29
2025-06-08,1096.98,credit,in,Counterparty_47,21142346.39,,
2025-06-08,371.61,credit,in,Counterparty_14,21142718.0,,
2025-06-08,259.06,tax_payment,out,Counterparty_33,21142458.94,2025-04-26,2025-06-03
2025-06-08,238.35,software_subscription,out,Counterparty_1,21142220.59,2025-05-20,2025-06-16
2025-06-08,34.68,loan_repayment,out,Counterparty_52,21142185.91,2025-05-09,2025-06-10
2025-06-08,880.09,loan_repayment,out,Counterparty_21,21141305.82,2025-05-01,2025-06-08
2025-06-08,5962.04,T&E,out,Counterparty_54,21135343.78,2025-05-09,2025-06-04
2025-06-08,1730.74,rent,out,Counterparty_31,21133613.04,2025-05-04,2025-06-10
2025-06-08,319.67,T&E,out,Counterparty_66,21133293.37,2025-05-10,2025-06-14
2025-06-08,475.71,marketing_spend,out,Counterparty_28,21132817.66,2025-05-21,2025-06-23
2025-06-08,1117.37,tax_payment,out,Counterparty_97,21131700.29,2025-05-24,2025-07-02
2025-06-08,1439.57,marketing_spend,out,Counterparty_77,21130260.72,2025-05-11,2025-06-12
2025-06-08,5712.79,tax_payment,out,Counterparty_64,21124547.93,2025-04-29,2025-05-31
2025-06-08,13025.43,credit,in,Counterparty_35,21137573.36,,
2025-06-08,6955.36,supplier_payment,out,Counterparty_39,21130618.0,2025-05-06,2025-06-09
2025-06-08,3167.28,software_subscription,out,Counterparty_98,21127450.72,2025-05-04,2025-06-12
2025-06-08,1925.15,rent,out,Counterparty_23,21125525.57,2025-05-02,2025-05-29
2025-06-08,8078.48,marketing_spend,out,Counterparty_10,21117447.09,2025-05-07,2025-06-04
2025-06-08,425.84,investment_income,in,Counterparty_3,21117872.93,,
2025-06-08,5118.29,supplier_payment,out,Counterparty_56,21112754.64,2025-05-10,2025-06-17
2025-06-08,5221.1,utilities,out,Counterparty_95,21107533.54,2025-05-22,2025-06-25
2025-06-08,3283.71,supplier_payment,out,Counterparty_78,21104249.83,2025-05-12,2025-06-06
2025-06-08,6073.31,software_subscription,out,Counterparty_60,21098176.52,2025-05-08,2025-06-03
2025-06-08,54.83,investment_income,in,Counterparty_61,21098231.35,,
2025-06-08,1696.61,payroll,out,Counterparty_13,21096534.74,2025-05-07,2025-06-11
2025-06-08,1276.39,utilities,out,Counterparty_33,21095258.35,2025-05-08,2025-06-10
2025-06-08,3671.28,software_subscription,out,Counterparty_59,21091587.07,2025-05-15,2025-06-12
2025-06-08,911.36,supplier_payment,out,Counterparty_13,21090675.71,2025-05-10,2025-06-07
2025-06-08,4035.46,T&E,out,Counterparty_68,21086640.25,2025-04-29,2025-06-05
2025-06-08,980.56,loan_repayment,out,Counterparty_2,21085659.69,2025-05-12,2025-06-16
2025-06-08,787.51,loan_repayment,out,Counterparty_20,21084872.18,2025-05-18,2025-06-15
2025-06-08,10291.0,supplier_payment,out,Counterparty_77,21074581.18,2025-05-11,2025-06-14
2025-06-08,765.37,asset_sale,in,Counterparty_44,21075346.55,,
2025-06-08,831.34,investment_income,in,Counterparty_60,21076177.89,,
2025-06-08,4151.38,refund,in,Counterparty_12,21080329.27,,
2025-06-08,2715.79,credit,in,Counterparty_29,21083045.06,,
2025-06-08,4386.47,asset_sale,in,Counterparty_84,21087431.53,,
2025-06-08,1978.36,investment_income,in,Counterparty_26,21089409.89,,
2025-06-08,4267.1,refund,in,Counterparty_70,21093676.99,,
2025-06-08,294.67,customer_payment,in,Counterparty_27,21093971.66,,
2025-06-08,3684.9,asset_sale,in,Counterparty_37,21097656.56,,
2025-06-08,1810.01,investment_income,in,Counterparty_94,21099466.57,,
2025-06-08,1348.05,asset_sale,in,Counterparty_76,21100814.62,,
2025-06-08,373.64,investment_income,in,Counterparty_3,21101188.26,,
2025-06-08,12640.45,investment_income,in,Counterparty_15,21113828.71,,
2025-06-09,3082.33,customer_payment,in,Counterparty_13,21116911.04,,
2025-06-09,18.4,credit,in,Counterparty_90,21116929.44,,
2025-06-09,4152.18,customer_payment,in,Counterparty_62,21121081.62,,
2025-06-09,1215.1,rent,out,Counterparty_72,21119866.52,2025-05-20,2025-06-14
2025-06-09,296.35,asset_sale,in,Counterparty_71,21120162.87,,
2025-06-09,4633.79,utilities,out,Counterparty_45,21115529.08,2025-05-14,2025-06-15
2025-06-09,33.72,rent,out,Counterparty_34,21115495.36,2025-05-07,2025-06-14
2025-06-09,124.97,tax_payment,out,Counterparty_47,21115370.39,2025-05-09,2025-06-05
2025-06-09,541.57,customer_payment,in,Counterparty_46,21115911.96,,
2025-06-09,293.41,customer_payment,in,Counterparty_47,21116205.37,,
2025-06-09,539.37,T&E,out,Counterparty_38,21115666.0,2025-05-16,2025-06-24
2025-06-09,260.62,customer_payment,in,Counterparty_24,21115926.62,,
2025-06-09,896.98,loan_repayment,out,Counterparty_43,21115029.64,2025-05-03,2025-06-09
2025-06-09,2050.33,credit,in,Counterparty_28,21117079.97,,
2025-06-09,3812.32,marketing_spend,out,Counterparty_58,21113267.65,2025-05-02,2025-06-09
2025-06-09,3731.07,asset_sale,in,Counterparty_48,21116998.72,,
2025-06-09,859.29,software_subscription,out,Counterparty_85,21116139.43,2025-05-07,2025-06-07
2025-06-09,1690.44,tax_payment,out,Counterparty_9,21114448.99,2025-05-05,2025-06-04
2025-06-09,2104.85,customer_payment,in,Counterparty_13,21116553.84,,
2025-06-09,519.86,investment_income,in,Counterparty_99,21117073.7,,
2025-06-09,1397.4,tax_payment,out,Counterparty_60,21115676.3,2025-05-10,2025-06-18
2025-06-09,2976.51,T&E,out,Counterparty_73,21112699.79,2025-05-07,2025-06-05
2025-06-09,2902.38,loan_repayment,out,Counterparty_3,21109797.41,2025-05-23,2025-06-18
2025-06-09,9306.55,investment_income,in,Counterparty_39,21119103.96,,
2025-06-09,878.75,utilities,out,Counterparty_5,21118225.21,2025-05-10,2025-06-14
2025-06-09,0.26,marketing_spend,out,Counterparty_36,21118224.95,2025-05-04,2025-06-02
2025-06-09,891.76,refund,in,Counterparty_13,21119116.71,,
2025-06-09,4245.09,T&E,out,Counterparty_18,21114871.62,2025-04-26,2025-05-25
2025-06-09,4159.39,credit,in,Counterparty_54,21119031.01,,
2025-06-09,6901.39,asset_sale,in,Counterparty_99,21125932.4,,
2025-06-09,2104.68,refund,in,Counterparty_2,21128037.08,,
2025-06-09,182.03,marketing_spend,out,Counterparty_66,21127855.05,2025-04-30,2025-06-05
2025-06-09,2316.11,refund,in,Counterparty_74,21130171.16,,
2025-06-09,15029.65,tax_payment,out,Counterparty_66,21115141.51,2025-05-08,2025-06-04
2025-06-09,1651.73,payroll,out,Counterparty_95,21113489.78,2025-04-29,2025-06-06
2025-06-09,1408.77,loan_repayment,out,Counterparty_32,21112081.01,2025-05-14,2025-06-15
2025-06-09,1244.37,asset_sale,in,Counterparty_61,21113325.38,,
2025-06-09,477.27,customer_payment,in,Counterparty_8,21113802.65,,
2025-06-09,2646.16,software_subscription,out,Counterparty_69,21111156.49,2025-05-22,2025-06-23
2025-06-09,4401.12,credit,in,Counterparty_56,21115557.61,,
2025-06-09,3121.09,credit,in,Counterparty_7,21118678.7,,
2025-06-09,973.37,asset_sale,in,Counterparty_41,21119652.07,,
2025-06-09,2082.78,tax_payment,out,Counterparty_68,21117569.29,2025-04-26,2025-05-27
2025-06-09,1042.53,customer_payment,in,Counterparty_67,21118611.82,,
2025-06-09,8483.31,marketing_spend,out,Counterparty_57,21110128.51,2025-05-21,2025-06-26
2025-06-09,449.77,credit,in,Counterparty_53,21110578.28,,
2025-06-09,1904.71,software_subscription,out,Counterparty_91,21108673.57,2025-05-14,2025-06-09
2025-06-09,84.94,investment_income,in,Counterparty_6,21108758.51,,
2025-06-09,5181.8,customer_payment,in,Counterparty_63,21113940.31,,
2025-06-09,1344.8,tax_payment,out,Counterparty_88,21112595.51,2025-04-29,2025-05-24
2025-06-09,3257.25,supplier_payment,out,Counterparty_24,21109338.26,2025-05-07,2025-06-12
2025-06-09,726.98,utilities,out,Counterparty_76,21108611.28,2025-05-06,2025-06-10
2025-06-09,856.57,rent,out,Counterparty_68,21107754.71,2025-05-16,2025-06-19
2025-06-09,606.07,supplier_payment,out,Counterparty_7,21107148.64,2025-05-15,2025-06-17
2025-06-09,3754.44,software_subscription,out,Counterparty_91,21103394.2,2025-05-14,2025-06-10
2025-06-09,411.47,rent,out,Counterparty_84,21102982.73,2025-05-02,2025-06-05
2025-06-09,5176.25,loan_repayment,out,Counterparty_87,21097806.48,2025-05-08,2025-06-09
2025-06-09,1501.43,utilities,out,Counterparty_30,21096305.05,2025-05-12,2025-06-11
2025-06-09,1497.89,marketing_spend,out,Counterparty_72,21094807.16,2025-05-12,2025-06-11
2025-06-09,13902.05,asset_sale,in,Counterparty_54,21108709.21,,
2025-06-09,3732.9,tax_payment,out,Counterparty_63,21104976.31,2025-05-14,2025-06-15
2025-06-10,464.75,credit,in,Counterparty_6,21105441.06,,
2025-06-10,1712.54,tax_payment,out,Counterparty_54,21103728.52,2025-05-02,2025-05-31
2025-06-10,7177.46,supplier_payment,out,Counterparty_53,21096551.06,2025-05-01,2025-05-30
2025-06-10,4100.68,investment_income,in,Counterparty_31,21100651.74,,
2025-06-10,1469.62,loan_repayment,out,Counterparty_30,21099182.12,2025-05-18,2025-06-26
2025-06-10,1023.29,loan_repayment,out,Counterparty_33,21098158.83,2025-04-29,2025-05-31
2025-06-10,936.25,investment_income,in,Counterparty_33,21099095.08,,
2025-06-10,1167.45,rent,out,Counterparty_91,21097927.63,2025-05-22,2025-06-30
2025-06-10,1763.03,investment_income,in,Counterparty_96,21099690.66,,
2025-06-10,5474.49,utilities,out,Counterparty_60,21094216.17,2025-05-20,2025-06-16
2025-06-10,58.86,asset_sale,in,Counterparty_53,21094275.03,,
2025-06-10,1715.54,credit,in,Counterparty_12,21095990.57,,
2025-06-10,10661.28,supplier_payment,out,Counterparty_13,21085329.29,2025-05-05,2025-06-05
2025-06-10,2938.0,credit,in,Counterparty_24,21088267.29,,
2025-06-10,4120.11,marketing_spend,out,Counterparty_17,21084147.18,2025-05-22,2025-06-25
2025-06-10,2378.15,supplier_payment,out,Counterparty_99,21081769.03,2025-05-13,2025-06-20
2025-06-10,1824.69,asset_sale,in,Counterparty_83,21083593.72,,
2025-06-10,153.83,T&E,out,Counterparty_1,21083439.89,2025-05-08,2025-06-09
2025-06-10,7423.12,refund,in,Counterparty_82,21090863.01,,
2025-06-10,3625.58,software_subscription,out,Counterparty_56,21087237.43,2025-05-22,2025-06-22
2025-06-10,3362.67,investment_income,in,Counterparty_13,21090600.1,,
2025-06-10,9638.92,payroll,out,Counterparty_64,21080961.18,2025-04-28,2025-06-03
2025-06-10,357.54,marketing_spend,out,Counterparty_27,21080603.64,2025-05-26,2025-06-24
2025-06-10,12037.78,rent,out,Counterparty_19,21068565.86,2025-05-12,2025-06-08
2025-06-10,1128.94,T&E,out,Counterparty_62,21067436.92,2025-04-30,2025-06-06
2025-06-10,9691.68,utilities,out,Counterparty_84,21057745.24,2025-05-21,2025-06-28
2025-06-10,3909.65,customer_payment,in,Counterparty_25,21061654.89,,
2025-06-10,1925.82,investment_income,in,Counterparty_14,21063580.71,,
2025-06-10,1017.82,marketing_spend,out,Counterparty_86,21062562.89,2025-04-30,2025-05-31
2025-06-10,1192.42,customer_payment,in,Counterparty_66,21063755.31,,
2025-06-10,2099.23,utilities,out,Counterparty_48,21061656.08,2025-05-07,2025-06-13
2025-06-10,6693.15,marketing_spend,out,Counterparty_14,21054962.93,2025-05-02,2025-06-03
2025-06-10,2388.08,credit,in,Counterparty_77,21057351.01,,
2025-06-10,2452.33,refund,in,Counterparty_78,21059803.34,,
2025-06-10,797.1,credit,in,Counterparty_68,21060600.44,,
2025-06-10,6248.88,customer_payment,in,Counterparty_10,21066849.32,,
2025-06-10,6332.7,T&E,out,Counterparty_31,21060516.62,2025-05-04,2025-05-31
2025-06-10,2331.74,loan_repayment,out,Counterparty_21,21058184.88,2025-05-22,2025-06-22
2025-06-10,4066.27,customer_payment,in,Counterparty_36,21062251.15,,
2025-06-10,4066.75,investment_income,in,Counterparty_64,21066317.9,,
2025-06-10,709.31,supplier_payment,out,Counterparty_47,21065608.59,2025-05-19,2025-06-24
2025-06-10,13504.27,asset_sale,in,Counterparty_63,21079112.86,,
2025-06-10,105.07,marketing_spend,out,Counterparty_94,21079007.79,2025-05-01,2025-06-03
2025-06-10,1289.26,customer_payment,in,Counterparty_43,21080297.05,,
2025-06-10,8265.09,investment_income,in,Counterparty_37,21088562.14,,
2025-06-10,441.36,refund,in,Counterparty_44,21089003.5,,
2025-06-10,816.68,tax_payment,out,Counterparty_97,21088186.82,2025-05-11,2025-06-05
2025-06-10,587.51,loan_repayment,out,Counterparty_40,21087599.31,2025-05-13,2025-06-19
2025-06-10,500.58,utilities,out,Counterparty_76,21087098.73,2025-05-26,2025-06-27
2025-06-10,5740.98,asset_sale,in,Counterparty_29,21092839.71,,
2025-06-10,7696.78,credit,in,Counterparty_26,21100536.49,,
2025-06-10,304.14,customer_payment,in,Counterparty_92,21100840.63,,
2025-06-10,7024.94,supplier_payment,out,Counterparty_91,21093815.69,2025-05-19,2025-06-19
2025-06-10,1911.88,asset_sale,in,Counterparty_36,21095727.57,,
2025-06-10,2760.96,asset_sale,in,Counterparty_85,21098488.53,,
2025-06-10,4769.69,customer_payment,in,Counterparty_95,21103258.22,,
2025-06-11,16422.88,T&E,out,Counterparty_62,21086835.34,2025-05-12,2025-06-11
2025-06-11,2395.15,credit,in,Counterparty_7,21089230.49,,
2025-06-11,3039.27,tax_payment,out,Counterparty_91,21086191.22,2025-05-26,2025-07-04
2025-06-11,1048.79,loan_repayment,out,Counterparty_73,21085142.43,2025-05-26,2025-07-03
2025-06-11,2892.25,T&E,out,Counterparty_3,21082250.18,2025-05-03,2025-06-08
2025-06-11,147.19,software_subscription,out,Counterparty_82,21082102.99,2025-05-05,2025-06-03
2025-06-11,1829.18,refund,in,Counterparty_52,21083932.17,,
2025-06-11,1643.64,marketing_spend,out,Counterparty_8,21082288.53,2025-05-17,2025-06-25
2025-06-11,7382.95,customer_payment,in,Counterparty_37,21089671.48,,
2025-06-11,495.16,credit,in,Counterparty_62,21090166.64,,
2025-06-11,1964.1,asset_sale,in,Counterparty_94,21092130.74,,
2025-06-11,659.72,investment_income,in,Counterparty_53,21092790.46,,
2025-06-11,1056.71,asset_sale,in,Counterparty_16,21093847.17,,
2025-06-11,103.8,asset_sale,in,Counterparty_4,21093950.97,,
2025-06-11,1827.85,investment_income,in,Counterparty_93,21095778.82,,
2025-06-11,467.94,investment_income,in,Counterparty_46,21096246.76,,
2025-06-11,636.87,credit,in,Counterparty_9,21096883.63,,
2025-06-11,4846.15,software_subscription,out,Counterparty_51,21092037.48,2025-05-16,2025-06-12
2025-06-11,3275.73,asset_sale,in,Counterparty_32,21095313.21,,
2025-06-11,3979.23,investment_income,in,Counterparty_79,21099292.44,,
2025-06-11,2698.42,T&E,out,Counterparty_34,21096594.02,2025-05-27,2025-06-26
2025-06-11,2484.85,T&E,out,Counterparty_95,21094109.17,2025-05-07,2025-06-15
2025-06-11,7841.91,software_subscription,out,Counterparty_25,21086267.26,2025-05-11,2025-06-17
2025-06-11,1787.46,marketing_spend,out,Counterparty_90,21084479.8,2025-05-08,2025-06-07
2025-06-11,252.68,refund,in,Counterparty_78,21084732.48,,
2025-06-11,4233.22,customer_payment,in,Counterparty_14,21088965.7,,
2025-06-11,586.31,T&E,out,Counterparty_91,21088379.39,2025-05-22,2025-06-26
2025-06-11,2201.16,refund,in,Counterparty_45,21090580.55,,
2025-06-11,735.7,marketing_spend,out,Counterparty_12,21089844.85,2025-05-02,2025-06-03
2025-06-11,392.57,customer_payment,in,Counterparty_52,21090237.42,,
2025-06-11,7110.09,investment_income,in,Counterparty_70,21097347.51,,
2025-06-11,577.43,credit,in,Counterparty_47,21097924.94,,
2025-06-11,3294.09,asset_sale,in,Counterparty_18,21101219.03,,
2025-06-11,277.17,investment_income,in,Counterparty_6,21101496.2,,
2025-06-11,777.8,credit,in,Counterparty_60,21102274.0,,
2025-06-11,2660.52,utilities,out,Counterparty_39,21099613.48,2025-04-30,2025-06-03
2025-06-11,7958.97,T&E,out,Counterparty_46,21091654.51,2025-05-02,2025-06-01
2025-06-11,3841.03,customer_payment,in,Counterparty_61,21095495.54,,
2025-06-11,60.76,refund,in,Counterparty_5,21095556.3,,
2025-06-11,2442.51,rent,out,Counterparty_74,21093113.79,2025-05-06,2025-06-04
2025-06-11,744.77,payroll,out,Counterparty_31,21092369.02,2025-05-22,2025-06-17
2025-06-11,509.54,customer_payment,in,Counterparty_61,21092878.56,,
2025-06-11,2132.86,refund,in,Counterparty_19,21095011.42,,
2025-06-11,2029.08,asset_sale,in,Counterparty_59,21097040.5,,
2025-06-11,2623.93,credit,in,Counterparty_36,21099664.43,,
2025-06-11,1607.3,software_subscription,out,Counterparty_23,21098057.13,2025-05-14,2025-06-13
2025-06-11,5857.83,payroll,out,Counterparty_65,21092199.3,2025-05-08,2025-06-13
2025-06-11,34.88,utilities,out,Counterparty_8,21092164.42,2025-05-19,2025-06-27
2025-06-11,3504.63,investment_income,in,Counterparty_90,21095669.05,,
2025-06-11,3699.56,customer_payment,in,Counterparty_7,21099368.61,,
2025-06-11,1116.44,software_subscription,out,Counterparty_73,21098252.17,2025-05-05,2025-06-10
2025-06-11,30.36,payroll,out,Counterparty_50,21098221.81,2025-05-14,2025-06-16
2025-06-11,109.7,T&E,out,Counterparty_53,21098112.11,2025-05-27,2025-06-26
2025-06-11,610.52,tax_payment,out,Counterparty_60,21097501.59,2025-05-01,2025-06-08
2025-06-11,1378.3,refund,in,Counterparty_30,21098879.89,,
2025-06-11,125.09,T&E,out,Counterparty_53,21098754.8,2025-04-30,2025-06-08
2025-06-11,6449.28,credit,in,Counterparty_38,21105204.08,,
2025-06-11,2491.97,customer_payment,in,Counterparty_99,21107696.05,,
2025-06-11,4617.82,refund,in,Counterparty_86,21112313.87,,
2025-06-11,438.36,payroll,out,Counterparty_22,21111875.51,2025-05-20,2025-06-14
2025-06-11,5247.89,investment_income,in,Counterparty_37,21117123.4,,
2025-06-11,1881.07,customer_payment,in,Counterparty_76,21119004.47,,
2025-06-11,7860.83,credit,in,Counterparty_55,21126865.3,,
2025-06-11,2653.69,software_subscription,out,Counterparty_41,21124211.61,2025-05-16,2025-06-17
2025-06-12,12567.63,tax_payment,out,Counterparty_35,21111643.98,2025-05-18,2025-06-24
2025-06-12,822.57,customer_payment,in,Counterparty_54,21112466.55,,
2025-06-12,2607.06,T&E,out,Counterparty_28,21109859.49,2025-05-10,2025-06-14
2025-06-12,3619.63,refund,in,Counterparty_46,21113479.12,,
2025-06-12,3689.38,refund,in,Counterparty_73,21117168.5,,
2025-06-12,3490.74,refund,in,Counterparty_25,21120659.24,,
2025-06-12,1437.19,payroll,out,Counterparty_25,21119222.05,2025-04-30,2025-05-27
2025-06-12,1408.37,payroll,out,Counterparty_86,21117813.68,2025-05-14,2025-06-19
2025-06-12,4114.88,utilities,out,Counterparty_47,21113698.8,2025-05-20,2025-06-14
2025-06-12,7056.88,marketing_spend,out,Counterparty_40,21106641.92,2025-05-23,2025-06-30
2025-06-12,1564.72,rent,out,Counterparty_65,21105077.2,2025-05-01,2025-06-07
2025-06-12,329.6,rent,out,Counterparty_23,21104747.6,2025-05-21,2025-06-28
2025-06-12,3434.43,customer_payment,in,Counterparty_76,21108182.03,,
2025-06-12,116.5,utilities,out,Counterparty_71,21108065.53,2025-05-16,2025-06-15
2025-06-12,2909.12,refund,in,Counterparty_76,21110974.65,,
2025-06-12,4326.07,rent,out,Counterparty_97,21106648.58,2025-04-29,2025-05-29
2025-06-12,208.26,tax_payment,out,Counterparty_22,21106440.32,2025-05-07,2025-06-09
2025-06-12,3755.57,asset_sale,in,Counterparty_60,21110195.89,,
2025-06-12,1918.12,credit,in,Counterparty_63,21112114.01,,
2025-06-12,1940.92,credit,in,Counterparty_67,21114054.93,,
2025-06-12,2413.78,customer_payment,in,Counterparty_52,21116468.71,,
2025-06-12,983.11,software_subscription,out,Counterparty_51,21115485.6,2025-05-10,2025-06-11
2025-06-12,1329.11,payroll,out,Counterparty_47,21114156.49,2025-05-13,2025-06-15
2025-06-12,753.83,rent,out,Counterparty_64,21113402.66,2025-05-07,2025-06-09
2025-06-12,1813.9,investment_income,in,Counterparty_8,21115216.56,,
2025-06-12,1474.12,loan_repayment,out,Counterparty_3,21113742.44,2025-05-09,2025-06-09
2025-06-12,2374.94,credit,in,Counterparty_16,21116117.38,,
2025-06-12,275.14,credit,in,Counterparty_25,21116392.52,,
2025-06-12,325.01,marketing_spend,out,Counterparty_85,21116067.51,2025-05-17,2025-06-17
2025-06-12,568.43,payroll,out,Counterparty_42,21115499.08,2025-05-18,2025-06-17
2025-06-12,625.78,marketing_spend,out,Counterparty_8,21114873.3,2025-05-06,2025-06-07
2025-06-12,2.42,marketing_spend,out,Counterparty_52,21114870.88,2025-05-16,2025-06-12
2025-06-12,4032.86,credit,in,Counterparty_68,21118903.74,,
2025-06-12,2349.38,software_subscription,out,Counterparty_47,21116554.36,2025-05-21,2025-06-21
2025-06-12,2210.32,payroll,out,Counterparty_83,21114344.04,2025-05-04,2025-05-31
2025-06-12,747.07,credit,in,Counterparty_57,21115091.11,,
2025-06-12,2878.08,T&E,out,Counterparty_3,21112213.03,2025-05-17,2025-06-21
2025-06-12,1636.04,marketing_spend,out,Counterparty_66,21110576.99,2025-05-14,2025-06-18
2025-06-12,2341.33,tax_payment,out,Counterparty_41,21108235.66,2025-05-14,2025-06-10
2025-06-12,1909.04,software_subscription,out,Counterparty_47,21106326.62,2025-05-17,2025-06-25
2025-06-12,347.86,rent,out,Counterparty_67,21105978.76,2025-05-18,2025-06-21
2025-06-12,52.44,software_subscription,out,Counterparty_29,21105926.32,2025-05-17,2025-06-12
2025-06-12,11498.62,payroll,out,Counterparty_24,21094427.7,2025-05-01,2025-05-31
2025-06-12,2228.63,software_subscription,out,Counterparty_79,21092199.07,2025-05-03,2025-06-08
2025-06-12,4368.52,investment_income,in,Counterparty_92,21096567.59,,
2025-06-12,696.28,investment_income,in,Counterparty_50,21097263.87,,
2025-06-12,632.28,loan_repayment,out,Counterparty_28,21096631.59,2025-05-04,2025-06-11
2025-06-12,1999.98,T&E,out,Counterparty_55,21094631.61,2025-05-05,2025-06-05
2025-06-12,9122.73,investment_income,in,Counterparty_30,21103754.34,,
2025-06-12,5125.92,refund,in,Counterparty_35,21108880.26,,
2025-06-12,4231.74,refund,in,Counterparty_81,21113112.0,,
2025-06-12,3741.84,investment_income,in,Counterparty_2,21116853.84,,
2025-06-12,1136.81,credit,in,Counterparty_38,21117990.65,,
2025-06-12,1640.32,customer_payment,in,Counterparty_31,21119630.97,,
2025-06-12,316.74,asset_sale,in,Counterparty_42,21119947.71,,
2025-06-12,7013.64,asset_sale,in,Counterparty_77,21126961.35,,
2025-06-12,5779.02,customer_payment,in,Counterparty_21,21132740.37,,
2025-06-12,1745.49,customer_payment,in,Counterparty_91,21134485.86,,
2025-06-12,5066.72,asset_sale,in,Counterparty_24,21139552.58,,
2025-06-12,490.93,customer_payment,in,Counterparty_45,21140043.51,,
2025-06-13,1450.72,tax_payment,out,Counterparty_57,21138592.79,2025-05-07,2025-06-01
2025-06-13,159.24,credit,in,Counterparty_45,21138752.03,,
2025-06-13,2019.92,supplier_payment,out,Counterparty_47,21136732.11,2025-05-18,2025-06-22
2025-06-13,1043.73,marketing_spend,out,Counterparty_83,21135688.38,2025-05-01,2025-06-07
2025-06-13,5975.01,investment_income,in,Counterparty_83,21141663.39,,
2025-06-13,1840.32,customer_payment,in,Counterparty_48,21143503.71,,
2025-06-13,7986.5,rent,out,Counterparty_82,21135517.21,2025-05-07,2025-06-02
2025-06-13,927.82,software_subscription,out,Counterparty_97,21134589.39,2025-05-11,2025-06-08
2025-06-13,5236.98,asset_sale,in,Counterparty_42,21139826.37,,
2025-06-13,5791.3,tax_payment,out,Counterparty_6,21134035.07,2025-05-05,2025-06-11
2025-06-13,2661.21,investment_income,in,Counterparty_72,21136696.28,,
2025-06-13,1681.72,payroll,out,Counterparty_24,21135014.56,2025-05-26,2025-06-25
2025-06-13,2743.28,customer_payment,in,Counterparty_70,21137757.84,,
2025-06-13,818.91,loan_repayment,out,Counterparty_31,21136938.93,2025-05-29,2025-06-24
2025-06-13,1384.72,asset_sale,in,Counterparty_35,21138323.65,,
2025-06-13,69.72,customer_payment,in,Counterparty_9,21138393.37,,
2025-06-13,4333.4,investment_income,in,Counterparty_57,21142726.77,,
2025-06-13,659.3,supplier_payment,out,Counterparty_54,21142067.47,2025-05-12,2025-06-10
2025-06-13,1473.57,utilities,out,Counterparty_89,21140593.9,2025-05-03,2025-06-04
2025-06-13,2358.2,tax_payment,out,Counterparty_78,21138235.7,2025-05-24,2025-06-22
2025-06-13,3080.49,credit,in,Counterparty_5,21141316.19,,
2025-06-13,3354.41,credit,in,Counterparty_5,21144670.6,,
2025-06-13,2322.71,software_subscription,out,Counterparty_6,21142347.89,2025-05-18,2025-06-17
2025-06-13,1093.29,supplier_payment,out,Counterparty_96,21141254.6,2025-05-29,2025-06-30
2025-06-13,6975.79,utilities,out,Counterparty_82,21134278.81,2025-05-13,2025-06-12
2025-06-13,9268.05,marketing_spend,out,Counterparty_3,21125010.76,2025-05-18,2025-06-26
2025-06-13,5940.38,supplier_payment,out,Counterparty_5,21119070.38,2025-05-11,2025-06-12
2025-06-13,7458.78,refund,in,Counterparty_31,21126529.16,,
2025-06-13,3007.01,asset_sale,in,Counterparty_88,21129536.17,,
2025-06-13,5696.98,software_subscription,out,Counterparty_30,21123839.19,2025-05-12,2025-06-12
2025-06-13,2322.07,software_subscription,out,Counterparty_80,21121517.12,2025-05-29,2025-06-25
2025-06-13,6047.75,investment_income,in,Counterparty_16,21127564.87,,
2025-06-13,2884.4,supplier_payment,out,Counterparty_42,21124680.47,2025-05-19,2025-06-25
2025-06-13,911.86,investment_income,in,Counterparty_68,21125592.33,,
2025-06-13,1463.78,tax_payment,out,Counterparty_22,21124128.55,2025-05-21,2025-06-21
2025-06-13,1709.8,customer_payment,in,Counterparty_83,21125838.35,,
2025-06-13,6357.55,credit,in,Counterparty_16,21132195.9,,
2025-06-13,2411.68,customer_payment,in,Counterparty_94,21134607.58,,
2025-06-13,10154.1,tax_payment,out,Counterparty_2,21124453.48,2025-05-04,2025-05-30
2025-06-13,6577.9,customer_payment,in,Counterparty_85,21131031.38,,
2025-06-13,13473.31,T&E,out,Counterparty_91,21117558.07,2025-05-24,2025-06-28
2025-06-13,6506.84,software_subscription,out,Counterparty_66,21111051.23,2025-05-12,2025-06-19
2025-06-13,1353.91,asset_sale,in,Counterparty_85,21112405.14,,
2025-06-13,3051.05,refund,in,Counterparty_74,21115456.19,,
2025-06-13,472.28,credit,in,Counterparty_85,21115928.47,,
2025-06-13,4473.77,credit,in,Counterparty_20,21120402.24,,
2025-06-13,3173.56,investment_income,in,Counterparty_7,21123575.8,,
2025-06-13,162.87,investment_income,in,Counterparty_99,21123738.67,,
2025-06-13,2577.46,tax_payment,out,Counterparty_6,21121161.21,2025-05-18,2025-06-18
2025-06-13,977.21,investment_income,in,Counterparty_99,21122138.42,,
2025-06-13,495.63,credit,in,Counterparty_90,21122634.05,,
2025-06-13,5677.91,credit,in,Counterparty_87,21128311.96,,
2025-06-13,1645.79,payroll,out,Counterparty_89,21126666.17,2025-05-02,2025-05-31
2025-06-13,890.14,rent,out,Counterparty_96,21125776.03,2025-05-04,2025-05-29
2025-06-14,1456.8,T&E,out,Counterparty_4,21124319.23,2025-05-09,2025-06-04
2025-06-14,1643.62,marketing_spend,out,Counterparty_59,21122675.61,2025-05-29,2025-07-07
2025-06-14,5952.99,utilities,out,Counterparty_17,21116722.62,2025-05-15,2025-06-23
2025-06-14,5513.79,credit,in,Counterparty_37,21122236.41,,
2025-06-14,696.64,investment_income,in,Counterparty_24,21122933.05,,
2025-06-14,6071.75,customer_payment,in,Counterparty_55,21129004.8,,
2025-06-14,1178.47,payroll,out,Counterparty_78,21127826.33,2025-05-20,2025-06-16
2025-06-14,153.64,refund,in,Counterparty_60,21127979.97,,
2025-06-14,430.68,asset_sale,in,Counterparty_60,21128410.65,,
2025-06-14,3458.2,refund,in,Counterparty_57,21131868.85,,
2025-06-14,142.14,tax_payment,out,Counterparty_51,21131726.71,2025-05-14,2025-06-15
2025-06-14,1179.43,marketing_spend,out,Counterparty_98,21130547.28,2025-05-14,2025-06-15
2025-06-14,198.74,refund,in,Counterparty_42,21130746.02,,
2025-06-14,2238.81,investment_income,in,Counterparty_48,21132984.83,,
2025-06-14,628.37,refund,in,Counterparty_62,21133613.2,,
2025-06-14,1194.41,customer_payment,in,Counterparty_85,21134807.61,,
2025-06-14,395.7,T&E,out,Counterparty_81,21134411.91,2025-05-08,2025-06-11
2025-06-14,3404.51,credit,in,Counterparty_64,21137816.42,,
2025-06-14,615.48,credit,in,Counterparty_77,21138431.9,,
2025-06-14,1149.83,refund,in,Counterparty_77,21139581.73,,
2025-06-14,1612.97,customer_payment,in,Counterparty_47,21141194.7,,
2025-06-14,3510.07,credit,in,Counterparty_18,21144704.77,,
2025-06-14,4583.91,utilities,out,Counterparty_24,21140120.86,2025-05-22,2025-06-20
2025-06-14,4997.34,asset_sale,in,Counterparty_67,21145118.2,,
2025-06-14,1579.64,credit,in,Counterparty_99,21146697.84,,
2025-06-14,598.73,credit,in,Counterparty_85,21147296.57,,
2025-06-14,10.69,investment_income,in,Counterparty_68,21147307.26,,
2025-06-14,1173.52,investment_income,in,Counterparty_20,21148480.78,,
2025-06-14,3512.47,loan_repayment,out,Counterparty_88,21144968.31,2025-05-01,2025-06-03
2025-06-14,947.26,loan_repayment,out,Counterparty_4,21144021.05,2025-05-22,2025-06-23
2025-06-14,2277.24,tax_payment,out,Counterparty_15,21141743.81,2025-05-16,2025-06-16
2025-06-14,890.64,refund,in,Counterparty_41,21142634.45,,
2025-06-14,2349.32,utilities,out,Counterparty_75,21140285.13,2025-05-10,2025-06-11
2025-06-14,5419.03,software_subscription,out,Counterparty_75,21134866.1,2025-05-01,2025-06-01
2025-06-14,4257.53,asset_sale,in,Counterparty_77,21139123.63,,
2025-06-14,578.69,investment_income,in,Counterparty_51,21139702.32,,
2025-06-14,4802.46,utilities,out,Counterparty_62,21134899.86,2025-05-26,2025-06-28
2025-06-14,1364.88,software_subscription,out,Counterparty_60,21133534.98,2025-05-07,2025-06-05
2025-06-14,7024.31,credit,in,Counterparty_84,21140559.29,,
2025-06-14,976.17,credit,in,Counterparty_68,21141535.46,,
2025-06-14,5600.48,asset_sale,in,Counterparty_50,21147135.94,,
2025-06-14,3024.35,credit,in,Counterparty_65,21150160.29,,
2025-06-14,5241.82,refund,in,Counterparty_68,21155402.11,,
2025-06-14,240.05,asset_sale,in,Counterparty_49,21155642.16,,
2025-06-14,3236.29,T&E,out,Counterparty_17,21152405.87,2025-05-28,2025-06-27
2025-06-14,1522.36,asset_sale,in,Counterparty_99,21153928.23,,
2025-06-14,3235.88,T&E,out,Counterparty_1,21150692.35,2025-05-09,2025-06-12
2025-06-14,9794.68,customer_payment,in,Counterparty_43,21160487.03,,
2025-06-14,2648.73,asset_sale,in,Counterparty_44,21163135.76,,
2025-06-14,677.67,customer_payment,in,Counterparty_42,21163813.43,,
2025-06-14,5564.95,tax_payment,out,Counterparty_63,21158248.48,2025-05-12,2025-06-16
2025-06-14,2215.5,investment_income,in,Counterparty_91,21160463.98,,
2025-06-14,1421.24,investment_income,in,Counterparty_73,21161885.22,,
2025-06-14,6265.34,T&E,out,Counterparty_12,21155619.88,2025-05-21,2025-06-20
2025-06-14,2529.2,customer_payment,in,Counterparty_63,21158149.08,,
2025-06-14,800.66,investment_income,in,Counterparty_90,21158949.74,,
2025-06-14,814.09,utilities,out,Counterparty_9,21158135.65,2025-05-14,2025-06-20
2025-06-14,829.25,rent,out,Counterparty_8,21157306.4,2025-05-14,2025-06-14
2025-06-14,2602.83,tax_payment,out,Counterparty_91,21154703.57,2025-05-26,2025-06-27
2025-06-14,1009.92,utilities,out,Counterparty_51,21153693.65,2025-05-13,2025-06-13
2025-06-14,4136.43,T&E,out,Counterparty_23,21149557.22,2025-05-28,2025-07-06
2025-06-14,3277.89,rent,out,Counterparty_95,21146279.33,2025-05-06,2025-06-09
2025-06-14,1257.33,T&E,out,Counterparty_7,21145022.0,2025-05-30,2025-07-03
2025-06-14,4737.13,investment_income,in,Counterparty_11,21149759.13,,
2025-06-14,2159.21,software_subscription,out,Counterparty_5,21147599.92,2025-05-13,2025-06-17
2025-06-14,2076.88,T&E,out,Counterparty_92,21145523.04,2025-05-08,2025-06-16
2025-06-14,1499.59,investment_income,in,Counterparty_6,21147022.63,,
2025-06-14,1242.73,utilities,out,Counterparty_39,21145779.9,2025-05-19,2025-06-22
2025-06-15,3740.55,T&E,out,Counterparty_7,21142039.35,2025-05-19,2025-06-14
2025-06-15,2707.33,tax_payment,out,Counterparty_8,21139332.02,2025-05-17,2025-06-20
2025-06-15,2705.38,credit,in,Counterparty_1,21142037.4,,
2025-06-15,6303.5,payroll,out,Counterparty_78,21135733.9,2025-05-19,2025-06-20
2025-06-15,5660.81,asset_sale,in,Counterparty_34,21141394.71,,
2025-06-15,9520.44,asset_sale,in,Counterparty_5,21150915.15,,
2025-06-15,2207.79,credit,in,Counterparty_94,21153122.94,,
2025-06-15,2294.69,loan_repayment,out,Counterparty_74,21150828.25,2025-05-10,2025-06-13
2025-06-15,8122.72,customer_payment,in,Counterparty_57,21158950.97,,
2025-06-15,3114.96,asset_sale,in,Counterparty_73,21162065.93,,
2025-06-15,4533.93,software_subscription,out,Counterparty_10,21157532.0,2025-05-27,2025-06-25
2025-06-15,1573.82,investment_income,in,Counterparty_12,21159105.82,,
2025-06-15,1124.22,investment_income,in,Counterparty_83,21160230.04,,
2025-06-15,798.19,software_subscription,out,Counterparty_81,21159431.85,2025-05-24,2025-06-23
2025-06-15,68.24,customer_payment,in,Counterparty_54,21159500.09,,
2025-06-15,1386.82,software_subscription,out,Counterparty_17,21158113.27,2025-05-14,2025-06-22
2025-06-15,10025.16,tax_payment,out,Counterparty_99,21148088.11,2025-05-10,2025-06-04
2025-06-15,595.19,payroll,out,Counterparty_55,21147492.92,2025-05-04,2025-06-05
2025-06-15,2727.66,rent,out,Counterparty_49,21144765.26,2025-05-17,2025-06-20
2025-06-15,1816.64,refund,in,Counterparty_48,21146581.9,,
2025-06-15,1133.4,credit,in,Counterparty_97,21147715.3,,
2025-06-15,2891.9,payroll,out,Counterparty_50,21144823.4,2025-05-03,2025-06-10
2025-06-15,2651.04,investment_income,in,Counterparty_70,21147474.44,,
2025-06-15,5293.03,customer_payment,in,Counterparty_40,21152767.47,,
2025-06-15,1459.62,utilities,out,Counterparty_91,21151307.85,2025-05-06,2025-06-11
2025-06-15,379.77,credit,in,Counterparty_81,21151687.62,,
2025-06-15,777.79,customer_payment,in,Counterparty_81,21152465.41,,
2025-06-15,1925.46,investment_income,in,Counterparty_18,21154390.87,,
2025-06-15,489.64,supplier_payment,out,Counterparty_65,21153901.23,2025-05-17,2025-06-23
2025-06-15,375.1,rent,out,Counterparty_56,21153526.13,2025-05-02,2025-06-08
2025-06-15,7569.47,customer_payment,in,Counterparty_5,21161095.6,,
2025-06-15,607.65,customer_payment,in,Counterparty_24,21161703.25,,
2025-06-15,2805.92,customer_payment,in,Counterparty_63,21164509.17,,
2025-06-15,1504.73,refund,in,Counterparty_64,21166013.9,,
2025-06-15,1100.54,refund,in,Counterparty_4,21167114.44,,
2025-06-15,4953.7,tax_payment,out,Counterparty_92,21162160.74,2025-05-06,2025-06-14
2025-06-15,515.73,customer_payment,in,Counterparty_79,21162676.47,,
2025-06-15,6254.72,asset_sale,in,Counterparty_34,21168931.19,,
2025-06-15,2588.86,loan_repayment,out,Counterparty_36,21166342.33,2025-05-29,2025-06-23
2025-06-15,592.45,asset_sale,in,Counterparty_85,21166934.78,,
2025-06-15,981.91,software_subscription,out,Counterparty_45,21165952.87,2025-05-25,2025-06-23
2025-06-15,753.28,customer_payment,in,Counterparty_21,21166706.15,,
2025-06-15,2733.27,investment_income,in,Counterparty_54,21169439.42,,
2025-06-15,637.13,credit,in,Counterparty_58,21170076.55,,
2025-06-15,2251.03,asset_sale,in,Counterparty_75,21172327.58,,
2025-06-15,1024.33,utilities,out,Counterparty_33,21171303.25,2025-05-31,2025-07-01
2025-06-15,881.57,asset_sale,in,Counterparty_99,21172184.82,,
2025-06-15,4150.04,refund,in,Counterparty_35,21176334.86,,
2025-06-15,11030.25,investment_income,in,Counterparty_69,21187365.11,,
2025-06-15,518.07,marketing_spend,out,Counterparty_26,21186847.04,2025-05-24,2025-06-29
2025-06-15,11281.58,asset_sale,in,Counterparty_10,21198128.62,,
2025-06-15,3719.3,asset_sale,in,Counterparty_1,21201847.92,,
2025-06-15,1282.0,tax_payment,out,Counterparty_89,21200565.92,2025-05-04,2025-05-31
2025-06-15,725.32,asset_sale,in,Counterparty_56,21201291.24,,
2025-06-15,1577.5,investment_income,in,Counterparty_73,21202868.74,,
2025-06-15,1561.1,refund,in,Counterparty_63,21204429.84,,
2025-06-15,4100.4,loan_repayment,out,Counterparty_61,21200329.44,2025-05-27,2025-07-02
2025-06-15,2376.78,refund,in,Counterparty_36,21202706.22,,
2025-06-15,3797.0,customer_payment,in,Counterparty_15,21206503.22,,
2025-06-15,1610.32,marketing_spend,out,Counterparty_53,21204892.9,2025-05-22,2025-06-17
2025-06-15,2505.07,software_subscription,out,Counterparty_34,21202387.83,2025-05-24,2025-06-27
2025-06-15,5504.23,asset_sale,in,Counterparty_99,21207892.06,,
2025-06-15,1890.01,tax_payment,out,Counterparty_63,21206002.05,2025-05-05,2025-06-04
2025-06-15,801.51,investment_income,in,Counterparty_6,21206803.56,,
2025-06-16,519.75,marketing_spend,out,Counterparty_79,21206283.81,2025-05-27,2025-07-01
2025-06-16,1690.41,marketing_spend,out,Counterparty_59,21204593.4,2025-05-03,2025-06-09
2025-06-16,1929.82,loan_repayment,out,Counterparty_1,21202663.58,2025-05-13,2025-06-07
2025-06-16,9404.7,supplier_payment,out,Counterparty_52,21193258.88,2025-05-21,2025-06-16
2025-06-16,3926.43,supplier_payment,out,Counterparty_12,21189332.45,2025-05-24,2025-06-23
2025-06-16,1300.76,tax_payment,out,Counterparty_17,21188031.69,2025-05-08,2025-06-05
2025-06-16,2472.94,software_subscription,out,Counterparty_94,21185558.75,2025-05-07,2025-06-09
2025-06-16,4054.68,utilities,out,Counterparty_62,21181504.07,2025-05-29,2025-06-24
2025-06-16,232.06,payroll,out,Counterparty_4,21181272.01,2025-05-13,2025-06-17
2025-06-16,1341.64,tax_payment,out,Counterparty_19,21179930.37,2025-05-28,2025-06-23
2025-06-16,584.02,customer_payment,in,Counterparty_3,21180514.39,,
2025-06-16,2019.02,tax_payment,out,Counterparty_20,21178495.37,2025-05-03,2025-06-09
2025-06-16,748.15,T&E,out,Counterparty_5,21177747.22,2025-05-20,2025-06-27
2025-06-16,718.62,refund,in,Counterparty_67,21178465.84,,
2025-06-16,2819.28,customer_payment,in,Counterparty_1,21181285.12,,
2025-06-16,1820.37,marketing_spend,out,Counterparty_14,21179464.75,2025-05-11,2025-06-16
2025-06-16,3009.73,investment_income,in,Counterparty_91,21182474.48,,
2025-06-16,1683.58,tax_payment,out,Counterparty_10,21180790.9,2025-05-28,2025-07-05
2025-06-16,3864.68,investment_income,in,Counterparty_93,21184655.58,,
2025-06-16,183.31,loan_repayment,out,Counterparty_63,21184472.27,2025-05-05,2025-06-03
2025-06-16,453.03,investment_income,in,Counterparty_34,21184925.3,,
2025-06-16,3306.24,customer_payment,in,Counterparty_97,21188231.54,,
2025-06-16,3012.38,software_subscription,out,Counterparty_43,21185219.16,2025-05-03,2025-06-09
2025-06-16,502.13,customer_payment,in,Counterparty_64,21185721.29,,
2025-06-16,1715.05,utilities,out,Counterparty_56,21184006.24,2025-05-06,2025-06-02
2025-06-16,1534.34,customer_payment,in,Counterparty_98,21185540.58,,
2025-06-16,10001.55,supplier_payment,out,Counterparty_23,21175539.03,2025-05-24,2025-07-02
2025-06-16,472.21,utilities,out,Counterparty_31,21175066.82,2025-05-08,2025-06-14
2025-06-16,6328.36,asset_sale,in,Counterparty_4,21181395.18,,
2025-06-16,1727.47,T&E,out,Counterparty_31,21179667.71,2025-05-27,2025-06-29
2025-06-16,3105.13,credit,in,Counterparty_37,21182772.84,,
2025-06-16,1967.35,investment_income,in,Counterparty_15,21184740.19,,
2025-06-16,2920.35,payroll,out,Counterparty_46,21181819.84,2025-05-09,2025-06-07
2025-06-16,3752.31,software_subscription,out,Counterparty_87,21178067.53,2025-05-29,2025-07-05
2025-06-16,2693.05,loan_repayment,out,Counterparty_48,21175374.48,2025-05-21,2025-06-17
2025-06-16,1483.37,loan_repayment,out,Counterparty_63,21173891.11,2025-05-17,2025-06-15
2025-06-16,3699.29,utilities,out,Counterparty_54,21170191.82,2025-05-27,2025-06-27
2025-06-16,2854.55,credit,in,Counterparty_89,21173046.37,,
2025-06-16,3211.62,tax_payment,out,Counterparty_10,21169834.75,2025-05-09,2025-06-03
2025-06-16,5375.35,refund,in,Counterparty_62,21175210.1,,
2025-06-16,789.06,supplier_payment,out,Counterparty_88,21174421.04,2025-06-01,2025-07-05
2025-06-16,1300.65,refund,in,Counterparty_49,21175721.69,,
2025-06-16,3388.19,investment_income,in,Counterparty_48,21179109.88,,
2025-06-16,4039.69,credit,in,Counterparty_50,21183149.57,,
2025-06-16,2926.8,loan_repayment,out,Counterparty_7,21180222.77,2025-05-25,2025-06-26
2025-06-16,54.92,credit,in,Counterparty_49,21180277.69,,
2025-06-16,2696.92,asset_sale,in,Counterparty_88,21182974.61,,
2025-06-16,291.85,credit,in,Counterparty_54,21183266.46,,
2025-06-16,3146.09,refund,in,Counterparty_16,21186412.55,,
2025-06-16,1268.4,credit,in,Counterparty_26,21187680.95,,
2025-06-16,1058.64,investment_income,in,Counterparty_40,21188739.59,,
2025-06-16,2530.81,credit,in,Counterparty_78,21191270.4,,
2025-06-16,673.3,customer_payment,in,Counterparty_9,21191943.7,,
2025-06-16,609.49,supplier_payment,out,Counterparty_64,21191334.21,2025-05-14,2025-06-15
2025-06-16,2168.76,payroll,out,Counterparty_68,21189165.45,2025-05-13,2025-06-19
2025-06-16,10658.19,asset_sale,in,Counterparty_49,21199823.64,,
2025-06-17,2544.22,investment_income,in,Counterparty_4,21202367.86,,
2025-06-17,733.69,investment_income,in,Counterparty_31,21203101.55,,
2025-06-17,8584.2,tax_payment,out,Counterparty_6,21194517.35,2025-05-22,2025-06-30
2025-06-17,3130.95,asset_sale,in,Counterparty_26,21197648.3,,
2025-06-17,2246.05,utilities,out,Counterparty_42,21195402.25,2025-05-07,2025-06-06
2025-06-17,4843.56,rent,out,Counterparty_55,21190558.69,2025-05-29,2025-07-05
2025-06-17,4183.97,investment_income,in,Counterparty_56,21194742.66,,
2025-06-17,6304.73,customer_payment,in,Counterparty_17,21201047.39,,
2025-06-17,765.75,customer_payment,in,Counterparty_30,21201813.14,,
2025-06-17,1730.49,loan_repayment,out,Counterparty_78,21200082.65,2025-05-11,2025-06-13
2025-06-17,4213.98,payroll,out,Counterparty_54,21195868.67,2025-05-08,2025-06-09
2025-06-17,602.76,refund,in,Counterparty_8,21196471.43,,
2025-06-17,3413.76,payroll,out,Counterparty_99,21193057.67,2025-05-15,2025-06-11
2025-06-17,1896.28,asset_sale,in,Counterparty_65,21194953.95,,
2025-06-17,1194.63,asset_sale,in,Counterparty_7,21196148.58,,
2025-06-17,2113.3,customer_payment,in,Counterparty_45,21198261.88,,
2025-06-17,210.05,software_subscription,out,Counterparty_34,21198051.83,2025-05-06,2025-06-13
2025-06-17,4238.68,loan_repayment,out,Counterparty_20,21193813.15,2025-05-04,2025-06-11
2025-06-17,1805.56,investment_income,in,Counterparty_64,21195618.71,,
2025-06-17,3020.5,refund,in,Counterparty_86,21198639.21,,
2025-06-17,1401.69,credit,in,Counterparty_43,21200040.9,,
2025-06-17,313.11,payroll,out,Counterparty_91,21199727.79,2025-05-23,2025-06-30
2025-06-17,993.28,credit,in,Counterparty_11,21200721.07,,
2025-06-17,11203.4,refund,in,Counterparty_51,21211924.47,,
2025-06-17,4773.23,rent,out,Counterparty_60,21207151.24,2025-05-20,2025-06-26
2025-06-17,894.95,refund,in,Counterparty_34,21208046.19,,
2025-06-17,6450.02,supplier_payment,out,Counterparty_15,21201596.17,2025-05-05,2025-06-12
2025-06-17,570.03,payroll,out,Counterparty_4,21201026.14,2025-05-29,2025-07-07
2025-06-17,1695.36,marketing_spend,out,Counterparty_79,21199330.78,2025-05-08,2025-06-13
2025-06-17,389.69,loan_repayment,out,Counterparty_43,21198941.09,2025-05-19,2025-06-26
2025-06-17,6482.33,credit,in,Counterparty_97,21205423.42,,
2025-06-17,6383.27,credit,in,Counterparty_73,21211806.69,,
2025-06-17,2910.76,asset_sale,in,Counterparty_58,21214717.45,,
2025-06-17,819.6,credit,in,Counterparty_50,21215537.05,,
2025-06-17,1285.83,payroll,out,Counterparty_81,21214251.22,2025-05-08,2025-06-10
2025-06-17,5413.02,software_subscription,out,Counterparty_25,21208838.2,2025-05-19,2025-06-27
2025-06-17,1001.48,supplier_payment,out,Counterparty_11,21207836.72,2025-05-20,2025-06-26
2025-06-17,2440.47,asset_sale,in,Counterparty_64,21210277.19,,
2025-06-17,1259.36,customer_payment,in,Counterparty_21,21211536.55,,
2025-06-17,2347.91,credit,in,Counterparty_27,21213884.46,,
2025-06-17,2505.11,refund,in,Counterparty_85,21216389.57,,
2025-06-17,1973.04,refund,in,Counterparty_73,21218362.61,,
2025-06-17,82.98,asset_sale,in,Counterparty_1,21218445.59,,
2025-06-17,2507.35,marketing_spend,out,Counterparty_50,21215938.24,2025-05-17,2025-06-13
2025-06-17,80.23,refund,in,Counterparty_12,21216018.47,,
2025-06-17,506.24,T&E,out,Counterparty_46,21215512.23,2025-06-02,2025-07-01
2025-06-17,1834.76,payroll,out,Counterparty_74,21213677.47,2025-05-16,2025-06-21
2025-06-17,3477.57,loan_repayment,out,Counterparty_46,21210199.9,2025-05-16,2025-06-21
2025-06-17,460.37,payroll,out,Counterparty_37,21209739.53,2025-05-30,2025-06-28
2025-06-17,1078.02,investment_income,in,Counterparty_92,21210817.55,,
2025-06-17,198.29,credit,in,Counterparty_40,21211015.84,,
2025-06-18,2042.08,tax_payment,out,Counterparty_56,21208973.76,2025-05-23,2025-06-29
2025-06-18,1349.07,tax_payment,out,Counterparty_93,21207624.69,2025-05-30,2025-06-27
2025-06-18,5561.46,utilities,out,Counterparty_76,21202063.23,2025-05-14,2025-06-19
2025-06-18,933.38,credit,in,Counterparty_40,21202996.61,,
2025-06-18,488.56,customer_payment,in,Counterparty_97,21203485.17,,
2025-06-18,138.75,supplier_payment,out,Counterparty_71,21203346.42,2025-05-08,2025-06-08
2025-06-18,1258.79,tax_payment,out,Counterparty_37,21202087.63,2025-05-23,2025-06-23
2025-06-18,614.36,software_subscription,out,Counterparty_71,21201473.27,2025-05-22,2025-06-25
2025-06-18,4702.85,loan_repayment,out,Counterparty_68,21196770.42,2025-05-14,2025-06-13
2025-06-18,1374.99,refund,in,Counterparty_45,21198145.41,,
2025-06-18,1631.32,customer_payment,in,Counterparty_87,21199776.73,,
2025-06-18,1350.41,T&E,out,Counterparty_87,21198426.32,2025-05-08,2025-06-09
2025-06-18,6792.79,tax_payment,out,Counterparty_47,21191633.53,2025-05-20,2025-06-25
2025-06-18,6012.52,credit,in,Counterparty_28,21197646.05,,
2025-06-18,7295.29,refund,in,Counterparty_11,21204941.34,,
2025-06-18,765.81,rent,out,Counterparty_90,21204175.53,2025-05-27,2025-06-23
2025-06-18,94.85,refund,in,Counterparty_60,21204270.38,,
2025-06-18,2259.9,software_subscription,out,Counterparty_82,21202010.48,2025-05-14,2025-06-17
2025-06-18,825.82,marketing_spend,out,Counterparty_79,21201184.66,2025-05-30,2025-06-26
2025-06-18,3655.46,investment_income,in,Counterparty_4,21204840.12,,
2025-06-18,6184.12,credit,in,Counterparty_33,21211024.24,,
2025-06-18,999.82,customer_payment,in,Counterparty_84,21212024.06,,
2025-06-18,3032.77,refund,in,Counterparty_5,21215056.83,,
2025-06-18,1230.61,payroll,out,Counterparty_18,21213826.22,2025-05-17,2025-06-15
2025-06-18,3596.31,asset_sale,in,Counterparty_65,21217422.53,,
2025-06-18,411.13,refund,in,Counterparty_86,21217833.66,,
2025-06-18,991.12,utilities,out,Counterparty_48,21216842.54,2025-05-13,2025-06-07
2025-06-18,7932.8,refund,in,Counterparty_43,21224775.34,,
2025-06-18,794.27,rent,out,Counterparty_45,21223981.07,2025-05-21,2025-06-23
2025-06-18,4543.61,credit,in,Counterparty_54,21228524.68,,
2025-06-18,1007.2,rent,out,Counterparty_82,21227517.48,2025-06-01,2025-07-03
2025-06-18,6446.81,tax_payment,out,Counterparty_21,21221070.67,2025-06-03,2025-06-30
2025-06-18,3685.32,marketing_spend,out,Counterparty_6,21217385.35,2025-05-26,2025-06-22
2025-06-18,751.65,tax_payment,out,Counterparty_52,21216633.7,2025-05-15,2025-06-12
2025-06-18,1374.6,tax_payment,out,Counterparty_51,21215259.1,2025-05-20,2025-06-19
2025-06-18,6374.47,payroll,out,Counterparty_25,21208884.63,2025-05-23,2025-06-22
2025-06-18,5186.57,investment_income,in,Counterparty_87,21214071.2,,
2025-06-18,2641.8,supplier_payment,out,Counterparty_76,21211429.4,2025-05-21,2025-06-20
2025-06-18,6405.7,credit,in,Counterparty_43,21217835.1,,
2025-06-18,1255.74,utilities,out,Counterparty_23,21216579.36,2025-05-09,2025-06-03
2025-06-18,767.91,customer_payment,in,Counterparty_85,21217347.27,,
2025-06-18,9922.31,credit,in,Counterparty_76,21227269.58,,
2025-06-18,2827.81,software_subscription,out,Counterparty_37,21224441.77,2025-05-12,2025-06-18
2025-06-18,2674.56,asset_sale,in,Counterparty_14,21227116.33,,
2025-06-18,231.98,tax_payment,out,Counterparty_37,21226884.35,2025-05-20,2025-06-20
2025-06-18,679.68,loan_repayment,out,Counterparty_91,21226204.67,2025-05-11,2025-06-12
2025-06-18,4174.74,tax_payment,out,Counterparty_90,21222029.93,2025-05-30,2025-06-26
2025-06-18,857.4,rent,out,Counterparty_46,21221172.53,2025-05-05,2025-06-03
2025-06-18,2232.41,asset_sale,in,Counterparty_57,21223404.94,,
2025-06-18,3605.0,refund,in,Counterparty_61,21227009.94,,
2025-06-19,796.02,T&E,out,Counterparty_89,21226213.92,2025-05-14,2025-06-14
2025-06-19,79.84,investment_income,in,Counterparty_33,21226293.76,,
2025-06-19,4947.5,rent,out,Counterparty_41,21221346.26,2025-05-16,2025-06-12
2025-06-19,2369.55,refund,in,Counterparty_82,21223715.81,,
2025-06-19,3134.12,customer_payment,in,Counterparty_66,21226849.93,,
2025-06-19,1667.41,T&E,out,Counterparty_32,21225182.52,2025-05-22,2025-06-30
2025-06-19,4793.09,loan_repayment,out,Counterparty_19,21220389.43,2025-05-15,2025-06-12
2025-06-19,2242.08,software_subscription,out,Counterparty_15,21218147.35,2025-06-01,2025-06-28
2025-06-19,6810.95,payroll,out,Counterparty_93,21211336.4,2025-05-26,2025-06-30
2025-06-19,1124.84,payroll,out,Counterparty_69,21210211.56,2025-05-27,2025-06-29
2025-06-19,665.76,supplier_payment,out,Counterparty_28,21209545.8,2025-05-26,2025-06-22
2025-06-19,3291.9,asset_sale,in,Counterparty_82,21212837.7,,
2025-06-19,4222.79,supplier_payment,out,Counterparty_45,21208614.91,2025-06-02,2025-07-05
2025-06-19,4471.08,marketing_spend,out,Counterparty_37,21204143.83,2025-05-29,2025-06-26
2025-06-19,1714.81,credit,in,Counterparty_26,21205858.64,,
2025-06-19,883.86,investment_income,in,Counterparty_54,21206742.5,,
2025-06-19,5276.24,asset_sale,in,Counterparty_37,21212018.74,,
2025-06-19,917.88,T&E,out,Counterparty_42,21211100.86,2025-06-03,2025-06-30
2025-06-19,1853.93,rent,out,Counterparty_23,21209246.93,2025-05-24,2025-06-20
2025-06-19,29.81,nsf_fee,out,Counterparty_13,21209217.12,2025-05-22,2025-06-22
2025-06-19,1200.15,supplier_payment,out,Counterparty_12,21208016.97,2025-05-27,2025-07-04
2025-06-19,477.99,asset_sale,in,Counterparty_96,21208494.96,,
2025-06-19,2318.23,credit,in,Counterparty_99,21210813.19,,
2025-06-19,156.75,tax_payment,out,Counterparty_48,21210656.44,2025-05-13,2025-06-15
2025-06-19,21.5,customer_payment,in,Counterparty_28,21210677.94,,
2025-06-19,4581.71,asset_sale,in,Counterparty_62,21215259.65,,
2025-06-19,3544.42,T&E,out,Counterparty_37,21211715.23,2025-05-09,2025-06-17
2025-06-19,75.11,customer_payment,in,Counterparty_14,21211790.34,,
2025-06-19,1808.79,asset_sale,in,Counterparty_63,21213599.13,,
2025-06-19,888.27,payroll,out,Counterparty_6,21212710.86,2025-05-15,2025-06-17
2025-06-19,7318.26,utilities,out,Counterparty_24,21205392.6,2025-05-23,2025-06-21
2025-06-19,952.52,loan_repayment,out,Counterparty_57,21204440.08,2025-05-26,2025-06-30
2025-06-19,1755.24,rent,out,Counterparty_19,21202684.84,2025-05-29,2025-06-27
2025-06-19,1557.52,customer_payment,in,Counterparty_81,21204242.36,,
2025-06-19,1239.16,credit,in,Counterparty_4,21205481.52,,
2025-06-19,805.18,customer_payment,in,Counterparty_85,21206286.7,,
2025-06-19,6750.48,tax_payment,out,Counterparty_92,21199536.22,2025-05-10,2025-06-10
2025-06-19,1059.1,rent,out,Counterparty_61,21198477.12,2025-06-03,2025-07-11
2025-06-19,269.32,supplier_payment,out,Counterparty_36,21198207.8,2025-05-07,2025-06-03
2025-06-19,362.03,payroll,out,Counterparty_14,21197845.77,2025-05-24,2025-06-20
2025-06-19,3453.93,investment_income,in,Counterparty_80,21201299.7,,
2025-06-19,2999.15,investment_income,in,Counterparty_88,21204298.85,,
2025-06-19,1633.56,utilities,out,Counterparty_21,21202665.29,2025-05-07,2025-06-12
2025-06-19,90.49,customer_payment,in,Counterparty_83,21202755.78,,
2025-06-19,1000.08,software_subscription,out,Counterparty_59,21201755.7,2025-06-04,2025-07-03
2025-06-19,88.78,loan_repayment,out,Counterparty_18,21201666.92,2025-05-29,2025-07-02
2025-06-19,2718.2,utilities,out,Counterparty_63,21198948.72,2025-05-21,2025-06-15
2025-06-19,5139.13,refund,in,Counterparty_15,21204087.85,,
2025-06-19,9212.96,refund,in,Counterparty_65,21213300.81,,
2025-06-19,6832.82,customer_payment,in,Counterparty_82,21220133.63,,
2025-06-19,5546.72,asset_sale,in,Counterparty_8,21225680.35,,
2025-06-19,5672.21,payroll,out,Counterparty_81,21220008.14,2025-06-03,2025-07-11
2025-06-19,4121.37,payroll,out,Counterparty_90,21215886.77,2025-05-07,2025-06-03
2025-06-19,951.51,T&E,out,Counterparty_24,21214935.26,2025-06-03,2025-07-09
2025-06-19,1821.64,tax_payment,out,Counterparty_91,21213113.62,2025-05-22,2025-06-29
2025-06-19,6230.85,customer_payment,in,Counterparty_5,21219344.47,,
2025-06-19,1509.03,credit,in,Counterparty_39,21220853.5,,
2025-06-20,1335.74,supplier_payment,out,Counterparty_63,21219517.76,2025-05-13,2025-06-08
2025-06-20,441.04,T&E,out,Counterparty_12,21219076.72,2025-05-17,2025-06-18
2025-06-20,3055.4,payroll,out,Counterparty_42,21216021.32,2025-05-13,2025-06-11
2025-06-20,498.25,T&E,out,Counterparty_34,21215523.07,2025-05-13,2025-06-10
2025-06-20,998.1,investment_income,in,Counterparty_33,21216521.17,,
2025-06-20,357.49,rent,out,Counterparty_10,21216163.68,2025-05-12,2025-06-19
2025-06-20,1919.46,software_subscription,out,Counterparty_81,21214244.22,2025-05-23,2025-06-25
2025-06-20,5092.77,T&E,out,Counterparty_19,21209151.45,2025-05-21,2025-06-19
2025-06-20,5680.81,software_subscription,out,Counterparty_87,21203470.64,2025-05-12,2025-06-19
2025-06-20,787.54,credit,in,Counterparty_13,21204258.18,,
2025-06-20,887.13,investment_income,in,Counterparty_60,21205145.31,,
2025-06-20,2754.77,T&E,out,Counterparty_45,21202390.54,2025-05-18,2025-06-23
2025-06-20,787.71,asset_sale,in,Counterparty_6,21203178.25,,
2025-06-20,5031.95,investment_income,in,Counterparty_64,21208210.2,,
2025-06-20,2638.96,utilities,out,Counterparty_42,21205571.24,2025-05-22,2025-06-26
2025-06-20,1172.1,loan_repayment,out,Counterparty_99,21204399.14,2025-06-04,2025-07-06
2025-06-20,784.5,tax_payment,out,Counterparty_69,21203614.64,2025-06-02,2025-06-29
2025-06-20,5547.95,T&E,out,Counterparty_87,21198066.69,2025-05-07,2025-06-15
2025-06-20,2145.33,marketing_spend,out,Counterparty_42,21195921.36,2025-05-09,2025-06-07
2025-06-20,1957.95,supplier_payment,out,Counterparty_86,21193963.41,2025-05-31,2025-06-28
2025-06-20,335.25,refund,in,Counterparty_55,21194298.66,,
2025-06-20,1583.83,customer_payment,in,Counterparty_77,21195882.49,,
2025-06-20,5838.68,asset_sale,in,Counterparty_28,21201721.17,,
2025-06-20,3454.8,customer_payment,in,Counterparty_77,21205175.97,,
2025-06-20,789.78,loan_repayment,out,Counterparty_27,21204386.19,2025-06-04,2025-07-05
2025-06-20,1320.13,asset_sale,in,Counterparty_27,21205706.32,,
2025-06-20,3058.67,refund,in,Counterparty_31,21208764.99,,
2025-06-20,613.68,tax_payment,out,Counterparty_11,21208151.31,2025-05-25,2025-06-29
2025-06-20,14512.24,customer_payment,in,Counterparty_77,21222663.55,,
2025-06-20,9447.47,investment_income,in,Counterparty_75,21232111.02,,
2025-06-20,11176.45,customer_payment,in,Counterparty_35,21243287.47,,
2025-06-20,2319.36,customer_payment,in,Counterparty_61,21245606.83,,
2025-06-20,7.51,marketing_spend,out,Counterparty_45,21245599.32,2025-05-15,2025-06-17
2025-06-20,1576.44,tax_payment,out,Counterparty_22,21244022.88,2025-05-07,2025-06-09
2025-06-20,6240.44,payroll,out,Counterparty_84,21237782.44,2025-05-29,2025-07-03
2025-06-20,281.19,asset_sale,in,Counterparty_66,21238063.63,,
2025-06-20,1347.46,payroll,out,Counterparty_18,21236716.17,2025-05-25,2025-06-28
2025-06-20,38.94,credit,in,Counterparty_43,21236755.11,,
2025-06-20,1561.79,rent,out,Counterparty_40,21235193.32,2025-05-18,2025-06-23
2025-06-20,2773.77,tax_payment,out,Counterparty_84,21232419.55,2025-05-30,2025-07-05
2025-06-20,2873.21,credit,in,Counterparty_33,21235292.76,,
2025-06-20,4572.26,asset_sale,in,Counterparty_96,21239865.02,,
2025-06-20,7041.34,rent,out,Counterparty_88,21232823.68,2025-05-31,2025-07-06
2025-06-20,16.44,payroll,out,Counterparty_98,21232807.24,2025-05-14,2025-06-17
2025-06-20,584.32,software_subscription,out,Counterparty_67,21232222.92,2025-05-14,2025-06-16
2025-06-20,837.34,utilities,out,Counterparty_70,21231385.58,2025-05-26,2025-06-23
2025-06-20,9466.53,investment_income,in,Counterparty_68,21240852.11,,
2025-06-20,2528.22,loan_repayment,out,Counterparty_96,21238323.89,2025-05-13,2025-06-14
2025-06-20,2047.81,asset_sale,in,Counterparty_10,21240371.7,,
2025-06-20,2862.23,customer_payment,in,Counterparty_87,21243233.93,,
2025-06-20,623.17,rent,out,Counterparty_63,21242610.76,2025-05-12,2025-06-12
2025-06-20,4778.84,loan_repayment,out,Counterparty_59,21237831.92,2025-05-30,2025-06-29
2025-06-20,1020.61,asset_sale,in,Counterparty_53,21238852.53,,
2025-06-20,1250.26,utilities,out,Counterparty_60,21237602.27,2025-05-22,2025-06-30
2025-06-20,671.72,T&E,out,Counterparty_92,21236930.55,2025-05-09,2025-06-06
2025-06-20,4801.33,asset_sale,in,Counterparty_75,21241731.88,,
2025-06-20,1821.9,rent,out,Counterparty_73,21239909.98,2025-05-23,2025-06-27
2025-06-20,1839.28,rent,out,Counterparty_85,21238070.7,2025-06-04,2025-07-09
2025-06-20,11332.04,software_subscription,out,Counterparty_72,21226738.66,2025-06-04,2025-07-11
2025-06-20,448.24,utilities,out,Counterparty_80,21226290.42,2025-06-04,2025-07-10
2025-06-20,5226.4,marketing_spend,out,Counterparty_92,21221064.02,2025-05-24,2025-06-21
2025-06-20,1030.52,utilities,out,Counterparty_45,21220033.5,2025-05-27,2025-07-01
2025-06-20,4815.17,rent,out,Counterparty_74,21215218.33,2025-06-04,2025-07-03
2025-06-21,2583.91,marketing_spend,out,Counterparty_31,21212634.42,2025-05-09,2025-06-09
2025-06-21,2127.63,customer_payment,in,Counterparty_69,21214762.05,,
2025-06-21,725.12,marketing_spend,out,Counterparty_66,21214036.93,2025-05-20,2025-06-21
2025-06-21,3309.72,customer_payment,in,Counterparty_26,21217346.65,,
2025-06-21,4619.82,software_subscription,out,Counterparty_95,21212726.83,2025-06-05,2025-07-11
2025-06-21,1762.59,rent,out,Counterparty_89,21210964.24,2025-05-08,2025-06-12
2025-06-21,295.62,credit,in,Counterparty_45,21211259.86,,
2025-06-21,1927.74,customer_payment,in,Counterparty_72,21213187.6,,
2025-06-21,1771.71,customer_payment,in,Counterparty_29,21214959.31,,
2025-06-21,812.75,loan_repayment,out,Counterparty_16,21214146.56,2025-05-23,2025-06-19
2025-06-21,7028.43,asset_sale,in,Counterparty_13,21221174.99,,
2025-06-21,1209.44,customer_payment,in,Counterparty_84,21222384.43,,
2025-06-21,1823.2,supplier_payment,out,Counterparty_30,21220561.23,2025-06-06,2025-07-10
2025-06-21,8095.54,refund,in,Counterparty_44,21228656.77,,
2025-06-21,675.76,investment_income,in,Counterparty_98,21229332.53,,
2025-06-21,22.34,rent,out,Counterparty_85,21229310.19,2025-05-22,2025-06-24
2025-06-21,3671.75,asset_sale,in,Counterparty_92,21232981.94,,
2025-06-21,618.3,customer_payment,in,Counterparty_46,21233600.24,,
2025-06-21,2436.14,supplier_payment,out,Counterparty_80,21231164.1,2025-05-25,2025-07-03
2025-06-21,110.11,utilities,out,Counterparty_8,21231053.99,2025-05-20,2025-06-17
2025-06-21,295.52,customer_payment,in,Counterparty_75,21231349.51,,
2025-06-21,3143.29,T&E,out,Counterparty_77,21228206.22,2025-05-29,2025-06-26
2025-06-21,42.91,rent,out,Counterparty_90,21228163.31,2025-05-20,2025-06-25
2025-06-21,6641.75,refund,in,Counterparty_60,21234805.06,,
2025-06-21,3135.66,refund,in,Counterparty_23,21237940.72,,
2025-06-21,3460.73,payroll,out,Counterparty_41,21234479.99,2025-05-19,2025-06-27
2025-06-21,1506.58,customer_payment,in,Counterparty_18,21235986.57,,
2025-06-21,3349.59,marketing_spend,out,Counterparty_97,21232636.98,2025-05-26,2025-07-04
2025-06-21,17691.94,T&E,out,Counterparty_67,21214945.04,2025-05-25,2025-06-23
2025-06-21,1977.92,customer_payment,in,Counterparty_97,21216922.96,,
2025-06-21,2535.91,marketing_spend,out,Counterparty_79,21214387.05,2025-05-30,2025-06-26
2025-06-21,2461.5,payroll,out,Counterparty_45,21211925.55,2025-06-04,2025-07-04
2025-06-21,1120.86,marketing_spend,out,Counterparty_75,21210804.69,2025-05-28,2025-06-22
2025-06-21,3540.52,software_subscription,out,Counterparty_27,21207264.17,2025-05-08,2025-06-05
2025-06-21,8908.2,supplier_payment,out,Counterparty_56,21198355.97,2025-05-17,2025-06-24
2025-06-21,897.4,asset_sale,in,Counterparty_53,21199253.37,,
2025-06-21,502.13,loan_repayment,out,Counterparty_38,21198751.24,2025-05-25,2025-06-21
2025-06-21,1650.72,investment_income,in,Counterparty_37,21200401.96,,
2025-06-21,3645.3,customer_payment,in,Counterparty_48,21204047.26,,
2025-06-21,3464.43,supplier_payment,out,Counterparty_61,21200582.83,2025-05-16,2025-06-18
2025-06-21,1152.89,refund,in,Counterparty_85,21201735.72,,
2025-06-21,1552.27,software_subscription,out,Counterparty_93,21200183.45,2025-05-25,2025-06-27
2025-06-21,15966.98,T&E,out,Counterparty_51,21184216.47,2025-05-13,2025-06-21
2025-06-21,2400.16,asset_sale,in,Counterparty_94,21186616.63,,
2025-06-21,8166.04,refund,in,Counterparty_99,21194782.67,,
2025-06-21,2184.38,marketing_spend,out,Counterparty_33,21192598.29,2025-05-21,2025-06-19
2025-06-21,85.14,supplier_payment,out,Counterparty_53,21192513.15,2025-05-24,2025-06-25
2025-06-21,4105.81,asset_sale,in,Counterparty_10,21196618.96,,
2025-06-22,2581.76,supplier_payment,out,Counterparty_3,21194037.2,2025-05-21,2025-06-16
2025-06-22,853.27,tax_payment,out,Counterparty_27,21193183.93,2025-05-30,2025-07-07
2025-06-22,8971.97,payroll,out,Counterparty_4,21184211.96,2025-05-24,2025-06-24
2025-06-22,10640.31,refund,in,Counterparty_55,21194852.27,,
2025-06-22,2388.05,tax_payment,out,Counterparty_22,21192464.22,2025-05-31,2025-06-27
2025-06-22,461.22,investment_income,in,Counterparty_66,21192925.44,,
2025-06-22,8025.47,credit,in,Counterparty_33,21200950.91,,
2025-06-22,3773.6,customer_payment,in,Counterparty_61,21204724.51,,
2025-06-22,1514.66,credit,in,Counterparty_34,21206239.17,,
2025-06-22,2599.14,credit,in,Counterparty_81,21208838.31,,
2025-06-22,630.33,investment_income,in,Counterparty_62,21209468.64,,
2025-06-22,617.36,refund,in,Counterparty_31,21210086.0,,
2025-06-22,2844.64,refund,in,Counterparty_66,21212930.64,,
2025-06-22,5343.51,payroll,out,Counterparty_70,21207587.13,2025-05-31,2025-07-04
2025-06-22,1440.48,marketing_spend,out,Counterparty_97,21206146.65,2025-05-26,2025-06-27
2025-06-22,4104.51,T&E,out,Counterparty_77,21202042.14,2025-06-02,2025-07-05
2025-06-22,1597.61,rent,out,Counterparty_10,21200444.53,2025-05-31,2025-07-03
2025-06-22,983.15,loan_repayment,out,Counterparty_25,21199461.38,2025-05-16,2025-06-10
2025-06-22,1174.51,rent,out,Counterparty_66,21198286.87,2025-05-24,2025-06-27
2025-06-22,1044.85,customer_payment,in,Counterparty_67,21199331.72,,
2025-06-22,2869.45,rent,out,Counterparty_27,21196462.27,2025-05-12,2025-06-20
2025-06-22,117.06,asset_sale,in,Counterparty_75,21196579.33,,
2025-06-22,461.62,investment_income,in,Counterparty_53,21197040.95,,
2025-06-22,712.49,investment_income,in,Counterparty_74,21197753.44,,
2025-06-22,1769.2,supplier_payment,out,Counterparty_6,21195984.24,2025-05-27,2025-07-01
2025-06-22,4103.24,utilities,out,Counterparty_7,21191881.0,2025-06-06,2025-07-02
2025-06-22,4321.54,tax_payment,out,Counterparty_73,21187559.46,2025-06-03,2025-07-02
2025-06-22,11543.29,credit,in,Counterparty_24,21199102.75,,
2025-06-22,2983.8,T&E,out,Counterparty_40,21196118.95,2025-05-19,2025-06-26
2025-06-22,2181.87,tax_payment,out,Counterparty_94,21193937.08,2025-06-01,2025-07-01
2025-06-22,679.97,marketing_spend,out,Counterparty_70,21193257.11,2025-05-16,2025-06-23
2025-06-22,1934.42,customer_payment,in,Counterparty_13,21195191.53,,
2025-06-22,1072.93,customer_payment,in,Counterparty_48,21196264.46,,
2025-06-22,1098.9,rent,out,Counterparty_43,21195165.56,2025-05-30,2025-07-07
2025-06-22,697.34,T&E,out,Counterparty_77,21194468.22,2025-05-30,2025-06-29
2025-06-22,4980.2,investment_income,in,Counterparty_8,21199448.42,,
2025-06-22,91.09,rent,out,Counterparty_51,21199357.33,2025-05-20,2025-06-20
2025-06-22,4100.45,asset_sale,in,Counterparty_60,21203457.78,,
2025-06-22,1352.68,loan_repayment,out,Counterparty_75,21202105.1,2025-06-01,2025-06-26
2025-06-22,2173.8,refund,in,Counterparty_33,21204278.9,,
2025-06-22,10172.31,utilities,out,Counterparty_20,21194106.59,2025-05-13,2025-06-19
2025-06-22,1364.43,marketing_spend,out,Counterparty_94,21192742.16,2025-05-20,2025-06-19
2025-06-22,5876.29,T&E,out,Counterparty_83,21186865.87,2025-05-26,2025-06-24
2025-06-22,87.42,customer_payment,in,Counterparty_77,21186953.29,,
2025-06-22,2353.36,tax_payment,out,Counterparty_83,21184599.93,2025-05-18,2025-06-26
2025-06-22,777.83,supplier_payment,out,Counterparty_13,21183822.1,2025-06-02,2025-07-07
2025-06-22,626.52,loan_repayment,out,Counterparty_71,21183195.58,2025-05-21,2025-06-29
2025-06-23,1786.58,credit,in,Counterparty_23,21184982.16,,
2025-06-23,1186.94,refund,in,Counterparty_94,21186169.1,,
2025-06-23,3356.25,refund,in,Counterparty_12,21189525.35,,
2025-06-23,1639.6,investment_income,in,Counterparty_79,21191164.95,,
2025-06-23,12796.68,refund,in,Counterparty_68,21203961.63,,
2025-06-23,1595.74,credit,in,Counterparty_83,21205557.37,,
2025-06-23,1283.74,refund,in,Counterparty_21,21206841.11,,
2025-06-23,4576.2,rent,out,Counterparty_42,21202264.91,2025-06-07,2025-07-14
2025-06-23,11220.87,customer_payment,in,Counterparty_37,21213485.78,,
2025-06-23,4685.91,supplier_payment,out,Counterparty_9,21208799.87,2025-05-24,2025-06-23
2025-06-23,378.31,software_subscription,out,Counterparty_61,21208421.56,2025-05-11,2025-06-12
2025-06-23,6715.51,supplier_payment,out,Counterparty_79,21201706.05,2025-05-16,2025-06-21
2025-06-23,1976.16,marketing_spend,out,Counterparty_29,21199729.89,2025-05-21,2025-06-16
2025-06-23,2282.3,T&E,out,Counterparty_25,21197447.59,2025-05-20,2025-06-26
2025-06-23,2514.89,T&E,out,Counterparty_42,21194932.7,2025-06-03,2025-07-05
2025-06-23,2255.12,software_subscription,out,Counterparty_21,21192677.58,2025-05-19,2025-06-18
2025-06-23,755.1,investment_income,in,Counterparty_26,21193432.68,,
2025-06-23,140.36,rent,out,Counterparty_32,21193292.32,2025-05-23,2025-06-27
2025-06-23,1409.09,asset_sale,in,Counterparty_42,21194701.41,,
2025-06-23,671.61,software_subscription,out,Counterparty_21,21194029.8,2025-05-19,2025-06-13
2025-06-23,777.82,supplier_payment,out,Counterparty_87,21193251.98,2025-05-17,2025-06-21
2025-06-23,3774.34,credit,in,Counterparty_47,21197026.32,,
2025-06-23,1246.85,rent,out,Counterparty_54,21195779.47,2025-05-19,2025-06-24
2025-06-23,897.24,rent,out,Counterparty_52,21194882.23,2025-06-06,2025-07-09
2025-06-23,2845.44,asset_sale,in,Counterparty_55,21197727.67,,
2025-06-23,8674.89,rent,out,Counterparty_49,21189052.78,2025-06-02,2025-07-07
2025-06-23,5771.58,refund,in,Counterparty_5,21194824.36,,
2025-06-23,5090.79,investment_income,in,Counterparty_37,21199915.15,,
2025-06-23,522.48,investment_income,in,Counterparty_12,21200437.63,,
2025-06-23,301.36,software_subscription,out,Counterparty_20,21200136.27,2025-05-24,2025-06-22
2025-06-23,3890.15,credit,in,Counterparty_11,21204026.42,,
2025-06-23,5850.51,loan_repayment,out,Counterparty_12,21198175.91,2025-05-13,2025-06-15
2025-06-23,82.23,credit,in,Counterparty_38,21198258.14,,
2025-06-23,4116.93,tax_payment,out,Counterparty_97,21194141.21,2025-06-07,2025-07-06
2025-06-23,2176.92,payroll,out,Counterparty_76,21191964.29,2025-05-31,2025-06-27
2025-06-23,1345.04,T&E,out,Counterparty_92,21190619.25,2025-05-31,2025-07-03
2025-06-23,1435.68,asset_sale,in,Counterparty_8,21192054.93,,
2025-06-23,332.41,credit,in,Counterparty_74,21192387.34,,
2025-06-23,582.33,payroll,out,Counterparty_27,21191805.01,2025-06-04,2025-06-29
2025-06-23,2126.63,utilities,out,Counterparty_39,21189678.38,2025-06-08,2025-07-03
2025-06-23,2415.52,asset_sale,in,Counterparty_23,21192093.9,,
2025-06-23,250.01,investment_income,in,Counterparty_38,21192343.91,,
2025-06-23,4432.41,credit,in,Counterparty_23,21196776.32,,
2025-06-23,1905.73,tax_payment,out,Counterparty_49,21194870.59,2025-05-24,2025-06-25
2025-06-23,5239.5,asset_sale,in,Counterparty_5,21200110.09,,
2025-06-23,3322.98,payroll,out,Counterparty_62,21196787.11,2025-05-17,2025-06-20
2025-06-23,442.76,utilities,out,Counterparty_75,21196344.35,2025-05-30,2025-06-25
2025-06-23,995.08,credit,in,Counterparty_4,21197339.43,,
2025-06-23,1528.68,marketing_spend,out,Counterparty_20,21195810.75,2025-06-04,2025-07-07
2025-06-23,4367.99,investment_income,in,Counterparty_2,21200178.74,,
2025-06-23,1040.89,refund,in,Counterparty_39,21201219.63,,
2025-06-23,2535.94,utilities,out,Counterparty_74,21198683.69,2025-06-07,2025-07-12
2025-06-23,2271.6,T&E,out,Counterparty_3,21196412.09,2025-05-22,2025-06-26
2025-06-23,2074.79,tax_payment,out,Counterparty_95,21194337.3,2025-06-03,2025-06-30
2025-06-23,421.36,customer_payment,in,Counterparty_54,21194758.66,,
2025-06-23,504.43,investment_income,in,Counterparty_42,21195263.09,,
2025-06-23,3285.83,loan_repayment,out,Counterparty_1,21191977.26,2025-06-05,2025-07-08
2025-06-23,7254.17,software_subscription,out,Counterparty_62,21184723.09,2025-06-08,2025-07-06
2025-06-23,10290.33,loan_repayment,out,Counterparty_50,21174432.76,2025-05-16,2025-06-20
2025-06-23,4127.79,asset_sale,in,Counterparty_23,21178560.55,,
2025-06-23,429.22,marketing_spend,out,Counterparty_65,21178131.33,2025-05-11,2025-06-18
2025-06-23,8252.44,supplier_payment,out,Counterparty_17,21169878.89,2025-05-31,2025-06-26
2025-06-23,1900.87,rent,out,Counterparty_72,21167978.02,2025-05-25,2025-06-19
2025-06-23,11361.15,software_subscription,out,Counterparty_78,21156616.87,2025-05-17,2025-06-15
2025-06-23,935.22,T&E,out,Counterparty_61,21155681.65,2025-05-16,2025-06-16
2025-06-23,3321.3,loan_repayment,out,Counterparty_23,21152360.35,2025-05-28,2025-07-02
2025-06-24,1439.36,rent,out,Counterparty_69,21150920.99,2025-05-17,2025-06-11
2025-06-24,1924.54,supplier_payment,out,Counterparty_91,21148996.45,2025-05-27,2025-06-21
2025-06-24,170.41,asset_sale,in,Counterparty_84,21149166.86,,
2025-06-24,1675.11,software_subscription,out,Counterparty_76,21147491.75,2025-05-19,2025-06-22
2025-06-24,496.59,credit,in,Counterparty_16,21147988.34,,
2025-06-24,1278.05,rent,out,Counterparty_40,21146710.29,2025-05-30,2025-07-04
2025-06-24,744.46,credit,in,Counterparty_72,21147454.75,,
2025-06-24,1939.66,asset_sale,in,Counterparty_85,21149394.41,,
2025-06-24,4506.46,T&E,out,Counterparty_99,21144887.95,2025-06-04,2025-07-05
2025-06-24,2878.32,credit,in,Counterparty_50,21147766.27,,
2025-06-24,824.49,refund,in,Counterparty_63,21148590.76,,
2025-06-24,773.78,asset_sale,in,Counterparty_40,21149364.54,,
2025-06-24,4027.66,rent,out,Counterparty_64,21145336.88,2025-05-31,2025-07-04
2025-06-24,5525.87,asset_sale,in,Counterparty_45,21150862.75,,
2025-06-24,2127.94,asset_sale,in,Counterparty_64,21152990.69,,
2025-06-24,4028.1,asset_sale,in,Counterparty_54,21157018.79,,
2025-06-24,1049.29,utilities,out,Counterparty_52,21155969.5,2025-05-23,2025-06-25
2025-06-24,1241.83,investment_income,in,Counterparty_13,21157211.33,,
2025-06-24,9395.01,refund,in,Counterparty_35,21166606.34,,
2025-06-24,6342.64,refund,in,Counterparty_15,21172948.98,,
2025-06-24,3080.61,credit,in,Counterparty_49,21176029.59,,
2025-06-24,8603.96,customer_payment,in,Counterparty_51,21184633.55,,
2025-06-24,260.33,investment_income,in,Counterparty_92,21184893.88,,
2025-06-24,141.72,payroll,out,Counterparty_77,21184752.16,2025-05-12,2025-06-16
2025-06-24,1071.39,investment_income,in,Counterparty_55,21185823.55,,
2025-06-24,2073.1,rent,out,Counterparty_91,21183750.45,2025-06-02,2025-06-30
2025-06-24,11303.22,software_subscription,out,Counterparty_35,21172447.23,2025-05-28,2025-06-29
2025-06-24,3852.23,payroll,out,Counterparty_88,21168595.0,2025-05-28,2025-07-04
2025-06-24,372.93,asset_sale,in,Counterparty_96,21168967.93,,
2025-06-24,2767.12,supplier_payment,out,Counterparty_5,21166200.81,2025-05-18,2025-06-25
2025-06-24,2245.59,customer_payment,in,Counterparty_47,21168446.4,,
2025-06-24,5446.25,utilities,out,Counterparty_41,21163000.15,2025-05-18,2025-06-18
2025-06-24,1764.41,credit,in,Counterparty_59,21164764.56,,
2025-06-24,988.73,refund,in,Counterparty_67,21165753.29,,
2025-06-24,1880.76,software_subscription,out,Counterparty_5,21163872.53,2025-05-17,2025-06-21
2025-06-24,3012.36,payroll,out,Counterparty_18,21160860.17,2025-06-02,2025-07-04
2025-06-24,3226.82,loan_repayment,out,Counterparty_59,21157633.35,2025-05-20,2025-06-14
2025-06-24,608.01,T&E,out,Counterparty_18,21157025.34,2025-05-13,2025-06-19
2025-06-24,3969.0,customer_payment,in,Counterparty_71,21160994.34,,
2025-06-24,354.93,T&E,out,Counterparty_43,21160639.41,2025-06-07,2025-07-09
2025-06-24,4527.54,asset_sale,in,Counterparty_8,21165166.95,,
2025-06-24,3774.75,software_subscription,out,Counterparty_78,21161392.2,2025-05-24,2025-06-24
2025-06-24,81.13,customer_payment,in,Counterparty_94,21161473.33,,
2025-06-24,2639.62,refund,in,Counterparty_85,21164112.95,,
2025-06-24,12491.0,marketing_spend,out,Counterparty_87,21151621.95,2025-06-02,2025-07-02
2025-06-24,3918.48,tax_payment,out,Counterparty_28,21147703.47,2025-05-28,2025-06-25
2025-06-24,3320.3,refund,in,Counterparty_6,21151023.77,,
2025-06-24,1835.37,refund,in,Counterparty_7,21152859.14,,
2025-06-24,76.72,refund,in,Counterparty_81,21152935.86,,
2025-06-24,8399.73,asset_sale,in,Counterparty_69,21161335.59,,
2025-06-24,555.26,marketing_spend,out,Counterparty_59,21160780.33,2025-05-11,2025-06-11
2025-06-24,4518.64,utilities,out,Counterparty_97,21156261.69,2025-06-03,2025-06-29
2025-06-24,608.19,loan_repayment,out,Counterparty_48,21155653.5,2025-06-09,2025-07-05
2025-06-24,628.19,rent,out,Counterparty_91,21155025.31,2025-05-16,2025-06-22
2025-06-24,69.97,investment_income,in,Counterparty_43,21155095.28,,
2025-06-24,2750.66,marketing_spend,out,Counterparty_35,21152344.62,2025-05-28,2025-07-02
2025-06-24,1556.88,T&E,out,Counterparty_95,21150787.74,2025-05-30,2025-06-27
2025-06-24,523.53,loan_repayment,out,Counterparty_63,21150264.21,2025-05-11,2025-06-05
2025-06-24,843.57,utilities,out,Counterparty_84,21149420.64,2025-05-14,2025-06-17
2025-06-24,933.35,asset_sale,in,Counterparty_59,21150353.99,,
2025-06-24,586.06,T&E,out,Counterparty_51,21149767.93,2025-05-29,2025-07-04
2025-06-24,3670.84,asset_sale,in,Counterparty_94,21153438.77,,
2025-06-24,11875.05,tax_payment,out,Counterparty_56,21141563.72,2025-06-03,2025-07-02
2025-06-24,6724.06,supplier_payment,out,Counterparty_18,21134839.66,2025-05-11,2025-06-05
2025-06-25,1385.69,asset_sale,in,Counterparty_80,21136225.35,,
2025-06-25,1235.46,refund,in,Counterparty_70,21137460.81,,
2025-06-25,6326.47,customer_payment,in,Counterparty_61,21143787.28,,
2025-06-25,1351.76,credit,in,Counterparty_48,21145139.04,,
2025-06-25,66.26,software_subscription,out,Counterparty_73,21145072.78,2025-06-07,2025-07-06
2025-06-25,4369.31,T&E,out,Counterparty_61,21140703.47,2025-05-31,2025-06-27
2025-06-25,1075.49,payroll,out,Counterparty_47,21139627.98,2025-05-25,2025-06-23
2025-06-25,202.69,supplier_payment,out,Counterparty_69,21139425.29,2025-06-06,2025-07-10
2025-06-25,813.57,investment_income,in,Counterparty_99,21140238.86,,
2025-06-25,1368.44,T&E,out,Counterparty_54,21138870.42,2025-06-04,2025-07-12
2025-06-25,931.42,credit,in,Counterparty_51,21139801.84,,
2025-06-25,2855.72,customer_payment,in,Counterparty_52,21142657.56,,
2025-06-25,871.22,utilities,out,Counterparty_69,21141786.34,2025-05-27,2025-07-04
2025-06-25,3686.12,refund,in,Counterparty_50,21145472.46,,
2025-06-25,886.67,credit,in,Counterparty_49,21146359.13,,
2025-06-25,390.15,loan_repayment,out,Counterparty_25,21145968.98,2025-06-06,2025-07-15
2025-06-25,857.06,investment_income,in,Counterparty_60,21146826.04,,
2025-06-25,780.03,rent,out,Counterparty_87,21146046.01,2025-05-20,2025-06-26
2025-06-25,1027.91,T&E,out,Counterparty_50,21145018.1,2025-06-09,2025-07-17
2025-06-25,1049.59,marketing_spend,out,Counterparty_94,21143968.51,2025-06-01,2025-07-06
2025-06-25,2435.2,investment_income,in,Counterparty_21,21146403.71,,
2025-06-25,926.55,customer_payment,in,Counterparty_53,21147330.26,,
2025-06-25,481.56,refund,in,Counterparty_25,21147811.82,,
2025-06-25,2125.46,marketing_spend,out,Counterparty_55,21145686.36,2025-06-06,2025-07-06
2025-06-25,2446.67,loan_repayment,out,Counterparty_17,21143239.69,2025-05-29,2025-06-29
2025-06-25,54.71,credit,in,Counterparty_69,21143294.4,,
2025-06-25,1866.68,tax_payment,out,Counterparty_7,21141427.72,2025-05-21,2025-06-17
2025-06-25,7740.82,refund,in,Counterparty_72,21149168.54,,
2025-06-25,597.97,utilities,out,Counterparty_43,21148570.57,2025-06-06,2025-07-07
2025-06-25,6027.41,supplier_payment,out,Counterparty_36,21142543.16,2025-05-14,2025-06-17
2025-06-25,432.18,rent,out,Counterparty_46,21142110.98,2025-05-26,2025-06-24
2025-06-25,4336.08,T&E,out,Counterparty_97,21137774.9,2025-05-20,2025-06-24
2025-06-25,388.86,credit,in,Counterparty_37,21138163.76,,
2025-06-25,2335.76,T&E,out,Counterparty_88,21135828.0,2025-06-08,2025-07-17
2025-06-25,2837.9,asset_sale,in,Counterparty_63,21138665.9,,
2025-06-25,863.93,investment_income,in,Counterparty_36,21139529.83,,
2025-06-25,3138.98,loan_repayment,out,Counterparty_2,21136390.85,2025-05-14,2025-06-16
2025-06-25,485.61,marketing_spend,out,Counterparty_11,21135905.24,2025-06-07,2025-07-10
2025-06-25,117.88,customer_payment,in,Counterparty_44,21136023.12,,
2025-06-25,497.5,credit,in,Counterparty_77,21136520.62,,
2025-06-25,1999.54,payroll,out,Counterparty_37,21134521.08,2025-05-17,2025-06-24
2025-06-25,2005.85,refund,in,Counterparty_77,21136526.93,,
2025-06-25,1919.98,T&E,out,Counterparty_32,21134606.95,2025-05-27,2025-06-29
2025-06-25,551.8,credit,in,Counterparty_64,21135158.75,,
2025-06-25,3538.6,customer_payment,in,Counterparty_41,21138697.35,,
2025-06-25,109.04,rent,out,Counterparty_80,21138588.31,2025-06-05,2025-07-04
2025-06-25,4328.86,asset_sale,in,Counterparty_15,21142917.17,,
2025-06-25,1627.39,tax_payment,out,Counterparty_74,21141289.78,2025-06-03,2025-06-29
2025-06-25,509.67,refund,in,Counterparty_97,21141799.45,,
2025-06-25,915.27,customer_payment,in,Counterparty_99,21142714.72,,
2025-06-25,2983.14,refund,in,Counterparty_18,21145697.86,,
2025-06-25,1642.7,customer_payment,in,Counterparty_64,21147340.56,,
2025-06-25,37.93,credit,in,Counterparty_69,21147378.49,,
2025-06-25,593.61,credit,in,Counterparty_88,21147972.1,,
2025-06-25,2308.96,loan_repayment,out,Counterparty_70,21145663.14,2025-06-02,2025-07-07
2025-06-25,1826.7,customer_payment,in,Counterparty_78,21147489.84,,
2025-06-25,14843.15,supplier_payment,out,Counterparty_4,21132646.69,2025-06-01,2025-07-03
2025-06-25,1653.67,marketing_spend,out,Counterparty_47,21130993.02,2025-05-25,2025-06-24
2025-06-25,4593.63,customer_payment,in,Counterparty_98,21135586.65,,
2025-06-25,1224.0,loan_repayment,out,Counterparty_13,21134362.65,2025-05-16,2025-06-22
2025-06-25,1525.03,tax_payment,out,Counterparty_76,21132837.62,2025-05-20,2025-06-27
2025-06-25,2977.65,supplier_payment,out,Counterparty_14,21129859.97,2025-06-08,2025-07-04
2025-06-25,2663.71,customer_payment,in,Counterparty_97,21132523.68,,
2025-06-25,1582.5,T&E,out,Counterparty_56,21130941.18,2025-05-29,2025-06-24
2025-06-25,534.9,payroll,out,Counterparty_65,21130406.28,2025-06-10,2025-07-18
2025-06-25,5327.17,marketing_spend,out,Counterparty_49,21125079.11,2025-05-30,2025-06-27
2025-06-26,2167.51,asset_sale,in,Counterparty_26,21127246.62,,
2025-06-26,9470.0,payroll,out,Counterparty_76,21117776.62,2025-06-05,2025-07-13
2025-06-26,3698.12,software_subscription,out,Counterparty_74,21114078.5,2025-05-31,2025-07-09
2025-06-26,248.4,investment_income,in,Counterparty_91,21114326.9,,
2025-06-26,1689.23,marketing_spend,out,Counterparty_5,21112637.67,2025-05-22,2025-06-29
2025-06-26,5882.38,asset_sale,in,Counterparty_37,21118520.05,,
2025-06-26,2879.64,utilities,out,Counterparty_91,21115640.41,2025-05-14,2025-06-21
2025-06-26,662.51,credit,in,Counterparty_68,21116302.92,,
2025-06-26,32.38,tax_payment,out,Counterparty_26,21116270.54,2025-06-09,2025-07-09
2025-06-26,116.62,payroll,out,Counterparty_49,21116153.92,2025-05-27,2025-07-03
2025-06-26,1571.4,marketing_spend,out,Counterparty_79,21114582.52,2025-05-22,2025-06-26
2025-06-26,37.25,refund,in,Counterparty_26,21114619.77,,
2025-06-26,1784.11,customer_payment,in,Counterparty_13,21116403.88,,
2025-06-26,6018.01,software_subscription,out,Counterparty_16,21110385.87,2025-06-03,2025-07-05
2025-06-26,122.68,tax_payment,out,Counterparty_91,21110263.19,2025-05-22,2025-06-27
2025-06-26,2543.15,credit,in,Counterparty_93,21112806.34,,
2025-06-26,1693.08,loan_repayment,out,Counterparty_65,21111113.26,2025-05-19,2025-06-16
2025-06-26,3378.76,loan_repayment,out,Counterparty_71,21107734.5,2025-05-29,2025-07-04
2025-06-26,700.89,credit,in,Counterparty_19,21108435.39,,
2025-06-26,5528.33,credit,in,Counterparty_97,21113963.72,,
2025-06-26,3991.16,customer_payment,in,Counterparty_98,21117954.88,,
2025-06-26,1451.16,loan_repayment,out,Counterparty_87,21116503.72,2025-05-16,2025-06-24
2025-06-26,270.67,payroll,out,Counterparty_14,21116233.05,2025-05-14,2025-06-08
2025-06-26,2506.81,credit,in,Counterparty_35,21118739.86,,
2025-06-26,642.61,supplier_payment,out,Counterparty_95,21118097.25,2025-06-09,2025-07-13
2025-06-26,756.11,payroll,out,Counterparty_50,21117341.14,2025-05-27,2025-06-27
2025-06-26,3133.1,credit,in,Counterparty_33,21120474.24,,
2025-06-26,9549.33,investment_income,in,Counterparty_21,21130023.57,,
2025-06-26,240.7,rent,out,Counterparty_50,21129782.87,2025-05-22,2025-06-27
2025-06-26,9743.07,T&E,out,Counterparty_92,21120039.8,2025-05-22,2025-06-21
2025-06-26,3750.91,tax_payment,out,Counterparty_23,21116288.89,2025-05-26,2025-06-30
2025-06-26,1440.97,asset_sale,in,Counterparty_33,21117729.86,,
2025-06-26,327.93,marketing_spend,out,Counterparty_11,21117401.93,2025-06-09,2025-07-07
2025-06-26,1175.63,software_subscription,out,Counterparty_79,21116226.3,2025-05-28,2025-06-25
2025-06-26,1372.23,asset_sale,in,Counterparty_78,21117598.53,,
2025-06-26,2720.17,supplier_payment,out,Counterparty_93,21114878.36,2025-05-25,2025-06-24
2025-06-26,14.92,loan_repayment,out,Counterparty_25,21114863.44,2025-05-18,2025-06-19
2025-06-26,5046.01,payroll,out,Counterparty_15,21109817.43,2025-05-19,2025-06-15
2025-06-26,4424.68,software_subscription,out,Counterparty_12,21105392.75,2025-06-03,2025-07-12
2025-06-26,4664.73,credit,in,Counterparty_18,21110057.48,,
2025-06-26,27410.59,customer_payment,in,Counterparty_38,21137468.07,,
2025-06-26,1025.57,asset_sale,in,Counterparty_81,21138493.64,,
2025-06-26,2783.89,supplier_payment,out,Counterparty_63,21135709.75,2025-05-29,2025-07-06
2025-06-26,4093.45,tax_payment,out,Counterparty_36,21131616.3,2025-06-04,2025-07-04
2025-06-26,2546.31,utilities,out,Counterparty_21,21129069.99,2025-05-30,2025-07-07
2025-06-26,3461.26,supplier_payment,out,Counterparty_12,21125608.73,2025-06-02,2025-07-02
2025-06-26,413.2,credit,in,Counterparty_29,21126021.93,,
2025-06-26,1855.67,rent,out,Counterparty_58,21124166.26,2025-06-11,2025-07-15
2025-06-26,59.56,T&E,out,Counterparty_86,21124106.7,2025-05-22,2025-06-19
2025-06-26,8723.77,supplier_payment,out,Counterparty_99,21115382.93,2025-06-10,2025-07-18
2025-06-26,3024.74,utilities,out,Counterparty_68,21112358.19,2025-05-24,2025-06-18
2025-06-26,391.66,customer_payment,in,Counterparty_60,21112749.85,,
2025-06-26,2634.17,payroll,out,Counterparty_39,21110115.68,2025-06-01,2025-06-30
2025-06-26,124.75,customer_payment,in,Counterparty_6,21110240.43,,
2025-06-26,3083.49,investment_income,in,Counterparty_4,21113323.92,,
2025-06-26,157.4,credit,in,Counterparty_37,21113481.32,,
2025-06-26,452.69,asset_sale,in,Counterparty_45,21113934.01,,
2025-06-26,158.03,T&E,out,Counterparty_92,21113775.98,2025-06-02,2025-07-01
2025-06-26,4302.59,asset_sale,in,Counterparty_60,21118078.57,,
2025-06-26,2756.04,credit,in,Counterparty_67,21120834.61,,
2025-06-26,2055.2,loan_repayment,out,Counterparty_93,21118779.41,2025-05-17,2025-06-24
2025-06-26,1140.47,loan_repayment,out,Counterparty_22,21117638.94,2025-05-26,2025-06-27
2025-06-26,1154.48,asset_sale,in,Counterparty_85,21118793.42,,
2025-06-26,473.87,utilities,out,Counterparty_2,21118319.55,2025-06-01,2025-06-30
2025-06-26,61.03,investment_income,in,Counterparty_78,21118380.58,,
2025-06-26,1684.96,refund,in,Counterparty_50,21120065.54,,
2025-06-26,4521.02,refund,in,Counterparty_71,21124586.56,,
2025-06-26,2083.59,tax_payment,out,Counterparty_16,21122502.97,2025-05-28,2025-06-29
2025-06-26,645.9,investment_income,in,Counterparty_11,21123148.87,,
2025-06-26,3664.84,investment_income,in,Counterparty_37,21126813.71,,
2025-06-26,1244.0,credit,in,Counterparty_69,21128057.71,,
2025-06-26,2728.53,customer_payment,in,Counterparty_64,21130786.24,,
2025-06-26,3616.02,loan_repayment,out,Counterparty_70,21127170.22,2025-06-03,2025-07-01
2025-06-26,619.19,customer_payment,in,Counterparty_77,21127789.41,,
2025-06-27,7786.88,asset_sale,in,Counterparty_1,21135576.29,,
2025-06-27,1211.02,credit,in,Counterparty_24,21136787.31,,
2025-06-27,3953.44,tax_payment,out,Counterparty_99,21132833.87,2025-05-26,2025-06-25
2025-06-27,489.47,rent,out,Counterparty_25,21132344.4,2025-06-03,2025-07-07
2025-06-27,4168.95,loan_repayment,out,Counterparty_2,21128175.45,2025-05-25,2025-06-19
2025-06-27,56.52,refund,in,Counterparty_52,21128231.97,,
2025-06-27,6520.33,software_subscription,out,Counterparty_35,21121711.64,2025-05-28,2025-07-01
2025-06-27,242.2,utilities,out,Counterparty_62,21121469.44,2025-05-24,2025-06-21
2025-06-27,2882.21,T&E,out,Counterparty_58,21118587.23,2025-05-25,2025-06-26
2025-06-27,10447.61,customer_payment,in,Counterparty_40,21129034.84,,
2025-06-27,6037.99,utilities,out,Counterparty_63,21122996.85,2025-05-21,2025-06-26
2025-06-27,985.67,T&E,out,Counterparty_12,21122011.18,2025-06-12,2025-07-08
2025-06-27,95.1,asset_sale,in,Counterparty_14,21122106.28,,
2025-06-27,460.96,credit,in,Counterparty_2,21122567.24,,
2025-06-27,3782.31,investment_income,in,Counterparty_42,21126349.55,,
2025-06-27,1818.42,utilities,out,Counterparty_85,21124531.13,2025-05-25,2025-06-25
2025-06-27,2366.82,credit,in,Counterparty_99,21126897.95,,
2025-06-27,4404.11,marketing_spend,out,Counterparty_67,21122493.84,2025-06-05,2025-07-02
2025-06-27,8480.28,credit,in,Counterparty_22,21130974.12,,
2025-06-27,2941.13,loan_repayment,out,Counterparty_42,21128032.99,2025-06-01,2025-07-03
2025-06-27,814.31,marketing_spend,out,Counterparty_57,21127218.68,2025-05-30,2025-06-27
2025-06-27,2082.54,supplier_payment,out,Counterparty_27,21125136.14,2025-05-28,2025-07-01
2025-06-27,4670.62,refund,in,Counterparty_8,21129806.76,,
2025-06-27,8683.78,utilities,out,Counterparty_31,21121122.98,2025-06-03,2025-07-04
2025-06-27,1430.94,credit,in,Counterparty_68,21122553.92,,
2025-06-27,8364.62,refund,in,Counterparty_1,21130918.54,,
2025-06-27,1792.67,rent,out,Counterparty_83,21129125.87,2025-06-01,2025-06-29
2025-06-27,0.04,T&E,out,Counterparty_99,21129125.83,2025-05-26,2025-06-30
2025-06-27,3385.99,refund,in,Counterparty_95,21132511.82,,
2025-06-27,1717.36,loan_repayment,out,Counterparty_83,21130794.46,2025-06-07,2025-07-12
2025-06-27,4835.94,marketing_spend,out,Counterparty_85,21125958.52,2025-05-26,2025-06-28
2025-06-27,1089.52,asset_sale,in,Counterparty_28,21127048.04,,
2025-06-27,4414.28,customer_payment,in,Counterparty_32,21131462.32,,
2025-06-27,6558.87,supplier_payment,out,Counterparty_89,21124903.45,2025-05-29,2025-06-26
2025-06-27,8789.75,software_subscription,out,Counterparty_49,21116113.7,2025-06-11,2025-07-17
2025-06-27,447.57,refund,in,Counterparty_76,21116561.27,,
2025-06-27,980.12,credit,in,Counterparty_96,21117541.39,,
2025-06-27,46.4,utilities,out,Counterparty_7,21117494.99,2025-05-18,2025-06-22
2025-06-27,3163.23,credit,in,Counterparty_26,21120658.22,,
2025-06-27,3975.85,customer_payment,in,Counterparty_74,21124634.07,,
2025-06-27,4186.22,refund,in,Counterparty_42,21128820.29,,
2025-06-27,7087.56,investment_income,in,Counterparty_5,21135907.85,,
2025-06-27,2841.03,utilities,out,Counterparty_21,21133066.82,2025-06-10,2025-07-13
2025-06-27,5983.55,marketing_spend,out,Counterparty_79,21127083.27,2025-06-07,2025-07-12
2025-06-27,990.01,investment_income,in,Counterparty_32,21128073.28,,
2025-06-27,700.79,T&E,out,Counterparty_91,21127372.49,2025-05-16,2025-06-17
2025-06-27,8121.95,rent,out,Counterparty_20,21119250.54,2025-05-29,2025-06-25
2025-06-27,514.82,credit,in,Counterparty_80,21119765.36,,
2025-06-27,2608.62,customer_payment,in,Counterparty_90,21122373.98,,
2025-06-27,14085.14,supplier_payment,out,Counterparty_72,21108288.84,2025-06-06,2025-07-08
2025-06-27,1657.6,asset_sale,in,Counterparty_27,21109946.44,,
2025-06-27,3717.47,rent,out,Counterparty_90,21106228.97,2025-06-06,2025-07-06
2025-06-27,92.22,supplier_payment,out,Counterparty_78,21106136.75,2025-05-16,2025-06-19
2025-06-27,1549.25,customer_payment,in,Counterparty_88,21107686.0,,
2025-06-27,704.94,customer_payment,in,Counterparty_68,21108390.94,,
2025-06-27,2748.5,tax_payment,out,Counterparty_47,21105642.44,2025-06-04,2025-07-07
2025-06-27,2394.51,software_subscription,out,Counterparty_41,21103247.93,2025-06-01,2025-07-04
2025-06-27,1263.9,investment_income,in,Counterparty_7,21104511.83,,
2025-06-27,2328.18,credit,in,Counterparty_29,21106840.01,,
2025-06-27,5683.69,asset_sale,in,Counterparty_85,21112523.7,,
2025-06-28,3698.32,rent,out,Counterparty_26,21108825.38,2025-06-10,2025-07-17
2025-06-28,1125.77,investment_income,in,Counterparty_2,21109951.15,,
2025-06-28,974.58,credit,in,Counterparty_57,21110925.73,,
2025-06-28,1075.88,software_subscription,out,Counterparty_33,21109849.85,2025-06-04,2025-07-06
2025-06-28,1299.58,utilities,out,Counterparty_40,21108550.27,2025-05-28,2025-06-30
2025-06-28,3307.62,credit,in,Counterparty_19,21111857.89,,
2025-06-28,7258.9,payroll,out,Counterparty_6,21104598.99,2025-05-19,2025-06-21
2025-06-28,1025.2,refund,in,Counterparty_13,21105624.19,,
2025-06-28,170.52,investment_income,in,Counterparty_83,21105794.71,,
2025-06-28,1132.43,tax_payment,out,Counterparty_39,21104662.28,2025-05-31,2025-06-26
2025-06-28,1044.34,refund,in,Counterparty_12,21105706.62,,
2025-06-28,366.28,T&E,out,Counterparty_15,21105340.34,2025-06-10,2025-07-08
2025-06-28,63.32,investment_income,in,Counterparty_97,21105403.66,,
2025-06-28,3638.05,payroll,out,Counterparty_94,21101765.61,2025-05-20,2025-06-20
2025-06-28,77.89,customer_payment,in,Counterparty_48,21101843.5,,
2025-06-28,533.57,refund,in,Counterparty_38,21102377.07,,
2025-06-28,580.12,software_subscription,out,Counterparty_12,21101796.95,2025-06-10,2025-07-13
2025-06-28,8048.64,rent,out,Counterparty_81,21093748.31,2025-06-12,2025-07-12
2025-06-28,9087.83,tax_payment,out,Counterparty_22,21084660.48,2025-06-01,2025-07-09
2025-06-28,1321.86,payroll,out,Counterparty_12,21083338.62,2025-05-22,2025-06-26
2025-06-28,5940.83,refund,in,Counterparty_23,21089279.45,,
2025-06-28,1391.04,loan_repayment,out,Counterparty_5,21087888.41,2025-05-24,2025-06-19
2025-06-28,1967.14,supplier_payment,out,Counterparty_49,21085921.27,2025-06-12,2025-07-16
2025-06-28,537.96,investment_income,in,Counterparty_61,21086459.23,,
2025-06-28,3745.56,refund,in,Counterparty_49,21090204.79,,
2025-06-28,6016.83,utilities,out,Counterparty_94,21084187.96,2025-05-29,2025-06-27
2025-06-28,2505.51,supplier_payment,out,Counterparty_50,21081682.45,2025-05-18,2025-06-25
2025-06-28,475.06,investment_income,in,Counterparty_66,21082157.51,,
2025-06-28,795.31,T&E,out,Counterparty_65,21081362.2,2025-05-31,2025-06-30
2025-06-28,3074.83,payroll,out,Counterparty_13,21078287.37,2025-05-19,2025-06-18
2025-06-28,1792.03,customer_payment,in,Counterparty_1,21080079.4,,
2025-06-28,6988.23,supplier_payment,out,Counterparty_89,21073091.17,2025-06-04,2025-07-05
2025-06-28,8473.08,software_subscription,out,Counterparty_36,21064618.09,2025-06-13,2025-07-11
2025-06-28,339.35,loan_repayment,out,Counterparty_34,21064278.74,2025-06-06,2025-07-15
2025-06-28,4649.68,asset_sale,in,Counterparty_64,21068928.42,,
2025-06-28,552.52,refund,in,Counterparty_64,21069480.94,,
2025-06-28,3662.95,supplier_payment,out,Counterparty_66,21065817.99,2025-06-10,2025-07-09
2025-06-28,6544.23,marketing_spend,out,Counterparty_11,21059273.76,2025-05-21,2025-06-16
2025-06-28,2810.44,loan_repayment,out,Counterparty_2,21056463.32,2025-06-12,2025-07-14
2025-06-28,723.59,customer_payment,in,Counterparty_19,21057186.91,,
2025-06-28,1236.9,software_subscription,out,Counterparty_20,21055950.01,2025-06-11,2025-07-10
2025-06-28,3197.53,investment_income,in,Counterparty_21,21059147.54,,
2025-06-28,9.5,tax_payment,out,Counterparty_15,21059138.04,2025-06-02,2025-07-11
2025-06-28,1669.2,tax_payment,out,Counterparty_75,21057468.84,2025-05-21,2025-06-18
2025-06-28,1603.98,T&E,out,Counterparty_95,21055864.86,2025-05-19,2025-06-27
2025-06-28,2696.99,investment_income,in,Counterparty_99,21058561.85,,
2025-06-28,118.43,asset_sale,in,Counterparty_89,21058680.28,,
2025-06-28,3353.65,tax_payment,out,Counterparty_63,21055326.63,2025-05-31,2025-07-02
2025-06-28,3234.95,investment_income,in,Counterparty_16,21058561.58,,
2025-06-28,1528.3,investment_income,in,Counterparty_11,21060089.88,,
2025-06-28,10800.57,asset_sale,in,Counterparty_8,21070890.45,,
2025-06-28,2120.61,tax_payment,out,Counterparty_30,21068769.84,2025-06-06,2025-07-02
2025-06-28,1524.68,rent,out,Counterparty_44,21067245.16,2025-06-05,2025-07-06
2025-06-28,7190.87,T&E,out,Counterparty_57,21060054.29,2025-06-08,2025-07-16
2025-06-28,6215.06,customer_payment,in,Counterparty_88,21066269.35,,
2025-06-28,1932.14,loan_repayment,out,Counterparty_61,21064337.21,2025-06-02,2025-06-27
2025-06-28,794.74,T&E,out,Counterparty_1,21063542.47,2025-06-13,2025-07-11
2025-06-28,718.4,software_subscription,out,Counterparty_93,21062824.07,2025-05-15,2025-06-11
2025-06-28,460.27,tax_payment,out,Counterparty_84,21062363.8,2025-06-13,2025-07-20
2025-06-28,5915.38,supplier_payment,out,Counterparty_29,21056448.42,2025-05-19,2025-06-13
2025-06-28,2191.19,credit,in,Counterparty_24,21058639.61,,
2025-06-28,1767.63,asset_sale,in,Counterparty_99,21060407.24,,
2025-06-28,3755.67,rent,out,Counterparty_67,21056651.57,2025-06-02,2025-07-02
2025-06-28,3376.81,T&E,out,Counterparty_12,21053274.76,2025-06-11,2025-07-10
2025-06-28,60.55,investment_income,in,Counterparty_62,21053335.31,,
2025-06-28,3321.47,credit,in,Counterparty_49,21056656.78,,
2025-06-28,3248.35,loan_repayment,out,Counterparty_92,21053408.43,2025-05-16,2025-06-15
2025-06-28,3084.5,marketing_spend,out,Counterparty_53,21050323.93,2025-05-24,2025-06-22
2025-06-28,2812.28,refund,in,Counterparty_56,21053136.21,,
2025-06-28,4721.14,T&E,out,Counterparty_22,21048415.07,2025-06-04,2025-07-01
2025-06-28,365.02,supplier_payment,out,Counterparty_3,21048050.05,2025-05-19,2025-06-25
2025-06-28,230.43,payroll,out,Counterparty_24,21047819.62,2025-05-17,2025-06-22
2025-06-28,975.71,credit,in,Counterparty_54,21048795.33,,
2025-06-29,4470.21,T&E,out,Counterparty_98,21044325.12,2025-06-14,2025-07-15
2025-06-29,7070.34,utilities,out,Counterparty_18,21037254.78,2025-06-07,2025-07-11
2025-06-29,1178.45,software_subscription,out,Counterparty_90,21036076.33,2025-05-28,2025-07-03
2025-06-29,410.65,software_subscription,out,Counterparty_60,21035665.68,2025-06-04,2025-07-05
2025-06-29,390.27,payroll,out,Counterparty_75,21035275.41,2025-06-10,2025-07-14
2025-06-29,1565.5,customer_payment,in,Counterparty_44,21036840.91,,
2025-06-29,1604.16,marketing_spend,out,Counterparty_36,21035236.75,2025-05-26,2025-07-01
2025-06-29,3604.17,asset_sale,in,Counterparty_53,21038840.92,,
2025-06-29,1223.86,refund,in,Counterparty_14,21040064.78,,
2025-06-29,1120.89,T&E,out,Counterparty_22,21038943.89,2025-05-23,2025-06-22
2025-06-29,855.51,payroll,out,Counterparty_60,21038088.38,2025-05-17,2025-06-11
2025-06-29,1145.72,credit,in,Counterparty_24,21039234.1,,
2025-06-29,10353.63,rent,out,Counterparty_60,21028880.47,2025-05-28,2025-06-22
2025-06-29,1368.48,asset_sale,in,Counterparty_39,21030248.95,,
2025-06-29,1171.44,software_subscription,out,Counterparty_82,21029077.51,2025-05-21,2025-06-27
2025-06-29,1329.44,asset_sale,in,Counterparty_41,21030406.95,,
2025-06-29,2247.71,tax_payment,out,Counterparty_97,21028159.24,2025-05-17,2025-06-11
2025-06-29,621.4,customer_payment,in,Counterparty_54,21028780.64,,
2025-06-29,4777.04,payroll,out,Counterparty_76,21024003.6,2025-05-26,2025-06-20
2025-06-29,2306.55,supplier_payment,out,Counterparty_68,21021697.05,2025-05-26,2025-07-03
2025-06-29,169.31,T&E,out,Counterparty_17,21021527.74,2025-05-22,2025-06-25
2025-06-29,7209.66,credit,in,Counterparty_39,21028737.4,,
2025-06-29,1307.14,loan_repayment,out,Counterparty_66,21027430.26,2025-06-10,2025-07-05
2025-06-29,741.06,refund,in,Counterparty_32,21028171.32,,
2025-06-29,1464.37,credit,in,Counterparty_57,21029635.69,,
2025-06-29,5664.1,customer_payment,in,Counterparty_92,21035299.79,,
2025-06-29,1896.24,payroll,out,Counterparty_28,21033403.55,2025-06-04,2025-07-06
2025-06-29,2970.79,credit,in,Counterparty_93,21036374.34,,
2025-06-29,4005.66,customer_payment,in,Counterparty_10,21040380.0,,
2025-06-29,587.22,investment_income,in,Counterparty_27,21040967.22,,
2025-06-29,2811.1,utilities,out,Counterparty_29,21038156.12,2025-05-19,2025-06-23
2025-06-29,2036.1,T&E,out,Counterparty_63,21036120.02,2025-05-23,2025-06-21
2025-06-29,982.27,T&E,out,Counterparty_93,21035137.75,2025-05-20,2025-06-27
2025-06-29,562.07,investment_income,in,Counterparty_95,21035699.82,,
2025-06-29,691.21,asset_sale,in,Counterparty_76,21036391.03,,
2025-06-29,488.7,T&E,out,Counterparty_35,21035902.33,2025-05-26,2025-06-28
2025-06-29,1081.17,rent,out,Counterparty_65,21034821.16,2025-05-18,2025-06-26
2025-06-29,975.0,payroll,out,Counterparty_43,21033846.16,2025-05-22,2025-06-29
2025-06-29,4915.23,customer_payment,in,Counterparty_44,21038761.39,,
2025-06-29,4175.87,payroll,out,Counterparty_60,21034585.52,2025-06-07,2025-07-14
2025-06-29,912.83,credit,in,Counterparty_12,21035498.35,,
2025-06-29,1041.51,credit,in,Counterparty_93,21036539.86,,
2025-06-29,1301.15,investment_income,in,Counterparty_82,21037841.01,,
2025-06-29,472.07,utilities,out,Counterparty_99,21037368.94,2025-06-11,2025-07-19
2025-06-29,606.05,asset_sale,in,Counterparty_92,21037974.99,,
2025-06-29,572.48,software_subscription,out,Counterparty_31,21037402.51,2025-06-02,2025-06-29
2025-06-29,1332.22,T&E,out,Counterparty_50,21036070.29,2025-05-21,2025-06-24
2025-06-29,1138.58,rent,out,Counterparty_8,21034931.71,2025-05-30,2025-06-24
2025-06-29,381.11,customer_payment,in,Counterparty_39,21035312.82,,
2025-06-29,143.45,tax_payment,out,Counterparty_20,21035169.37,2025-06-05,2025-07-12
2025-06-29,4286.4,T&E,out,Counterparty_12,21030882.97,2025-06-07,2025-07-07
2025-06-29,2219.83,payroll,out,Counterparty_11,21028663.14,2025-06-06,2025-07-05
2025-06-30,5228.48,loan_repayment,out,Counterparty_32,21023434.66,2025-05-18,2025-06-24
2025-06-30,779.87,refund,in,Counterparty_97,21024214.53,,
2025-06-30,4027.26,tax_payment,out,Counterparty_23,21020187.27,2025-05-22,2025-06-18
2025-06-30,6857.63,software_subscription,out,Counterparty_34,21013329.64,2025-05-19,2025-06-26
2025-06-30,772.18,asset_sale,in,Counterparty_38,21014101.82,,
2025-06-30,3283.72,refund,in,Counterparty_89,21017385.54,,
2025-06-30,2736.62,loan_repayment,out,Counterparty_32,21014648.92,2025-05-24,2025-06-21
2025-06-30,595.01,marketing_spend,out,Counterparty_85,21014053.91,2025-05-21,2025-06-18
2025-06-30,6106.09,rent,out,Counterparty_30,21007947.82,2025-05-20,2025-06-22
2025-06-30,384.88,refund,in,Counterparty_9,21008332.7,,
2025-06-30,896.87,utilities,out,Counterparty_22,21007435.83,2025-06-15,2025-07-19
2025-06-30,10103.79,utilities,out,Counterparty_7,20997332.04,2025-05-28,2025-06-30
2025-06-30,2476.57,refund,in,Counterparty_58,20999808.61,,
2025-06-30,2809.5,marketing_spend,out,Counterparty_92,20996999.11,2025-06-02,2025-07-08
2025-06-30,1894.43,customer_payment,in,Counterparty_60,20998893.54,,
2025-06-30,5632.3,refund,in,Counterparty_17,21004525.84,,
2025-06-30,3052.37,investment_income,in,Counterparty_80,21007578.21,,
2025-06-30,971.66,T&E,out,Counterparty_57,21006606.55,2025-06-02,2025-07-05
2025-06-30,4948.86,software_subscription,out,Counterparty_43,21001657.69,2025-05-19,2025-06-13
2025-06-30,1788.37,tax_payment,out,Counterparty_66,20999869.32,2025-05-30,2025-06-24
2025-06-30,9417.47,customer_payment,in,Counterparty_40,21009286.79,,
2025-06-30,2612.96,payroll,out,Counterparty_60,21006673.83,2025-06-08,2025-07-12
2025-06-30,240.79,asset_sale,in,Counterparty_94,21006914.62,,
2025-06-30,21.76,T&E,out,Counterparty_81,21006892.86,2025-05-20,2025-06-21
2025-06-30,6682.32,payroll,out,Counterparty_12,21000210.54,2025-06-13,2025-07-08
2025-06-30,4399.29,asset_sale,in,Counterparty_88,21004609.83,,
2025-06-30,536.01,credit,in,Counterparty_76,21005145.84,,
2025-06-30,2717.52,investment_income,in,Counterparty_14,21007863.36,,
2025-06-30,691.47,tax_payment,out,Counterparty_84,21007171.89,2025-05-20,2025-06-21
2025-06-30,1653.36,tax_payment,out,Counterparty_89,21005518.53,2025-05-18,2025-06-25
2025-06-30,5958.95,investment_income,in,Counterparty_97,21011477.48,,
2025-06-30,2009.72,marketing_spend,out,Counterparty_14,21009467.76,2025-05-29,2025-06-23
2025-06-30,13589.9,supplier_payment,out,Counterparty_79,20995877.86,2025-05-31,2025-07-07
2025-06-30,101.73,customer_payment,in,Counterparty_2,20995979.59,,
2025-06-30,1379.02,asset_sale,in,Counterparty_43,20997358.61,,
2025-06-30,3616.02,tax_payment,out,Counterparty_55,20993742.59,2025-05-25,2025-06-20
2025-06-30,2895.64,customer_payment,in,Counterparty_31,20996638.23,,
2025-06-30,2883.6,payroll,out,Counterparty_44,20993754.63,2025-05-23,2025-06-25
2025-06-30,2286.27,supplier_payment,out,Counterparty_3,20991468.36,2025-06-14,2025-07-09
2025-06-30,2584.97,credit,in,Counterparty_44,20994053.33,,
2025-06-30,5086.57,customer_payment,in,Counterparty_2,20999139.9,,
2025-06-30,3981.18,customer_payment,in,Counterparty_65,21003121.08,,
2025-06-30,160.55,loan_repayment,out,Counterparty_39,21002960.53,2025-06-10,2025-07-16
2025-06-30,1949.7,asset_sale,in,Counterparty_22,21004910.23,,
2025-06-30,4509.67,payroll,out,Counterparty_54,21000400.56,2025-06-08,2025-07-17
2025-06-30,4026.77,refund,in,Counterparty_79,21004427.33,,
2025-06-30,1937.97,utilities,out,Counterparty_72,21002489.36,2025-06-05,2025-07-13
2025-06-30,738.07,software_subscription,out,Counterparty_90,21001751.29,2025-06-07,2025-07-16
2025-06-30,547.79,refund,in,Counterparty_68,21002299.08,,
2025-06-30,2824.24,payroll,out,Counterparty_56,20999474.84,2025-05-21,2025-06-21
2025-06-30,3465.13,asset_sale,in,Counterparty_77,21002939.97,,
2025-06-30,1379.75,asset_sale,in,Counterparty_11,21004319.72,,
2025-06-30,895.3,payroll,out,Counterparty_26,21003424.42,2025-06-14,2025-07-21
2025-06-30,825.94,customer_payment,in,Counterparty_46,21004250.36,,
2025-06-30,1421.72,payroll,out,Counterparty_9,21002828.64,2025-06-03,2025-07-12
2025-06-30,377.63,supplier_payment,out,Counterparty_92,21002451.01,2025-05-22,2025-06-23
2025-06-30,1068.4,supplier_payment,out,Counterparty_81,21001382.61,2025-05-18,2025-06-14
2025-07-01,17732.05,software_subscription,out,Counterparty_41,20983650.56,2025-06-11,2025-07-19
2025-07-01,5651.21,refund,in,Counterparty_36,20989301.77,,
2025-07-01,10.46,credit,in,Counterparty_94,20989312.23,,
2025-07-01,7211.97,credit,in,Counterparty_8,20996524.2,,
2025-07-01,229.24,investment_income,in,Counterparty_64,20996753.44,,
2025-07-01,2264.32,tax_payment,out,Counterparty_62,20994489.12,2025-06-02,2025-06-30
2025-07-01,2550.87,credit,in,Counterparty_67,20997039.99,,
2025-07-01,6315.19,marketing_spend,out,Counterparty_78,20990724.8,2025-05-18,2025-06-23
2025-07-01,7591.39,T&E,out,Counterparty_91,20983133.41,2025-06-09,2025-07-16
2025-07-01,2691.85,asset_sale,in,Counterparty_33,20985825.26,,
2025-07-01,5874.64,rent,out,Counterparty_32,20979950.62,2025-05-27,2025-06-25
2025-07-01,1664.58,supplier_payment,out,Counterparty_1,20978286.04,2025-05-19,2025-06-14
2025-07-01,3743.77,tax_payment,out,Counterparty_62,20974542.27,2025-06-12,2025-07-14
2025-07-01,1758.5,utilities,out,Counterparty_39,20972783.77,2025-05-25,2025-07-02
2025-07-01,486.78,utilities,out,Counterparty_35,20972296.99,2025-05-28,2025-06-23
2025-07-01,293.8,utilities,out,Counterparty_62,20972003.19,2025-05-28,2025-06-26
2025-07-01,674.93,loan_repayment,out,Counterparty_53,20971328.26,2025-06-12,2025-07-11
2025-07-01,324.88,payroll,out,Counterparty_41,20971003.38,2025-05-24,2025-07-02
2025-07-01,742.65,loan_repayment,out,Counterparty_1,20970260.73,2025-05-19,2025-06-26
2025-07-01,4380.49,software_subscription,out,Counterparty_38,20965880.24,2025-05-26,2025-06-28
2025-07-01,3053.81,marketing_spend,out,Counterparty_77,20962826.43,2025-06-06,2025-07-05
2025-07-01,2687.82,T&E,out,Counterparty_66,20960138.61,2025-06-15,2025-07-14
2025-07-01,1624.45,payroll,out,Counterparty_70,20958514.16,2025-06-13,2025-07-19
2025-07-01,5912.5,supplier_payment,out,Counterparty_43,20952601.66,2025-06-05,2025-07-06
2025-07-01,8522.02,investment_income,in,Counterparty_15,20961123.68,,
2025-07-01,7089.52,supplier_payment,out,Counterparty_26,20954034.16,2025-05-25,2025-06-30
2025-07-01,8445.9,utilities,out,Counterparty_86,20945588.26,2025-06-01,2025-07-05
2025-07-01,5314.52,credit,in,Counterparty_98,20950902.78,,
2025-07-01,3222.94,customer_payment,in,Counterparty_99,20954125.72,,
2025-07-01,5222.79,customer_payment,in,Counterparty_37,20959348.51,,
2025-07-01,3565.25,refund,in,Counterparty_11,20962913.76,,
2025-07-01,4360.59,rent,out,Counterparty_27,20958553.17,2025-05-27,2025-06-24
2025-07-01,15861.17,customer_payment,in,Counterparty_94,20974414.34,,
2025-07-01,10098.65,asset_sale,in,Counterparty_78,20984512.99,,
2025-07-01,5718.93,investment_income,in,Counterparty_31,20990231.92,,
2025-07-01,359.03,investment_income,in,Counterparty_15,20990590.95,,
2025-07-01,98.13,payroll,out,Counterparty_92,20990492.82,2025-06-09,2025-07-05
2025-07-01,2129.59,refund,in,Counterparty_59,20992622.41,,
2025-07-01,3538.4,customer_payment,in,Counterparty_30,20996160.81,,
2025-07-01,9247.07,customer_payment,in,Counterparty_13,21005407.88,,
2025-07-01,6379.78,asset_sale,in,Counterparty_40,21011787.66,,
2025-07-01,442.41,asset_sale,in,Counterparty_99,21012230.07,,
2025-07-01,3073.58,software_subscription,out,Counterparty_83,21009156.49,2025-05-26,2025-06-21
2025-07-01,6042.77,tax_payment,out,Counterparty_16,21003113.72,2025-06-04,2025-07-06
2025-07-01,1330.72,supplier_payment,out,Counterparty_40,21001783.0,2025-05-20,2025-06-15
2025-07-01,6753.45,refund,in,Counterparty_14,21008536.45,,
2025-07-02,6628.7,marketing_spend,out,Counterparty_29,21001907.75,2025-06-09,2025-07-11
2025-07-02,3906.45,marketing_spend,out,Counterparty_22,20998001.3,2025-06-08,2025-07-15
2025-07-02,10014.86,software_subscription,out,Counterparty_93,20987986.44,2025-05-21,2025-06-27
2025-07-02,3211.54,customer_payment,in,Counterparty_80,20991197.98,,
2025-07-02,2917.92,marketing_spend,out,Counterparty_89,20988280.06,2025-06-01,2025-07-09
2025-07-02,973.68,investment_income,in,Counterparty_30,20989253.74,,
2025-07-02,41.02,payroll,out,Counterparty_50,20989212.72,2025-05-25,2025-06-28
2025-07-02,3321.49,customer_payment,in,Counterparty_95,20992534.21,,
2025-07-02,2639.64,T&E,out,Counterparty_68,20989894.57,2025-06-12,2025-07-19
2025-07-02,539.83,loan_repayment,out,Counterparty_18,20989354.74,2025-06-16,2025-07-14
2025-07-02,5149.61,T&E,out,Counterparty_17,20984205.13,2025-06-04,2025-07-03
2025-07-02,2296.08,tax_payment,out,Counterparty_92,20981909.05,2025-05-19,2025-06-20
2025-07-02,489.4,payroll,out,Counterparty_95,20981419.65,2025-06-11,2025-07-19
2025-07-02,306.6,asset_sale,in,Counterparty_38,20981726.25,,
2025-07-02,426.48,credit,in,Counterparty_24,20982152.73,,
2025-07-02,3551.33,refund,in,Counterparty_4,20985704.06,,
2025-07-02,2335.76,refund,in,Counterparty_4,20988039.82,,
2025-07-02,3867.29,customer_payment,in,Counterparty_16,20991907.11,,
2025-07-02,11914.79,asset_sale,in,Counterparty_42,21003821.9,,
2025-07-02,11504.5,customer_payment,in,Counterparty_57,21015326.4,,
2025-07-02,3639.97,refund,in,Counterparty_86,21018966.37,,
2025-07-02,490.83,asset_sale,in,Counterparty_36,21019457.2,,
2025-07-02,3421.97,investment_income,in,Counterparty_42,21022879.17,,
2025-07-02,2837.24,asset_sale,in,Counterparty_69,21025716.41,,
2025-07-02,6714.37,asset_sale,in,Counterparty_60,21032430.78,,
2025-07-02,450.93,investment_income,in,Counterparty_62,21032881.71,,
2025-07-02,593.28,software_subscription,out,Counterparty_94,21032288.43,2025-05-27,2025-06-22
2025-07-02,11850.92,software_subscription,out,Counterparty_8,21020437.51,2025-05-31,2025-06-29
2025-07-02,3385.26,marketing_spend,out,Counterparty_30,21017052.25,2025-05-24,2025-06-23
2025-07-02,3879.67,credit,in,Counterparty_56,21020931.92,,
2025-07-02,3644.57,customer_payment,in,Counterparty_5,21024576.49,,
2025-07-02,997.67,asset_sale,in,Counterparty_62,21025574.16,,
2025-07-02,2904.24,rent,out,Counterparty_43,21022669.92,2025-06-07,2025-07-09
2025-07-02,181.49,payroll,out,Counterparty_21,21022488.43,2025-06-04,2025-07-08
2025-07-02,341.41,loan_repayment,out,Counterparty_17,21022147.02,2025-06-14,2025-07-11
2025-07-02,366.97,asset_sale,in,Counterparty_27,21022513.99,,
2025-07-02,2651.56,tax_payment,out,Counterparty_63,21019862.43,2025-05-23,2025-06-30
2025-07-02,2752.28,loan_repayment,out,Counterparty_93,21017110.15,2025-06-04,2025-07-01
2025-07-02,1468.83,T&E,out,Counterparty_85,21015641.32,2025-06-01,2025-06-28
2025-07-02,333.44,tax_payment,out,Counterparty_48,21015307.88,2025-06-12,2025-07-21
2025-07-02,1002.64,T&E,out,Counterparty_38,21014305.24,2025-05-27,2025-07-05
2025-07-02,2074.61,T&E,out,Counterparty_59,21012230.63,2025-06-13,2025-07-15
2025-07-02,4598.13,software_subscription,out,Counterparty_21,21007632.5,2025-05-23,2025-06-30
2025-07-02,4484.54,tax_payment,out,Counterparty_12,21003147.96,2025-05-25,2025-06-30
2025-07-02,953.89,supplier_payment,out,Counterparty_86,21002194.07,2025-05-20,2025-06-20
2025-07-02,1275.26,software_subscription,out,Counterparty_76,21000918.81,2025-05-25,2025-06-30
2025-07-02,10507.0,supplier_payment,out,Counterparty_23,20990411.81,2025-06-02,2025-06-28
2025-07-02,6872.55,supplier_payment,out,Counterparty_40,20983539.26,2025-05-19,2025-06-18
2025-07-02,2617.91,supplier_payment,out,Counterparty_46,20980921.35,2025-06-16,2025-07-18
2025-07-02,1618.64,asset_sale,in,Counterparty_89,20982539.99,,
2025-07-02,9081.12,software_subscription,out,Counterparty_18,20973458.87,2025-05-28,2025-07-04
2025-07-03,9146.84,rent,out,Counterparty_86,20964312.03,2025-06-17,2025-07-24
2025-07-03,19392.61,loan_repayment,out,Counterparty_14,20944919.42,2025-05-21,2025-06-29
2025-07-03,10126.83,utilities,out,Counterparty_23,20934792.59,2025-06-07,2025-07-05
2025-07-03,7945.56,payroll,out,Counterparty_1,20926847.03,2025-06-03,2025-07-08
2025-07-03,2330.48,asset_sale,in,Counterparty_17,20929177.51,,
2025-07-03,1824.24,refund,in,Counterparty_49,20931001.75,,
2025-07-03,4198.48,asset_sale,in,Counterparty_59,20935200.23,,
2025-07-03,4761.63,payroll,out,Counterparty_78,20930438.6,2025-05-21,2025-06-29
2025-07-03,58.74,asset_sale,in,Counterparty_58,20930497.34,,
2025-07-03,289.25,payroll,out,Counterparty_59,20930208.09,2025-05-22,2025-06-27
2025-07-03,376.96,credit,in,Counterparty_98,20930585.05,,
2025-07-03,7874.82,credit,in,Counterparty_37,20938459.87,,
2025-07-03,4994.63,marketing_spend,out,Counterparty_5,20933465.24,2025-05-21,2025-06-24
2025-07-03,2478.48,T&E,out,Counterparty_62,20930986.76,2025-06-02,2025-07-07
2025-07-03,2456.92,T&E,out,Counterparty_57,20928529.84,2025-05-21,2025-06-17
2025-07-03,5811.92,software_subscription,out,Counterparty_22,20922717.92,2025-06-10,2025-07-05
2025-07-03,5432.65,marketing_spend,out,Counterparty_24,20917285.27,2025-05-24,2025-06-30
2025-07-03,1542.08,investment_income,in,Counterparty_19,20918827.35,,
2025-07-03,2398.38,refund,in,Counterparty_78,20921225.73,,
2025-07-03,78.49,credit,in,Counterparty_11,20921304.22,,
2025-07-03,6731.13,rent,out,Counterparty_29,20914573.09,2025-05-31,2025-07-06
2025-07-03,4731.68,payroll,out,Counterparty_6,20909841.41,2025-06-12,2025-07-19
2025-07-03,11147.72,marketing_spend,out,Counterparty_52,20898693.69,2025-06-18,2025-07-26
2025-07-03,4818.37,refund,in,Counterparty_8,20903512.06,,
2025-07-03,1486.19,T&E,out,Counterparty_95,20902025.87,2025-05-30,2025-07-01
2025-07-03,11564.67,investment_income,in,Counterparty_92,20913590.54,,
2025-07-03,2424.95,software_subscription,out,Counterparty_44,20911165.59,2025-06-06,2025-07-13
2025-07-03,1302.54,credit,in,Counterparty_83,20912468.13,,
2025-07-03,2807.66,utilities,out,Counterparty_87,20909660.47,2025-06-18,2025-07-23
2025-07-03,979.54,asset_sale,in,Counterparty_25,20910640.01,,
2025-07-03,7102.15,marketing_spend,out,Counterparty_19,20903537.86,2025-05-21,2025-06-17
2025-07-03,1763.47,T&E,out,Counterparty_80,20901774.39,2025-06-15,2025-07-24
2025-07-03,1498.88,investment_income,in,Counterparty_85,20903273.27,,
2025-07-03,23829.65,T&E,out,Counterparty_11,20879443.62,2025-06-14,2025-07-12
2025-07-03,5470.72,utilities,out,Counterparty_86,20873972.9,2025-06-17,2025-07-18
2025-07-03,4537.87,asset_sale,in,Counterparty_45,20878510.77,,
2025-07-03,4909.73,investment_income,in,Counterparty_22,20883420.5,,
2025-07-03,8038.04,customer_payment,in,Counterparty_17,20891458.54,,
2025-07-03,603.61,credit,in,Counterparty_42,20892062.15,,
2025-07-03,945.92,customer_payment,in,Counterparty_80,20893008.07,,
2025-07-04,273.97,asset_sale,in,Counterparty_11,20893282.04,,
2025-07-04,5500.46,credit,in,Counterparty_88,20898782.5,,
2025-07-04,10663.11,refund,in,Counterparty_7,20909445.61,,
2025-07-04,2402.49,credit,in,Counterparty_14,20911848.1,,
2025-07-04,1928.33,investment_income,in,Counterparty_30,20913776.43,,
2025-07-04,12221.89,asset_sale,in,Counterparty_86,20925998.32,,
2025-07-04,377.83,refund,in,Counterparty_75,20926376.15,,
2025-07-04,1603.46,credit,in,Counterparty_18,20927979.61,,
2025-07-04,1076.69,credit,in,Counterparty_79,20929056.3,,
2025-07-04,216.74,payroll,out,Counterparty_87,20928839.56,2025-06-13,2025-07-22
2025-07-04,12383.1,asset_sale,in,Counterparty_23,20941222.66,,
2025-07-04,2702.98,supplier_payment,out,Counterparty_16,20938519.68,2025-05-22,2025-06-30
2025-07-04,3933.51,investment_income,in,Counterparty_46,20942453.19,,
2025-07-04,764.85,refund,in,Counterparty_20,20943218.04,,
2025-07-04,2851.13,asset_sale,in,Counterparty_40,20946069.17,,
2025-07-04,4472.61,investment_income,in,Counterparty_60,20950541.78,,
2025-07-04,12608.47,utilities,out,Counterparty_67,20937933.31,2025-06-08,2025-07-04
2025-07-04,3659.67,payroll,out,Counterparty_34,20934273.64,2025-06-03,2025-07-09
2025-07-04,8084.03,supplier_payment,out,Counterparty_76,20926189.61,2025-05-21,2025-06-21
2025-07-04,1404.83,credit,in,Counterparty_49,20927594.44,,
2025-07-04,14372.48,asset_sale,in,Counterparty_71,20941966.92,,
2025-07-04,244.19,customer_payment,in,Counterparty_25,20942211.11,,
2025-07-04,1174.15,utilities,out,Counterparty_3,20941036.96,2025-06-12,2025-07-17
2025-07-04,1177.15,refund,in,Counterparty_13,20942214.11,,
2025-07-04,11656.95,asset_sale,in,Counterparty_97,20953871.06,,
2025-07-04,4339.52,software_subscription,out,Counterparty_44,20949531.54,2025-06-03,2025-07-10
2025-07-04,8535.69,credit,in,Counterparty_45,20958067.23,,
2025-07-04,1026.94,marketing_spend,out,Counterparty_96,20957040.29,2025-05-30,2025-07-04
2025-07-04,3649.84,software_subscription,out,Counterparty_12,20953390.45,2025-06-10,2025-07-11
2025-07-04,4669.53,asset_sale,in,Counterparty_21,20958059.98,,
2025-07-04,631.24,investment_income,in,Counterparty_73,20958691.22,,
2025-07-04,2167.43,T&E,out,Counterparty_51,20956523.79,2025-06-04,2025-07-04
2025-07-04,1789.82,rent,out,Counterparty_33,20954733.97,2025-05-27,2025-07-04
2025-07-04,5374.98,utilities,out,Counterparty_96,20949358.99,2025-06-16,2025-07-12
2025-07-04,2804.07,payroll,out,Counterparty_22,20946554.92,2025-05-25,2025-07-01
2025-07-04,12118.7,marketing_spend,out,Counterparty_17,20934436.22,2025-05-26,2025-06-29
2025-07-04,7414.31,customer_payment,in,Counterparty_52,20941850.53,,
2025-07-04,1125.71,rent,out,Counterparty_8,20940724.82,2025-05-21,2025-06-16
2025-07-04,3284.31,payroll,out,Counterparty_24,20937440.51,2025-06-15,2025-07-20
2025-07-04,1626.32,supplier_payment,out,Counterparty_88,20935814.19,2025-06-14,2025-07-10
2025-07-04,3730.64,software_subscription,out,Counterparty_81,20932083.55,2025-06-16,2025-07-25
2025-07-04,1681.2,customer_payment,in,Counterparty_72,20933764.75,,
2025-07-04,1061.93,tax_payment,out,Counterparty_14,20932702.82,2025-06-06,2025-07-10
2025-07-04,7119.91,loan_repayment,out,Counterparty_55,20925582.91,2025-06-09,2025-07-11
2025-07-04,10758.28,loan_repayment,out,Counterparty_70,20914824.63,2025-05-24,2025-06-26
2025-07-04,801.74,tax_payment,out,Counterparty_24,20914022.89,2025-06-01,2025-07-02
2025-07-04,5638.65,software_subscription,out,Counterparty_71,20908384.24,2025-05-26,2025-06-20
2025-07-04,214.03,software_subscription,out,Counterparty_25,20908170.21,2025-05-22,2025-06-24
2025-07-04,919.75,credit,in,Counterparty_55,20909089.96,,
2025-07-04,1228.81,investment_income,in,Counterparty_30,20910318.77,,
2025-07-04,4109.25,credit,in,Counterparty_44,20914428.02,,
2025-07-04,11500.88,credit,in,Counterparty_4,20925928.9,,
2025-07-04,1617.95,refund,in,Counterparty_33,20927546.85,,
2025-07-04,10791.72,asset_sale,in,Counterparty_93,20938338.57,,
2025-07-04,3243.51,investment_income,in,Counterparty_62,20941582.08,,
2025-07-05,7024.88,supplier_payment,out,Counterparty_57,20934557.2,2025-06-13,2025-07-13
2025-07-05,10095.55,investment_income,in,Counterparty_78,20944652.75,,
2025-07-05,185.41,rent,out,Counterparty_86,20944467.34,2025-05-24,2025-06-19
2025-07-05,2137.68,credit,in,Counterparty_13,20946605.02,,
2025-07-05,53.26,utilities,out,Counterparty_61,20946551.76,2025-06-16,2025-07-14
2025-07-05,710.83,customer_payment,in,Counterparty_26,20947262.59,,
2025-07-05,14209.16,supplier_payment,out,Counterparty_70,20933053.43,2025-05-25,2025-06-26
2025-07-05,1244.75,supplier_payment,out,Counterparty_98,20931808.68,2025-06-16,2025-07-15
2025-07-05,1668.5,investment_income,in,Counterparty_3,20933477.18,,
2025-07-05,1524.24,payroll,out,Counterparty_19,20931952.94,2025-05-22,2025-06-17
2025-07-05,485.95,payroll,out,Counterparty_45,20931466.99,2025-05-26,2025-06-26
2025-07-05,3845.7,loan_repayment,out,Counterparty_32,20927621.29,2025-06-08,2025-07-03
2025-07-05,3071.25,utilities,out,Counterparty_86,20924550.04,2025-06-20,2025-07-27
2025-07-05,6142.1,credit,in,Counterparty_21,20930692.14,,
2025-07-05,1142.43,investment_income,in,Counterparty_72,20931834.57,,
2025-07-05,25.33,marketing_spend,out,Counterparty_7,20931809.24,2025-06-13,2025-07-10
2025-07-05,396.62,supplier_payment,out,Counterparty_63,20931412.62,2025-05-23,2025-07-01
2025-07-05,8518.54,credit,in,Counterparty_24,20939931.16,,
2025-07-05,561.04,asset_sale,in,Counterparty_8,20940492.2,,
2025-07-05,3313.97,credit,in,Counterparty_86,20943806.17,,
2025-07-05,4160.25,tax_payment,out,Counterparty_41,20939645.92,2025-05-31,2025-06-25
2025-07-05,1519.06,marketing_spend,out,Counterparty_57,20938126.86,2025-06-12,2025-07-21
2025-07-05,2967.77,utilities,out,Counterparty_70,20935159.09,2025-05-29,2025-06-26
2025-07-05,2832.16,customer_payment,in,Counterparty_54,20937991.25,,
2025-07-05,6360.32,supplier_payment,out,Counterparty_40,20931630.93,2025-06-15,2025-07-24
2025-07-05,3388.88,tax_payment,out,Counterparty_50,20928242.05,2025-06-19,2025-07-20
2025-07-05,3499.1,refund,in,Counterparty_32,20931741.15,,
2025-07-05,507.14,refund,in,Counterparty_18,20932248.29,,
2025-07-05,4458.9,utilities,out,Counterparty_65,20927789.39,2025-06-01,2025-07-01
2025-07-05,2102.09,customer_payment,in,Counterparty_7,20929891.48,,
2025-07-05,1301.13,tax_payment,out,Counterparty_55,20928590.35,2025-05-24,2025-06-23
2025-07-05,3709.5,rent,out,Counterparty_5,20924880.85,2025-05-26,2025-06-29
2025-07-05,1763.84,supplier_payment,out,Counterparty_63,20923117.01,2025-05-23,2025-06-30
2025-07-05,22808.67,supplier_payment,out,Counterparty_28,20900308.34,2025-06-03,2025-06-30
2025-07-05,6667.69,payroll,out,Counterparty_38,20893640.65,2025-06-01,2025-07-01
2025-07-05,2701.04,investment_income,in,Counterparty_7,20896341.69,,
2025-07-05,2161.91,customer_payment,in,Counterparty_35,20898503.6,,
2025-07-05,3907.78,tax_payment,out,Counterparty_16,20894595.82,2025-06-19,2025-07-20
2025-07-05,12651.67,credit,in,Counterparty_8,20907247.49,,
2025-07-05,18050.85,customer_payment,in,Counterparty_89,20925298.34,,
2025-07-05,2188.22,refund,in,Counterparty_3,20927486.56,,
2025-07-05,4026.97,credit,in,Counterparty_19,20931513.53,,
2025-07-05,762.3,asset_sale,in,Counterparty_6,20932275.83,,
2025-07-05,16473.58,investment_income,in,Counterparty_56,20948749.41,,
2025-07-05,5438.85,asset_sale,in,Counterparty_95,20954188.26,,
2025-07-05,5528.98,credit,in,Counterparty_37,20959717.24,,
2025-07-06,1309.54,software_subscription,out,Counterparty_72,20958407.7,2025-05-25,2025-06-26
2025-07-06,2810.85,tax_payment,out,Counterparty_81,20955596.85,2025-06-12,2025-07-07
2025-07-06,8725.81,customer_payment,in,Counterparty_82,20964322.66,,
2025-07-06,16899.95,customer_payment,in,Counterparty_36,20981222.61,,
2025-07-06,1814.88,payroll,out,Counterparty_79,20979407.73,2025-05-26,2025-06-20
2025-07-06,4598.86,T&E,out,Counterparty_64,20974808.87,2025-06-04,2025-07-05
2025-07-06,575.8,asset_sale,in,Counterparty_84,20975384.67,,
2025-07-06,7435.71,rent,out,Counterparty_18,20967948.96,2025-05-24,2025-07-01
2025-07-06,4987.77,rent,out,Counterparty_35,20962961.19,2025-06-09,2025-07-16
2025-07-06,2447.3,investment_income,in,Counterparty_86,20965408.49,,
2025-07-06,8706.6,rent,out,Counterparty_27,20956701.89,2025-06-13,2025-07-14
2025-07-06,390.24,loan_repayment,out,Counterparty_19,20956311.65,2025-06-01,2025-07-02
2025-07-06,2545.97,customer_payment,in,Counterparty_20,20958857.62,,
2025-07-06,450.46,utilities,out,Counterparty_18,20958407.16,2025-06-08,2025-07-03
2025-07-06,2484.61,refund,in,Counterparty_31,20960891.77,,
2025-07-06,230.59,marketing_spend,out,Counterparty_30,20960661.18,2025-05-30,2025-06-27
2025-07-06,6825.46,customer_payment,in,Counterparty_74,20967486.64,,
2025-07-06,610.77,payroll,out,Counterparty_16,20966875.87,2025-06-20,2025-07-24
2025-07-06,2179.2,T&E,out,Counterparty_70,20964696.67,2025-06-11,2025-07-18
2025-07-06,6492.03,T&E,out,Counterparty_73,20958204.64,2025-05-28,2025-07-05
2025-07-06,466.3,tax_payment,out,Counterparty_67,20957738.34,2025-06-11,2025-07-13
2025-07-06,9146.41,investment_income,in,Counterparty_39,20966884.75,,
2025-07-06,7309.73,asset_sale,in,Counterparty_49,20974194.48,,
2025-07-06,2048.88,loan_repayment,out,Counterparty_73,20972145.6,2025-06-08,2025-07-15
2025-07-06,13095.41,customer_payment,in,Counterparty_92,20985241.01,,
2025-07-06,9576.88,marketing_spend,out,Counterparty_23,20975664.13,2025-06-05,2025-07-07
2025-07-06,5246.94,investment_income,in,Counterparty_20,20980911.07,,
2025-07-06,4813.47,tax_payment,out,Counterparty_13,20976097.6,2025-06-04,2025-07-06
2025-07-06,5117.69,customer_payment,in,Counterparty_49,20981215.29,,
2025-07-06,1705.68,rent,out,Counterparty_37,20979509.61,2025-06-11,2025-07-16
2025-07-06,2619.21,investment_income,in,Counterparty_94,20982128.82,,
2025-07-07,4275.56,T&E,out,Counterparty_32,20977853.26,2025-06-07,2025-07-09
2025-07-07,3555.63,marketing_spend,out,Counterparty_95,20974297.63,2025-06-13,2025-07-20
2025-07-07,2058.86,T&E,out,Counterparty_13,20972238.77,2025-06-16,2025-07-17
2025-07-07,13587.63,asset_sale,in,Counterparty_51,20985826.4,,
2025-07-07,4783.58,investment_income,in,Counterparty_32,20990609.98,,
2025-07-07,8988.93,refund,in,Counterparty_60,20999598.91,,
2025-07-07,7629.29,customer_payment,in,Counterparty_32,21007228.2,,
2025-07-07,3633.87,credit,in,Counterparty_52,21010862.07,,
2025-07-07,736.47,marketing_spend,out,Counterparty_43,21010125.6,2025-06-04,2025-07-13
2025-07-07,577.64,tax_payment,out,Counterparty_15,21009547.96,2025-06-08,2025-07-07
2025-07-07,705.67,credit,in,Counterparty_38,21010253.63,,
2025-07-07,3465.49,utilities,out,Counterparty_78,21006788.14,2025-06-03,2025-06-29
2025-07-07,9412.37,rent,out,Counterparty_11,20997375.77,2025-06-19,2025-07-19
2025-07-07,34.33,software_subscription,out,Counterparty_9,20997341.44,2025-06-12,2025-07-09
2025-07-07,6911.61,investment_income,in,Counterparty_89,21004253.05,,
2025-07-07,1123.16,credit,in,Counterparty_53,21005376.21,,
2025-07-07,366.34,rent,out,Counterparty_20,21005009.87,2025-06-14,2025-07-21
2025-07-07,3703.28,payroll,out,Counterparty_55,21001306.59,2025-05-29,2025-07-03
2025-07-07,1423.03,tax_payment,out,Counterparty_64,20999883.56,2025-06-04,2025-07-05
2025-07-07,2953.89,investment_income,in,Counterparty_14,21002837.45,,
2025-07-07,6855.73,asset_sale,in,Counterparty_1,21009693.18,,
2025-07-07,444.39,customer_payment,in,Counterparty_76,21010137.57,,
2025-07-07,2314.4,T&E,out,Counterparty_33,21007823.17,2025-06-04,2025-07-03
2025-07-07,5130.36,loan_repayment,out,Counterparty_41,21002692.81,2025-06-09,2025-07-14
2025-07-07,4513.64,investment_income,in,Counterparty_78,21007206.45,,
2025-07-07,7210.11,T&E,out,Counterparty_32,20999996.34,2025-06-08,2025-07-09
2025-07-07,3113.44,customer_payment,in,Counterparty_19,21003109.78,,
2025-07-07,8540.0,rent,out,Counterparty_20,20994569.78,2025-06-15,2025-07-18
2025-07-07,3877.02,marketing_spend,out,Counterparty_14,20990692.76,2025-06-15,2025-07-13
2025-07-07,2013.26,asset_sale,in,Counterparty_86,20992706.02,,
2025-07-07,9020.53,refund,in,Counterparty_11,21001726.55,,
2025-07-07,595.91,T&E,out,Counterparty_92,21001130.64,2025-05-29,2025-07-07
2025-07-07,5727.99,asset_sale,in,Counterparty_59,21006858.63,,
2025-07-07,6209.24,customer_payment,in,Counterparty_58,21013067.87,,
2025-07-07,837.87,software_subscription,out,Counterparty_40,21012230.0,2025-05-31,2025-06-26
2025-07-07,6149.32,refund,in,Counterparty_69,21018379.32,,
2025-07-07,277.26,customer_payment,in,Counterparty_90,21018656.58,,
2025-07-07,942.26,customer_payment,in,Counterparty_78,21019598.84,,
2025-07-07,3436.8,tax_payment,out,Counterparty_31,21016162.04,2025-06-16,2025-07-16
2025-07-07,11354.75,asset_sale,in,Counterparty_62,21027516.79,,
2025-07-07,4148.98,loan_repayment,out,Counterparty_73,21023367.81,2025-05-25,2025-06-27
2025-07-07,5655.68,asset_sale,in,Counterparty_27,21029023.49,,
2025-07-07,3049.96,refund,in,Counterparty_91,21032073.45,,
2025-07-07,3067.05,customer_payment,in,Counterparty_24,21035140.5,,
2025-07-07,9530.9,utilities,out,Counterparty_60,21025609.6,2025-06-18,2025-07-15
2025-07-07,1244.05,loan_repayment,out,Counterparty_30,21024365.55,2025-06-21,2025-07-26
2025-07-07,6274.97,software_subscription,out,Counterparty_99,21018090.58,2025-06-07,2025-07-09
2025-07-07,4622.71,T&E,out,Counterparty_21,21013467.87,2025-06-19,2025-07-20
2025-07-07,4495.75,asset_sale,in,Counterparty_76,21017963.62,,
2025-07-07,1290.56,utilities,out,Counterparty_30,21016673.06,2025-06-10,2025-07-16
2025-07-07,11574.21,utilities,out,Counterparty_27,21005098.85,2025-05-29,2025-06-26
2025-07-07,3662.75,utilities,out,Counterparty_93,21001436.1,2025-06-22,2025-07-25
2025-07-07,15432.29,refund,in,Counterparty_61,21016868.39,,
2025-07-07,938.57,loan_repayment,out,Counterparty_21,21015929.82,2025-06-03,2025-06-30
2025-07-07,88.39,rent,out,Counterparty_71,21015841.43,2025-05-30,2025-06-25
2025-07-07,183.03,utilities,out,Counterparty_55,21015658.4,2025-06-07,2025-07-14
2025-07-07,5036.09,tax_payment,out,Counterparty_72,21010622.31,2025-06-08,2025-07-12
2025-07-07,3471.88,customer_payment,in,Counterparty_81,21014094.19,,
2025-07-07,12985.31,payroll,out,Counterparty_12,21001108.88,2025-06-06,2025-07-07
2025-07-07,1723.86,payroll,out,Counterparty_35,20999385.02,2025-05-28,2025-07-01
2025-07-07,984.3,credit,in,Counterparty_93,21000369.32,,
2025-07-07,876.1,utilities,out,Counterparty_59,20999493.22,2025-06-10,2025-07-10
2025-07-07,28095.87,payroll,out,Counterparty_97,20971397.35,2025-06-17,2025-07-22
2025-07-07,7779.63,tax_payment,out,Counterparty_71,20963617.72,2025-06-15,2025-07-14
2025-07-07,3789.67,credit,in,Counterparty_85,20967407.39,,
2025-07-07,7100.57,refund,in,Counterparty_30,20974507.96,,
2025-07-07,2462.29,refund,in,Counterparty_8,20976970.25,,
2025-07-07,764.41,investment_income,in,Counterparty_20,20977734.66,,
2025-07-07,1818.31,asset_sale,in,Counterparty_5,20979552.97,,
2025-07-07,1570.52,refund,in,Counterparty_15,20981123.49,,
2025-07-08,5399.29,rent,out,Counterparty_72,20975724.2,2025-05-25,2025-06-29
2025-07-08,2284.85,marketing_spend,out,Counterparty_22,20973439.35,2025-06-07,2025-07-15
2025-07-08,264.64,refund,in,Counterparty_9,20973703.99,,
2025-07-08,5531.72,rent,out,Counterparty_1,20968172.27,2025-06-06,2025-07-10
2025-07-08,11283.2,marketing_spend,out,Counterparty_21,20956889.07,2025-06-04,2025-07-03
2025-07-08,5261.46,marketing_spend,out,Counterparty_98,20951627.61,2025-06-20,2025-07-17
2025-07-08,1067.73,supplier_payment,out,Counterparty_56,20950559.88,2025-06-13,2025-07-15
2025-07-08,175.3,asset_sale,in,Counterparty_35,20950735.18,,
2025-07-08,6067.41,investment_income,in,Counterparty_23,20956802.59,,
2025-07-08,994.96,investment_income,in,Counterparty_4,20957797.55,,
2025-07-08,10062.77,T&E,out,Counterparty_81,20947734.78,2025-06-16,2025-07-25
2025-07-08,3354.3,marketing_spend,out,Counterparty_5,20944380.48,2025-06-20,2025-07-26
2025-07-08,3107.31,credit,in,Counterparty_4,20947487.79,,
2025-07-08,2345.58,refund,in,Counterparty_75,20949833.37,,
2025-07-08,2394.86,rent,out,Counterparty_52,20947438.51,2025-05-29,2025-07-05
2025-07-08,1134.47,loan_repayment,out,Counterparty_19,20946304.04,2025-05-30,2025-06-25
2025-07-08,7977.56,investment_income,in,Counterparty_3,20954281.6,,
2025-07-08,147.79,investment_income,in,Counterparty_8,20954429.39,,
2025-07-08,1713.69,customer_payment,in,Counterparty_53,20956143.08,,
2025-07-08,327.04,utilities,out,Counterparty_60,20955816.04,2025-06-04,2025-07-03
2025-07-08,3167.18,loan_repayment,out,Counterparty_79,20952648.86,2025-06-06,2025-07-03
2025-07-08,1414.9,investment_income,in,Counterparty_12,20954063.76,,
2025-07-08,3491.83,refund,in,Counterparty_4,20957555.59,,
2025-07-08,287.17,refund,in,Counterparty_2,20957842.76,,
2025-07-08,2325.06,utilities,out,Counterparty_15,20955517.7,2025-06-10,2025-07-09
2025-07-08,7263.19,customer_payment,in,Counterparty_5,20962780.89,,
2025-07-08,219.25,rent,out,Counterparty_46,20962561.64,2025-06-13,2025-07-21
2025-07-08,5250.41,rent,out,Counterparty_4,20957311.23,2025-06-21,2025-07-16
2025-07-08,2169.46,loan_repayment,out,Counterparty_77,20955141.77,2025-05-26,2025-06-20
2025-07-08,66.83,refund,in,Counterparty_44,20955208.6,,
2025-07-08,14316.07,payroll,out,Counterparty_24,20940892.53,2025-06-01,2025-07-09
2025-07-08,1799.07,software_subscription,out,Counterparty_22,20939093.46,2025-06-08,2025-07-09
2025-07-08,8851.56,refund,in,Counterparty_7,20947945.02,,
2025-07-08,1449.54,credit,in,Counterparty_20,20949394.56,,
2025-07-08,2539.96,customer_payment,in,Counterparty_60,20951934.52,,
2025-07-08,837.8,T&E,out,Counterparty_46,20951096.72,2025-06-04,2025-06-30
2025-07-08,2910.0,payroll,out,Counterparty_6,20948186.72,2025-05-30,2025-07-07
2025-07-08,999.24,credit,in,Counterparty_33,20949185.96,,
2025-07-08,2666.03,credit,in,Counterparty_72,20951851.99,,
2025-07-08,10862.66,utilities,out,Counterparty_95,20940989.33,2025-05-28,2025-06-28
2025-07-08,1627.17,marketing_spend,out,Counterparty_91,20939362.16,2025-05-25,2025-06-29
2025-07-08,745.79,loan_repayment,out,Counterparty_56,20938616.37,2025-06-19,2025-07-22
2025-07-08,3684.55,T&E,out,Counterparty_17,20934931.82,2025-05-30,2025-07-02
2025-07-08,4889.4,investment_income,in,Counterparty_50,20939821.22,,
2025-07-08,562.04,refund,in,Counterparty_5,20940383.26,,
2025-07-08,1400.42,payroll,out,Counterparty_76,20938982.84,2025-06-17,2025-07-24
2025-07-09,2353.36,loan_repayment,out,Counterparty_42,20936629.48,2025-06-21,2025-07-25
2025-07-09,6096.12,credit,in,Counterparty_78,20942725.6,,
2025-07-09,12339.82,investment_income,in,Counterparty_96,20955065.42,,
2025-07-09,7399.53,T&E,out,Counterparty_82,20947665.89,2025-06-15,2025-07-13
2025-07-09,1032.02,tax_payment,out,Counterparty_84,20946633.87,2025-06-09,2025-07-17
2025-07-09,10522.65,supplier_payment,out,Counterparty_74,20936111.22,2025-06-16,2025-07-11
2025-07-09,2845.78,loan_repayment,out,Counterparty_79,20933265.44,2025-06-09,2025-07-16
2025-07-09,1075.8,credit,in,Counterparty_28,20934341.24,,
2025-07-09,4987.73,software_subscription,out,Counterparty_30,20929353.51,2025-05-29,2025-06-26
2025-07-09,5930.5,payroll,out,Counterparty_45,20923423.01,2025-06-06,2025-07-07
2025-07-09,4267.2,investment_income,in,Counterparty_24,20927690.21,,
2025-07-09,2604.63,investment_income,in,Counterparty_54,20930294.84,,
2025-07-09,3522.2,software_subscription,out,Counterparty_66,20926772.64,2025-05-27,2025-06-30
2025-07-09,7.88,investment_income,in,Counterparty_67,20926780.52,,
2025-07-09,2337.52,credit,in,Counterparty_72,20929118.04,,
2025-07-09,2840.73,software_subscription,out,Counterparty_17,20926277.31,2025-06-12,2025-07-17
2025-07-09,1913.39,investment_income,in,Counterparty_79,20928190.7,,
2025-07-09,4025.77,credit,in,Counterparty_65,20932216.47,,
2025-07-09,5410.92,rent,out,Counterparty_78,20926805.55,2025-05-31,2025-07-06
2025-07-09,7428.94,tax_payment,out,Counterparty_83,20919376.61,2025-06-21,2025-07-21
2025-07-09,13518.37,investment_income,in,Counterparty_28,20932894.98,,
2025-07-09,1762.62,customer_payment,in,Counterparty_24,20934657.6,,
2025-07-09,5690.71,utilities,out,Counterparty_89,20928966.89,2025-06-14,2025-07-09
2025-07-09,2166.02,utilities,out,Counterparty_67,20926800.87,2025-06-09,2025-07-08
2025-07-09,3313.09,loan_repayment,out,Counterparty_3,20923487.78,2025-06-24,2025-07-26
2025-07-09,11819.59,marketing_spend,out,Counterparty_15,20911668.19,2025-06-05,2025-07-13
2025-07-09,2686.21,tax_payment,out,Counterparty_1,20908981.98,2025-06-04,2025-07-08
2025-07-09,2311.44,utilities,out,Counterparty_14,20906670.54,2025-06-21,2025-07-25
2025-07-09,13258.72,payroll,out,Counterparty_54,20893411.82,2025-06-14,2025-07-14
2025-07-09,2894.48,utilities,out,Counterparty_74,20890517.34,2025-06-03,2025-06-30
2025-07-09,1970.21,customer_payment,in,Counterparty_35,20892487.55,,
2025-07-09,758.57,T&E,out,Counterparty_38,20891728.98,2025-06-12,2025-07-10
2025-07-09,4607.78,T&E,out,Counterparty_31,20887121.2,2025-06-17,2025-07-20
2025-07-09,8717.99,refund,in,Counterparty_78,20895839.19,,
2025-07-09,2740.22,marketing_spend,out,Counterparty_63,20893098.97,2025-06-18,2025-07-17
2025-07-09,8780.92,customer_payment,in,Counterparty_71,20901879.89,,
2025-07-09,12000.0,T&E,out,Counterparty_19,20889879.89,2025-06-10,2025-07-14
2025-07-09,1292.96,investment_income,in,Counterparty_56,20891172.85,,
2025-07-09,8700.33,utilities,out,Counterparty_59,20882472.52,2025-06-03,2025-07-01
2025-07-09,3355.83,marketing_spend,out,Counterparty_55,20879116.69,2025-05-28,2025-06-24
2025-07-09,1577.01,software_subscription,out,Counterparty_69,20877539.68,2025-06-24,2025-07-19
2025-07-09,2537.72,rent,out,Counterparty_43,20875001.96,2025-06-07,2025-07-02
2025-07-09,7187.62,supplier_payment,out,Counterparty_27,20867814.34,2025-06-10,2025-07-08
2025-07-09,4489.88,loan_repayment,out,Counterparty_18,20863324.46,2025-06-12,2025-07-07
2025-07-09,4397.75,marketing_spend,out,Counterparty_95,20858926.71,2025-05-28,2025-06-27
2025-07-09,13720.82,payroll,out,Counterparty_23,20845205.89,2025-06-02,2025-06-29
2025-07-09,6347.98,asset_sale,in,Counterparty_63,20851553.87,,
2025-07-09,6740.95,loan_repayment,out,Counterparty_12,20844812.92,2025-06-12,2025-07-11
2025-07-09,1420.85,customer_payment,in,Counterparty_49,20846233.77,,
2025-07-09,463.63,loan_repayment,out,Counterparty_55,20845770.14,2025-06-24,2025-07-24
2025-07-10,12285.37,marketing_spend,out,Counterparty_76,20833484.77,2025-06-15,2025-07-13
2025-07-10,1963.43,asset_sale,in,Counterparty_39,20835448.2,,
2025-07-10,4530.48,investment_income,in,Counterparty_21,20839978.68,,
2025-07-10,699.31,loan_repayment,out,Counterparty_22,20839279.37,2025-06-01,2025-06-29
2025-07-10,4590.86,investment_income,in,Counterparty_52,20843870.23,,
2025-07-10,3499.45,customer_payment,in,Counterparty_98,20847369.68,,
2025-07-10,8725.27,credit,in,Counterparty_22,20856094.95,,
2025-07-10,395.24,refund,in,Counterparty_41,20856490.19,,
2025-07-10,1061.86,T&E,out,Counterparty_23,20855428.33,2025-06-20,2025-07-19
2025-07-10,272.39,loan_repayment,out,Counterparty_18,20855155.94,2025-06-11,2025-07-20
2025-07-10,4092.02,investment_income,in,Counterparty_4,20859247.96,,
2025-07-10,5846.96,software_subscription,out,Counterparty_83,20853401.0,2025-05-27,2025-06-26
2025-07-10,8051.25,loan_repayment,out,Counterparty_95,20845349.75,2025-06-06,2025-07-02
2025-07-10,348.26,customer_payment,in,Counterparty_49,20845698.01,,
2025-07-10,5222.15,tax_payment,out,Counterparty_74,20840475.86,2025-06-06,2025-07-15
2025-07-10,3995.34,refund,in,Counterparty_87,20844471.2,,
2025-07-10,4594.87,T&E,out,Counterparty_88,20839876.33,2025-06-01,2025-07-04
2025-07-10,1462.99,payroll,out,Counterparty_25,20838413.34,2025-06-21,2025-07-25
2025-07-10,538.68,investment_income,in,Counterparty_50,20838952.02,,
2025-07-10,1655.1,rent,out,Counterparty_82,20837296.92,2025-06-20,2025-07-16
2025-07-10,659.65,tax_payment,out,Counterparty_25,20836637.27,2025-06-17,2025-07-22
2025-07-10,425.67,credit,in,Counterparty_62,20837062.94,,
2025-07-10,1380.91,rent,out,Counterparty_87,20835682.03,2025-06-13,2025-07-15
2025-07-10,6670.79,marketing_spend,out,Counterparty_83,20829011.24,2025-06-22,2025-07-26
2025-07-10,19947.5,credit,in,Counterparty_38,20848958.74,,
2025-07-10,889.18,payroll,out,Counterparty_20,20848069.56,2025-05-27,2025-06-25
2025-07-10,4737.52,investment_income,in,Counterparty_67,20852807.08,,
2025-07-10,12171.07,refund,in,Counterparty_71,20864978.15,,
2025-07-10,9566.5,software_subscription,out,Counterparty_21,20855411.65,2025-05-31,2025-06-30
2025-07-10,2234.03,software_subscription,out,Counterparty_75,20853177.62,2025-05-28,2025-07-01
2025-07-10,1622.7,tax_payment,out,Counterparty_8,20851554.92,2025-06-25,2025-07-28
2025-07-10,2134.28,payroll,out,Counterparty_82,20849420.64,2025-06-19,2025-07-19
2025-07-10,1588.18,T&E,out,Counterparty_5,20847832.46,2025-06-12,2025-07-15
2025-07-10,19612.0,refund,in,Counterparty_58,20867444.46,,
2025-07-10,755.92,customer_payment,in,Counterparty_72,20868200.38,,
2025-07-10,6466.36,supplier_payment,out,Counterparty_92,20861734.02,2025-06-02,2025-07-07
2025-07-10,2259.47,rent,out,Counterparty_53,20859474.55,2025-06-20,2025-07-16
2025-07-10,1203.61,T&E,out,Counterparty_94,20858270.94,2025-06-19,2025-07-20
2025-07-10,665.94,asset_sale,in,Counterparty_51,20858936.88,,
2025-07-10,493.14,loan_repayment,out,Counterparty_33,20858443.74,2025-05-27,2025-06-22
2025-07-10,5649.12,investment_income,in,Counterparty_20,20864092.86,,
2025-07-10,4299.24,customer_payment,in,Counterparty_39,20868392.1,,
2025-07-10,183.08,supplier_payment,out,Counterparty_19,20868209.02,2025-05-28,2025-06-26
2025-07-10,250.12,payroll,out,Counterparty_25,20867958.9,2025-05-31,2025-07-07
2025-07-10,74.59,refund,in,Counterparty_70,20868033.49,,
2025-07-10,2257.44,investment_income,in,Counterparty_27,20870290.93,,
2025-07-10,6769.7,marketing_spend,out,Counterparty_21,20863521.23,2025-06-21,2025-07-18
2025-07-10,9580.36,investment_income,in,Counterparty_95,20873101.59,,
2025-07-10,1327.45,investment_income,in,Counterparty_16,20874429.04,,
2025-07-10,3814.21,supplier_payment,out,Counterparty_9,20870614.83,2025-06-19,2025-07-23
2025-07-10,5348.58,refund,in,Counterparty_34,20875963.41,,
2025-07-10,982.73,credit,in,Counterparty_20,20876946.14,,
2025-07-10,2427.4,credit,in,Counterparty_85,20879373.54,,
2025-07-10,11557.42,refund,in,Counterparty_89,20890930.96,,
2025-07-11,1102.11,customer_payment,in,Counterparty_81,20892033.07,,
2025-07-11,1764.82,credit,in,Counterparty_96,20893797.89,,
2025-07-11,9228.15,customer_payment,in,Counterparty_17,20903026.04,,
2025-07-11,12596.91,T&E,out,Counterparty_42,20890429.13,2025-06-24,2025-07-27
2025-07-11,15582.37,customer_payment,in,Counterparty_56,20906011.5,,
2025-07-11,5848.22,supplier_payment,out,Counterparty_80,20900163.28,2025-06-09,2025-07-11
2025-07-11,650.6,refund,in,Counterparty_49,20900813.88,,
2025-07-11,3023.48,loan_repayment,out,Counterparty_46,20897790.4,2025-06-18,2025-07-18
2025-07-11,3203.94,payroll,out,Counterparty_8,20894586.46,2025-06-26,2025-08-01
2025-07-11,8510.4,loan_repayment,out,Counterparty_92,20886076.06,2025-06-23,2025-07-26
2025-07-11,2763.05,utilities,out,Counterparty_48,20883313.01,2025-06-14,2025-07-12
2025-07-11,2613.79,asset_sale,in,Counterparty_17,20885926.8,,
2025-07-11,2843.96,payroll,out,Counterparty_80,20883082.84,2025-06-20,2025-07-16
2025-07-11,7665.04,software_subscription,out,Counterparty_26,20875417.8,2025-06-19,2025-07-19
2025-07-11,1684.68,investment_income,in,Counterparty_10,20877102.48,,
2025-07-11,1188.79,investment_income,in,Counterparty_24,20878291.27,,
2025-07-11,740.62,customer_payment,in,Counterparty_74,20879031.89,,
2025-07-11,217.72,tax_payment,out,Counterparty_11,20878814.17,2025-06-11,2025-07-11
2025-07-11,8797.84,software_subscription,out,Counterparty_63,20870016.33,2025-06-13,2025-07-16
2025-07-11,391.48,software_subscription,out,Counterparty_11,20869624.85,2025-06-22,2025-07-29
2025-07-11,5885.95,supplier_payment,out,Counterparty_62,20863738.9,2025-06-03,2025-06-29
2025-07-11,529.73,loan_repayment,out,Counterparty_95,20863209.17,2025-06-19,2025-07-16
2025-07-11,4870.73,utilities,out,Counterparty_90,20858338.44,2025-06-23,2025-07-31
2025-07-11,1683.62,software_subscription,out,Counterparty_9,20856654.82,2025-05-30,2025-07-03
2025-07-11,2785.22,customer_payment,in,Counterparty_74,20859440.04,,
2025-07-11,572.02,credit,in,Counterparty_12,20860012.06,,
2025-07-11,6707.03,rent,out,Counterparty_58,20853305.03,2025-06-02,2025-07-05
2025-07-11,14889.95,customer_payment,in,Counterparty_43,20868194.98,,
2025-07-11,2726.57,supplier_payment,out,Counterparty_83,20865468.41,2025-06-16,2025-07-20
2025-07-11,817.9,software_subscription,out,Counterparty_64,20864650.51,2025-05-30,2025-07-05
2025-07-11,1018.98,customer_payment,in,Counterparty_80,20865669.49,,
2025-07-11,1330.79,refund,in,Counterparty_4,20867000.28,,
2025-07-11,3869.3,credit,in,Counterparty_97,20870869.58,,
2025-07-11,9506.48,credit,in,Counterparty_9,20880376.06,,
2025-07-11,7908.67,T&E,out,Counterparty_75,20872467.39,2025-05-30,2025-06-24
2025-07-11,2130.13,T&E,out,Counterparty_90,20870337.26,2025-06-04,2025-07-07
2025-07-11,5422.2,tax_payment,out,Counterparty_8,20864915.06,2025-06-14,2025-07-12
2025-07-11,2427.76,supplier_payment,out,Counterparty_34,20862487.3,2025-06-02,2025-07-10
2025-07-11,3672.56,investment_income,in,Counterparty_73,20866159.86,,
2025-07-11,566.79,asset_sale,in,Counterparty_33,20866726.65,,
2025-07-11,608.56,refund,in,Counterparty_78,20867335.21,,
2025-07-11,11190.5,refund,in,Counterparty_97,20878525.71,,
2025-07-11,124.23,software_subscription,out,Counterparty_50,20878401.48,2025-06-09,2025-07-18
2025-07-12,988.05,investment_income,in,Counterparty_29,20879389.53,,
2025-07-12,2546.31,credit,in,Counterparty_34,20881935.84,,
2025-07-12,39.25,marketing_spend,out,Counterparty_74,20881896.59,2025-06-01,2025-07-01
2025-07-12,10576.18,asset_sale,in,Counterparty_45,20892472.77,,
2025-07-12,480.37,credit,in,Counterparty_39,20892953.14,,
2025-07-12,4006.24,rent,out,Counterparty_65,20888946.9,2025-06-25,2025-07-25
2025-07-12,1278.77,credit,in,Counterparty_29,20890225.67,,
2025-07-12,13623.81,utilities,out,Counterparty_85,20876601.86,2025-06-16,2025-07-14
2025-07-12,6236.8,utilities,out,Counterparty_30,20870365.06,2025-06-21,2025-07-20
2025-07-12,3210.95,asset_sale,in,Counterparty_4,20873576.01,,
2025-07-12,4592.66,asset_sale,in,Counterparty_68,20878168.67,,
2025-07-12,2369.42,loan_repayment,out,Counterparty_84,20875799.25,2025-06-25,2025-07-23
2025-07-12,4498.21,rent,out,Counterparty_80,20871301.04,2025-06-02,2025-07-05
2025-07-12,2929.74,customer_payment,in,Counterparty_42,20874230.78,,
2025-07-12,666.98,investment_income,in,Counterparty_44,20874897.76,,
2025-07-12,880.71,rent,out,Counterparty_97,20874017.05,2025-06-17,2025-07-25
2025-07-12,619.18,customer_payment,in,Counterparty_33,20874636.23,,
2025-07-12,990.09,refund,in,Counterparty_99,20875626.32,,
2025-07-12,2033.72,payroll,out,Counterparty_35,20873592.6,2025-06-02,2025-07-07
2025-07-12,3891.47,loan_repayment,out,Counterparty_9,20869701.13,2025-06-12,2025-07-15
2025-07-12,529.16,payroll,out,Counterparty_66,20869171.97,2025-06-18,2025-07-24
2025-07-12,6171.22,marketing_spend,out,Counterparty_63,20863000.75,2025-06-17,2025-07-24
2025-07-12,15414.63,marketing_spend,out,Counterparty_15,20847586.12,2025-06-09,2025-07-04
2025-07-12,13803.16,investment_income,in,Counterparty_61,20861389.28,,
2025-07-12,752.88,software_subscription,out,Counterparty_28,20860636.4,2025-05-30,2025-07-07
2025-07-12,11443.18,customer_payment,in,Counterparty_76,20872079.58,,
2025-07-12,2024.99,investment_income,in,Counterparty_50,20874104.57,,
2025-07-12,5013.64,refund,in,Counterparty_77,20879118.21,,
2025-07-12,859.07,investment_income,in,Counterparty_33,20879977.28,,
2025-07-12,393.11,marketing_spend,out,Counterparty_77,20879584.17,2025-06-24,2025-07-23
2025-07-12,486.93,marketing_spend,out,Counterparty_16,20879097.24,2025-06-14,2025-07-12
2025-07-12,3406.01,software_subscription,out,Counterparty_88,20875691.23,2025-06-03,2025-06-29
2025-07-12,3256.39,refund,in,Counterparty_60,20878947.62,,
2025-07-12,4913.38,customer_payment,in,Counterparty_59,20883861.0,,
2025-07-12,3839.57,customer_payment,in,Counterparty_50,20887700.57,,
2025-07-12,8319.37,T&E,out,Counterparty_58,20879381.2,2025-06-21,2025-07-22
2025-07-12,15848.89,credit,in,Counterparty_98,20895230.09,,
2025-07-12,1852.5,software_subscription,out,Counterparty_22,20893377.59,2025-06-22,2025-07-26
2025-07-13,1096.05,refund,in,Counterparty_58,20894473.64,,
2025-07-13,744.19,payroll,out,Counterparty_16,20893729.45,2025-06-19,2025-07-14
2025-07-13,4822.35,utilities,out,Counterparty_29,20888907.1,2025-06-24,2025-07-28
2025-07-13,5368.32,utilities,out,Counterparty_60,20883538.78,2025-06-24,2025-07-20
2025-07-13,11076.74,refund,in,Counterparty_52,20894615.52,,
2025-07-13,4429.24,utilities,out,Counterparty_7,20890186.28,2025-06-25,2025-07-25
2025-07-13,1212.06,investment_income,in,Counterparty_11,20891398.34,,
2025-07-13,6221.84,customer_payment,in,Counterparty_38,20897620.18,,
2025-07-13,6478.44,rent,out,Counterparty_23,20891141.74,2025-06-15,2025-07-17
2025-07-13,2679.65,marketing_spend,out,Counterparty_90,20888462.09,2025-06-20,2025-07-25
2025-07-13,16361.43,asset_sale,in,Counterparty_58,20904823.52,,
2025-07-13,5450.14,tax_payment,out,Counterparty_37,20899373.38,2025-06-27,2025-07-31
2025-07-13,2240.2,investment_income,in,Counterparty_53,20901613.58,,
2025-07-13,13008.09,investment_income,in,Counterparty_64,20914621.67,,
2025-07-13,527.73,investment_income,in,Counterparty_5,20915149.4,,
2025-07-13,6901.68,payroll,out,Counterparty_67,20908247.72,2025-06-03,2025-07-06
2025-07-13,8780.91,credit,in,Counterparty_83,20917028.63,,
2025-07-13,6653.71,refund,in,Counterparty_59,20923682.34,,
2025-07-13,12773.37,tax_payment,out,Counterparty_1,20910908.97,2025-06-03,2025-07-07
2025-07-13,1677.55,utilities,out,Counterparty_17,20909231.42,2025-06-20,2025-07-28
2025-07-13,2704.39,supplier_payment,out,Counterparty_67,20906527.03,2025-06-16,2025-07-24
2025-07-13,7201.17,credit,in,Counterparty_97,20913728.2,,
2025-07-13,122.19,supplier_payment,out,Counterparty_8,20913606.01,2025-06-01,2025-07-07
2025-07-13,714.86,loan_repayment,out,Counterparty_1,20912891.15,2025-06-25,2025-07-31
2025-07-13,2350.43,customer_payment,in,Counterparty_14,20915241.58,,
2025-07-13,5997.04,T&E,out,Counterparty_32,20909244.54,2025-06-16,2025-07-17
2025-07-13,21325.53,credit,in,Counterparty_98,20930570.07,,
2025-07-13,10779.53,software_subscription,out,Counterparty_75,20919790.54,2025-06-14,2025-07-23
2025-07-13,12245.68,credit,in,Counterparty_83,20932036.22,,
2025-07-13,1860.14,marketing_spend,out,Counterparty_29,20930176.08,2025-06-04,2025-07-05
2025-07-13,1042.4,utilities,out,Counterparty_94,20929133.68,2025-06-13,2025-07-18
2025-07-13,7873.97,customer_payment,in,Counterparty_51,20937007.65,,
2025-07-13,10175.03,payroll,out,Counterparty_77,20926832.62,2025-06-04,2025-07-03
2025-07-13,2894.54,investment_income,in,Counterparty_66,20929727.16,,
2025-07-13,3487.09,T&E,out,Counterparty_39,20926240.07,2025-06-13,2025-07-10
2025-07-13,9532.33,T&E,out,Counterparty_61,20916707.74,2025-06-12,2025-07-16
2025-07-13,693.63,investment_income,in,Counterparty_61,20917401.37,,
2025-07-13,854.16,customer_payment,in,Counterparty_58,20918255.53,,
2025-07-13,6169.9,loan_repayment,out,Counterparty_38,20912085.63,2025-06-26,2025-08-02
2025-07-13,1222.92,tax_payment,out,Counterparty_33,20910862.71,2025-06-10,2025-07-17
2025-07-13,3395.38,marketing_spend,out,Counterparty_43,20907467.33,2025-06-10,2025-07-10
2025-07-13,2726.65,rent,out,Counterparty_13,20904740.68,2025-06-12,2025-07-20
2025-07-13,7122.69,customer_payment,in,Counterparty_14,20911863.37,,
2025-07-13,20519.47,payroll,out,Counterparty_34,20891343.9,2025-05-31,2025-06-26
2025-07-13,4626.79,customer_payment,in,Counterparty_70,20895970.69,,
2025-07-13,5216.59,software_subscription,out,Counterparty_68,20890754.1,2025-06-14,2025-07-11
2025-07-14,7344.54,payroll,out,Counterparty_65,20883409.56,2025-06-28,2025-07-28
2025-07-14,7985.76,marketing_spend,out,Counterparty_18,20875423.8,2025-06-09,2025-07-18
2025-07-14,5742.7,investment_income,in,Counterparty_16,20881166.5,,
2025-07-14,857.95,customer_payment,in,Counterparty_60,20882024.45,,
2025-07-14,8428.69,tax_payment,out,Counterparty_35,20873595.76,2025-06-21,2025-07-27
2025-07-14,7957.41,asset_sale,in,Counterparty_97,20881553.17,,
2025-07-14,9744.2,asset_sale,in,Counterparty_5,20891297.37,,
2025-07-14,4626.87,investment_income,in,Counterparty_82,20895924.24,,
2025-07-14,4396.3,refund,in,Counterparty_31,20900320.54,,
2025-07-14,8828.45,investment_income,in,Counterparty_28,20909148.99,,
2025-07-14,8510.1,customer_payment,in,Counterparty_37,20917659.09,,
2025-07-14,465.27,loan_repayment,out,Counterparty_85,20917193.82,2025-06-20,2025-07-24
2025-07-14,11978.64,T&E,out,Counterparty_24,20905215.18,2025-06-04,2025-07-03
2025-07-14,17405.91,tax_payment,out,Counterparty_52,20887809.27,2025-05-31,2025-07-06
2025-07-14,253.82,credit,in,Counterparty_81,20888063.09,,
2025-07-14,1385.22,asset_sale,in,Counterparty_21,20889448.31,,
2025-07-14,5997.43,customer_payment,in,Counterparty_19,20895445.74,,
2025-07-14,4080.06,refund,in,Counterparty_60,20899525.8,,
2025-07-14,3015.32,asset_sale,in,Counterparty_63,20902541.12,,
2025-07-14,1284.17,credit,in,Counterparty_80,20903825.29,,
2025-07-14,712.56,credit,in,Counterparty_70,20904537.85,,
2025-07-14,10744.88,software_subscription,out,Counterparty_94,20893792.97,2025-06-09,2025-07-16
2025-07-14,6852.24,software_subscription,out,Counterparty_52,20886940.73,2025-06-18,2025-07-13
2025-07-14,8896.77,customer_payment,in,Counterparty_9,20895837.5,,
2025-07-14,4923.67,customer_payment,in,Counterparty_21,20900761.17,,
2025-07-14,9836.38,asset_sale,in,Counterparty_68,20910597.55,,
2025-07-14,20839.71,customer_payment,in,Counterparty_47,20931437.26,,
2025-07-14,2688.46,tax_payment,out,Counterparty_63,20928748.8,2025-06-25,2025-07-27
2025-07-14,2930.87,asset_sale,in,Counterparty_7,20931679.67,,
2025-07-14,1227.71,credit,in,Counterparty_68,20932907.38,,
2025-07-14,1451.72,supplier_payment,out,Counterparty_20,20931455.66,2025-06-07,2025-07-02
2025-07-14,557.05,marketing_spend,out,Counterparty_8,20930898.61,2025-06-13,2025-07-15
2025-07-14,3086.74,asset_sale,in,Counterparty_59,20933985.35,,
2025-07-14,8555.57,customer_payment,in,Counterparty_53,20942540.92,,
2025-07-14,11804.22,rent,out,Counterparty_87,20930736.7,2025-06-29,2025-07-31
2025-07-14,7974.95,payroll,out,Counterparty_65,20922761.75,2025-06-15,2025-07-23
2025-07-14,4199.7,software_subscription,out,Counterparty_11,20918562.05,2025-06-24,2025-07-26
2025-07-14,334.48,customer_payment,in,Counterparty_11,20918896.53,,
2025-07-15,6447.7,loan_repayment,out,Counterparty_31,20912448.83,2025-06-03,2025-06-29
2025-07-15,3411.73,T&E,out,Counterparty_63,20909037.1,2025-06-26,2025-07-31
2025-07-15,5038.58,asset_sale,in,Counterparty_40,20914075.68,,
2025-07-15,4340.25,asset_sale,in,Counterparty_76,20918415.93,,
2025-07-15,11043.16,marketing_spend,out,Counterparty_38,20907372.77,2025-06-14,2025-07-23
2025-07-15,15655.48,payroll,out,Counterparty_66,20891717.29,2025-06-17,2025-07-23
2025-07-15,12422.04,supplier_payment,out,Counterparty_27,20879295.25,2025-06-02,2025-07-10
2025-07-15,13851.45,utilities,out,Counterparty_6,20865443.8,2025-06-09,2025-07-18
2025-07-15,1404.71,tax_payment,out,Counterparty_8,20864039.09,2025-06-28,2025-07-27
2025-07-15,1864.74,T&E,out,Counterparty_76,20862174.35,2025-06-09,2025-07-14
2025-07-15,2621.41,tax_payment,out,Counterparty_14,20859552.94,2025-06-09,2025-07-14
2025-07-15,3603.35,software_subscription,out,Counterparty_24,20855949.59,2025-06-08,2025-07-06
2025-07-15,7.63,refund,in,Counterparty_8,20855957.22,,
2025-07-15,4827.21,loan_repayment,out,Counterparty_82,20851130.01,2025-06-19,2025-07-26
2025-07-15,11858.57,supplier_payment,out,Counterparty_9,20839271.44,2025-06-22,2025-07-23
2025-07-15,303.67,rent,out,Counterparty_23,20838967.77,2025-06-09,2025-07-14
2025-07-15,3930.6,customer_payment,in,Counterparty_58,20842898.37,,
2025-07-15,3849.5,asset_sale,in,Counterparty_76,20846747.87,,
2025-07-15,1506.28,investment_income,in,Counterparty_50,20848254.15,,
2025-07-15,4493.51,software_subscription,out,Counterparty_68,20843760.64,2025-06-07,2025-07-10
2025-07-15,8191.52,utilities,out,Counterparty_52,20835569.12,2025-06-08,2025-07-03
2025-07-15,4302.92,loan_repayment,out,Counterparty_19,20831266.2,2025-06-30,2025-07-29
2025-07-15,3838.95,payroll,out,Counterparty_38,20827427.25,2025-06-21,2025-07-25
2025-07-15,14690.79,asset_sale,in,Counterparty_67,20842118.04,,
2025-07-15,3664.78,marketing_spend,out,Counterparty_82,20838453.26,2025-06-01,2025-07-09
2025-07-15,2914.56,software_subscription,out,Counterparty_91,20835538.7,2025-06-03,2025-07-11
2025-07-15,2613.06,loan_repayment,out,Counterparty_85,20832925.64,2025-06-27,2025-07-24
2025-07-15,3596.01,tax_payment,out,Counterparty_29,20829329.63,2025-06-14,2025-07-16
2025-07-15,4587.65,credit,in,Counterparty_12,20833917.28,,
2025-07-15,7238.17,refund,in,Counterparty_73,20841155.45,,
2025-07-15,5093.91,customer_payment,in,Counterparty_49,20846249.36,,
2025-07-15,866.32,asset_sale,in,Counterparty_48,20847115.68,,
2025-07-15,834.41,rent,out,Counterparty_7,20846281.27,2025-06-14,2025-07-16
2025-07-15,681.87,investment_income,in,Counterparty_48,20846963.14,,
2025-07-15,224.98,T&E,out,Counterparty_61,20846738.16,2025-06-16,2025-07-22
2025-07-15,4756.61,supplier_payment,out,Counterparty_74,20841981.55,2025-06-02,2025-07-03
2025-07-15,5196.35,utilities,out,Counterparty_61,20836785.2,2025-06-06,2025-07-04
2025-07-15,24.35,rent,out,Counterparty_54,20836760.85,2025-06-06,2025-07-01
2025-07-15,6271.17,loan_repayment,out,Counterparty_22,20830489.68,2025-06-20,2025-07-24
2025-07-15,5841.74,credit,in,Counterparty_51,20836331.42,,
2025-07-15,3107.3,credit,in,Counterparty_41,20839438.72,,
2025-07-15,11886.56,refund,in,Counterparty_80,20851325.28,,
2025-07-15,7155.86,utilities,out,Counterparty_29,20844169.42,2025-06-11,2025-07-14
2025-07-15,4742.88,credit,in,Counterparty_49,20848912.3,,
2025-07-15,24426.43,asset_sale,in,Counterparty_45,20873338.73,,
2025-07-15,8103.41,credit,in,Counterparty_20,20881442.14,,
2025-07-15,5633.13,asset_sale,in,Counterparty_32,20887075.27,,
2025-07-16,2833.4,asset_sale,in,Counterparty_49,20889908.67,,
2025-07-16,405.71,T&E,out,Counterparty_4,20889502.96,2025-07-01,2025-07-30
2025-07-16,4709.56,customer_payment,in,Counterparty_33,20894212.52,,
2025-07-16,4753.62,payroll,out,Counterparty_50,20889458.9,2025-06-12,2025-07-09
2025-07-16,2677.83,utilities,out,Counterparty_65,20886781.07,2025-06-09,2025-07-09
2025-07-16,1831.65,loan_repayment,out,Counterparty_32,20884949.42,2025-06-18,2025-07-27
2025-07-16,5873.38,supplier_payment,out,Counterparty_56,20879076.04,2025-06-18,2025-07-24
2025-07-16,11859.52,utilities,out,Counterparty_77,20867216.52,2025-06-20,2025-07-18
2025-07-16,2064.39,customer_payment,in,Counterparty_51,20869280.91,,
2025-07-16,13354.68,investment_income,in,Counterparty_58,20882635.59,,
2025-07-16,2285.33,marketing_spend,out,Counterparty_45,20880350.26,2025-06-12,2025-07-09
2025-07-16,37.18,refund,in,Counterparty_94,20880387.44,,
2025-07-16,3541.39,tax_payment,out,Counterparty_16,20876846.05,2025-06-22,2025-07-22
2025-07-16,7246.6,marketing_spend,out,Counterparty_42,20869599.45,2025-06-17,2025-07-12
2025-07-16,2203.09,T&E,out,Counterparty_16,20867396.36,2025-06-16,2025-07-11
2025-07-16,5607.9,investment_income,in,Counterparty_82,20873004.26,,
2025-07-16,1218.97,tax_payment,out,Counterparty_76,20871785.29,2025-06-16,2025-07-13
2025-07-16,2552.14,marketing_spend,out,Counterparty_31,20869233.15,2025-06-22,2025-07-20
2025-07-16,2444.27,refund,in,Counterparty_28,20871677.42,,
2025-07-16,3030.93,credit,in,Counterparty_41,20874708.35,,
2025-07-16,11402.5,tax_payment,out,Counterparty_51,20863305.85,2025-06-15,2025-07-21
2025-07-16,2600.19,asset_sale,in,Counterparty_3,20865906.04,,
2025-07-16,3693.79,tax_payment,out,Counterparty_7,20862212.25,2025-06-15,2025-07-10
2025-07-16,2650.61,marketing_spend,out,Counterparty_83,20859561.64,2025-06-21,2025-07-23
2025-07-16,3835.39,T&E,out,Counterparty_86,20855726.25,2025-06-13,2025-07-08
2025-07-16,5263.42,tax_payment,out,Counterparty_83,20850462.83,2025-06-28,2025-07-28
2025-07-16,2278.99,marketing_spend,out,Counterparty_15,20848183.84,2025-06-20,2025-07-24
2025-07-16,2642.13,refund,in,Counterparty_34,20850825.97,,
2025-07-16,342.43,utilities,out,Counterparty_37,20850483.54,2025-06-28,2025-07-29
2025-07-16,13027.93,utilities,out,Counterparty_56,20837455.61,2025-06-02,2025-07-06
2025-07-16,895.03,T&E,out,Counterparty_78,20836560.58,2025-06-27,2025-07-27
2025-07-16,5107.0,tax_payment,out,Counterparty_18,20831453.58,2025-06-02,2025-06-30
2025-07-16,7644.73,T&E,out,Counterparty_31,20823808.85,2025-06-03,2025-06-30
2025-07-16,5423.86,rent,out,Counterparty_6,20818384.99,2025-06-25,2025-07-26
2025-07-16,6765.43,asset_sale,in,Counterparty_20,20825150.42,,
2025-07-16,1031.85,refund,in,Counterparty_69,20826182.27,,
2025-07-16,2748.38,credit,in,Counterparty_7,20828930.65,,
2025-07-16,7473.08,payroll,out,Counterparty_5,20821457.57,2025-06-08,2025-07-05
2025-07-16,1884.16,loan_repayment,out,Counterparty_11,20819573.41,2025-06-23,2025-07-20
2025-07-16,1116.13,utilities,out,Counterparty_85,20818457.28,2025-06-04,2025-07-11
2025-07-16,23754.21,customer_payment,in,Counterparty_36,20842211.49,,
2025-07-16,1946.5,refund,in,Counterparty_7,20844157.99,,
2025-07-16,1998.56,refund,in,Counterparty_11,20846156.55,,
2025-07-16,5578.07,credit,in,Counterparty_74,20851734.62,,
2025-07-16,10154.19,T&E,out,Counterparty_59,20841580.43,2025-06-09,2025-07-16
2025-07-16,3051.79,supplier_payment,out,Counterparty_61,20838528.64,2025-06-03,2025-07-07
2025-07-16,1305.24,tax_payment,out,Counterparty_22,20837223.4,2025-06-17,2025-07-12
2025-07-16,9051.06,software_subscription,out,Counterparty_59,20828172.34,2025-06-16,2025-07-11
2025-07-16,5737.7,marketing_spend,out,Counterparty_63,20822434.64,2025-07-01,2025-08-05
2025-07-16,471.1,utilities,out,Counterparty_98,20821963.54,2025-06-23,2025-07-24
2025-07-16,6079.55,supplier_payment,out,Counterparty_3,20815883.99,2025-06-12,2025-07-11
2025-07-16,1817.58,payroll,out,Counterparty_69,20814066.41,2025-06-22,2025-07-21
2025-07-16,2837.83,rent,out,Counterparty_41,20811228.58,2025-06-30,2025-07-29
2025-07-16,6470.02,refund,in,Counterparty_29,20817698.6,,
2025-07-16,1126.98,utilities,out,Counterparty_50,20816571.62,2025-06-16,2025-07-15
2025-07-16,3874.13,supplier_payment,out,Counterparty_98,20812697.49,2025-06-09,2025-07-10
2025-07-17,28960.86,supplier_payment,out,Counterparty_70,20783736.63,2025-06-03,2025-07-10
2025-07-17,3572.99,payroll,out,Counterparty_88,20780163.64,2025-06-29,2025-07-30
2025-07-17,1879.41,payroll,out,Counterparty_57,20778284.23,2025-06-20,2025-07-22
2025-07-17,6496.52,payroll,out,Counterparty_51,20771787.71,2025-06-27,2025-07-22
2025-07-17,7991.86,utilities,out,Counterparty_57,20763795.85,2025-06-14,2025-07-15
2025-07-17,753.75,utilities,out,Counterparty_56,20763042.1,2025-06-25,2025-07-23
2025-07-17,8968.43,loan_repayment,out,Counterparty_33,20754073.67,2025-07-02,2025-08-05
2025-07-17,5799.81,T&E,out,Counterparty_19,20748273.86,2025-06-03,2025-07-04
2025-07-17,4211.65,software_subscription,out,Counterparty_77,20744062.21,2025-06-21,2025-07-27
2025-07-17,2546.13,investment_income,in,Counterparty_76,20746608.34,,
2025-07-17,27375.89,supplier_payment,out,Counterparty_89,20719232.45,2025-06-10,2025-07-06
2025-07-17,21937.69,utilities,out,Counterparty_76,20697294.76,2025-06-04,2025-07-10
2025-07-17,4789.21,T&E,out,Counterparty_11,20692505.55,2025-06-15,2025-07-11
2025-07-17,14576.78,software_subscription,out,Counterparty_48,20677928.77,2025-06-05,2025-07-14
2025-07-17,9033.85,marketing_spend,out,Counterparty_36,20668894.92,2025-06-26,2025-08-04
2025-07-17,7598.63,loan_repayment,out,Counterparty_46,20661296.29,2025-06-15,2025-07-16
2025-07-17,1969.6,payroll,out,Counterparty_31,20659326.69,2025-07-01,2025-07-26
2025-07-17,3363.45,utilities,out,Counterparty_9,20655963.24,2025-06-04,2025-07-10
2025-07-17,8398.32,credit,in,Counterparty_93,20664361.56,,
2025-07-17,5453.41,tax_payment,out,Counterparty_69,20658908.15,2025-06-20,2025-07-24
2025-07-17,5041.78,investment_income,in,Counterparty_22,20663949.93,,
2025-07-17,12842.57,investment_income,in,Counterparty_19,20676792.5,,
2025-07-17,2761.87,asset_sale,in,Counterparty_40,20679554.37,,
2025-07-17,13391.9,customer_payment,in,Counterparty_21,20692946.27,,
2025-07-17,5356.14,investment_income,in,Counterparty_99,20698302.41,,
2025-07-17,6502.98,payroll,out,Counterparty_38,20691799.43,2025-06-19,2025-07-19
2025-07-17,2209.82,investment_income,in,Counterparty_92,20694009.25,,
2025-07-17,1338.47,asset_sale,in,Counterparty_22,20695347.72,,
2025-07-17,5808.96,credit,in,Counterparty_35,20701156.68,,
2025-07-17,822.72,investment_income,in,Counterparty_9,20701979.4,,
2025-07-17,3722.8,investment_income,in,Counterparty_75,20705702.2,,
2025-07-17,8542.45,customer_payment,in,Counterparty_36,20714244.65,,
2025-07-17,8492.23,refund,in,Counterparty_98,20722736.88,,
2025-07-17,13266.83,supplier_payment,out,Counterparty_23,20709470.05,2025-06-08,2025-07-08
2025-07-17,1416.78,tax_payment,out,Counterparty_90,20708053.27,2025-06-28,2025-07-31
2025-07-17,8349.7,investment_income,in,Counterparty_16,20716402.97,,
2025-07-17,548.12,credit,in,Counterparty_83,20716951.09,,
2025-07-17,1157.3,customer_payment,in,Counterparty_63,20718108.39,,
2025-07-17,10696.6,credit,in,Counterparty_85,20728804.99,,
2025-07-17,1288.62,customer_payment,in,Counterparty_24,20730093.61,,
2025-07-17,18702.0,investment_income,in,Counterparty_76,20748795.61,,
2025-07-17,5272.8,credit,in,Counterparty_82,20754068.41,,
2025-07-18,7425.73,tax_payment,out,Counterparty_67,20746642.68,2025-06-28,2025-08-05
2025-07-18,5241.79,payroll,out,Counterparty_5,20741400.89,2025-06-17,2025-07-26
2025-07-18,18328.16,T&E,out,Counterparty_39,20723072.73,2025-06-06,2025-07-01
2025-07-18,5090.78,asset_sale,in,Counterparty_1,20728163.51,,
2025-07-18,378.3,supplier_payment,out,Counterparty_93,20727785.21,2025-06-22,2025-07-19
2025-07-18,6096.78,customer_payment,in,Counterparty_94,20733881.99,,
2025-07-18,1061.89,supplier_payment,out,Counterparty_41,20732820.1,2025-06-10,2025-07-14
2025-07-18,407.32,refund,in,Counterparty_9,20733227.42,,
2025-07-18,14397.06,asset_sale,in,Counterparty_76,20747624.48,,
2025-07-18,942.27,asset_sale,in,Counterparty_86,20748566.75,,
2025-07-18,2329.06,customer_payment,in,Counterparty_5,20750895.81,,
2025-07-18,398.27,rent,out,Counterparty_32,20750497.54,2025-06-22,2025-07-18
2025-07-18,63.36,investment_income,in,Counterparty_74,20750560.9,,
2025-07-18,1281.09,refund,in,Counterparty_41,20751841.99,,
2025-07-18,1718.78,credit,in,Counterparty_53,20753560.77,,
2025-07-18,2417.39,loan_repayment,out,Counterparty_4,20751143.38,2025-06-15,2025-07-16
2025-07-18,2999.39,tax_payment,out,Counterparty_71,20748143.99,2025-06-14,2025-07-12
2025-07-18,10418.8,T&E,out,Counterparty_98,20737725.19,2025-06-11,2025-07-19
2025-07-18,2954.41,customer_payment,in,Counterparty_87,20740679.6,,
2025-07-18,14615.35,customer_payment,in,Counterparty_96,20755294.95,,
2025-07-18,1067.69,rent,out,Counterparty_6,20754227.26,2025-06-18,2025-07-25
2025-07-18,4552.08,investment_income,in,Counterparty_38,20758779.34,,
2025-07-18,559.07,credit,in,Counterparty_92,20759338.41,,
2025-07-18,3448.23,software_subscription,out,Counterparty_68,20755890.18,2025-06-15,2025-07-11
2025-07-18,807.85,customer_payment,in,Counterparty_46,20756698.03,,
2025-07-18,19315.31,T&E,out,Counterparty_86,20737382.72,2025-06-21,2025-07-24
2025-07-18,1817.42,T&E,out,Counterparty_33,20735565.3,2025-06-17,2025-07-14
2025-07-18,2035.7,marketing_spend,out,Counterparty_41,20733529.6,2025-07-01,2025-07-26
2025-07-18,1861.32,payroll,out,Counterparty_42,20731668.28,2025-06-20,2025-07-19
2025-07-18,1143.53,supplier_payment,out,Counterparty_30,20730524.75,2025-06-10,2025-07-06
2025-07-18,22054.42,supplier_payment,out,Counterparty_6,20708470.33,2025-06-16,2025-07-15
2025-07-18,13042.82,payroll,out,Counterparty_46,20695427.51,2025-06-22,2025-07-18
2025-07-18,1716.08,loan_repayment,out,Counterparty_31,20693711.43,2025-07-03,2025-08-05
2025-07-19,6167.91,marketing_spend,out,Counterparty_64,20687543.52,2025-06-26,2025-07-23
2025-07-19,281.36,credit,in,Counterparty_63,20687824.88,,
2025-07-19,502.93,credit,in,Counterparty_66,20688327.81,,
2025-07-19,2264.25,customer_payment,in,Counterparty_53,20690592.06,,
2025-07-19,5495.1,payroll,out,Counterparty_9,20685096.96,2025-07-01,2025-07-26
2025-07-19,7096.91,refund,in,Counterparty_40,20692193.87,,
2025-07-19,5939.84,payroll,out,Counterparty_33,20686254.03,2025-06-05,2025-07-02
2025-07-19,4148.89,loan_repayment,out,Counterparty_58,20682105.14,2025-06-16,2025-07-15
2025-07-19,1626.77,T&E,out,Counterparty_5,20680478.37,2025-06-19,2025-07-24
2025-07-19,2132.41,credit,in,Counterparty_28,20682610.78,,
2025-07-19,1702.7,asset_sale,in,Counterparty_83,20684313.48,,
2025-07-19,1804.39,loan_repayment,out,Counterparty_66,20682509.09,2025-06-18,2025-07-21
2025-07-19,1481.64,marketing_spend,out,Counterparty_30,20681027.45,2025-06-07,2025-07-11
2025-07-19,365.77,supplier_payment,out,Counterparty_70,20680661.68,2025-06-11,2025-07-18
2025-07-19,5472.14,supplier_payment,out,Counterparty_48,20675189.54,2025-06-17,2025-07-19
2025-07-19,5781.0,refund,in,Counterparty_63,20680970.54,,
2025-07-19,6570.42,investment_income,in,Counterparty_90,20687540.96,,
2025-07-19,10469.08,loan_repayment,out,Counterparty_10,20677071.88,2025-06-17,2025-07-17
2025-07-19,1925.51,rent,out,Counterparty_7,20675146.37,2025-07-02,2025-07-27
2025-07-19,3273.2,utilities,out,Counterparty_42,20671873.17,2025-06-28,2025-07-28
2025-07-19,1585.34,investment_income,in,Counterparty_50,20673458.51,,
2025-07-19,6239.91,software_subscription,out,Counterparty_57,20667218.6,2025-06-19,2025-07-14
2025-07-19,8206.43,customer_payment,in,Counterparty_21,20675425.03,,
2025-07-19,7709.52,T&E,out,Counterparty_62,20667715.51,2025-06-10,2025-07-06
2025-07-19,2989.14,loan_repayment,out,Counterparty_27,20664726.37,2025-07-03,2025-07-31
2025-07-19,418.92,asset_sale,in,Counterparty_86,20665145.29,,
2025-07-19,1999.42,payroll,out,Counterparty_62,20663145.87,2025-06-16,2025-07-16
2025-07-19,743.89,supplier_payment,out,Counterparty_33,20662401.98,2025-06-06,2025-07-15
2025-07-19,13807.17,credit,in,Counterparty_9,20676209.15,,
2025-07-19,2029.69,payroll,out,Counterparty_44,20674179.46,2025-06-27,2025-07-30
2025-07-19,7816.29,marketing_spend,out,Counterparty_56,20666363.17,2025-06-14,2025-07-11
2025-07-19,5269.22,customer_payment,in,Counterparty_35,20671632.39,,
2025-07-19,2222.01,asset_sale,in,Counterparty_98,20673854.4,,
2025-07-19,192.03,marketing_spend,out,Counterparty_55,20673662.37,2025-06-05,2025-07-07
2025-07-19,7287.54,asset_sale,in,Counterparty_10,20680949.91,,
2025-07-19,516.77,marketing_spend,out,Counterparty_78,20680433.14,2025-06-15,2025-07-22
2025-07-19,6814.08,asset_sale,in,Counterparty_51,20687247.22,,
2025-07-19,3623.81,investment_income,in,Counterparty_11,20690871.03,,
2025-07-19,7238.8,rent,out,Counterparty_43,20683632.23,2025-07-03,2025-08-08
2025-07-19,199.95,loan_repayment,out,Counterparty_92,20683432.28,2025-06-11,2025-07-14
2025-07-19,545.08,refund,in,Counterparty_53,20683977.36,,
2025-07-20,11892.6,asset_sale,in,Counterparty_42,20695869.96,,
2025-07-20,9436.3,investment_income,in,Counterparty_71,20705306.26,,
2025-07-20,4423.6,supplier_payment,out,Counterparty_17,20700882.66,2025-06-18,2025-07-14
2025-07-20,2763.21,software_subscription,out,Counterparty_72,20698119.45,2025-06-14,2025-07-12
2025-07-20,360.76,tax_payment,out,Counterparty_86,20697758.69,2025-06-25,2025-07-25
2025-07-20,8365.83,marketing_spend,out,Counterparty_51,20689392.86,2025-06-17,2025-07-17
2025-07-20,3493.34,investment_income,in,Counterparty_90,20692886.2,,
2025-07-20,860.36,refund,in,Counterparty_81,20693746.56,,
2025-07-20,16137.37,tax_payment,out,Counterparty_7,20677609.19,2025-07-03,2025-08-10
2025-07-20,637.1,payroll,out,Counterparty_69,20676972.09,2025-06-23,2025-07-29
2025-07-20,20365.48,payroll,out,Counterparty_66,20656606.61,2025-06-22,2025-07-29
2025-07-20,1965.33,credit,in,Counterparty_68,20658571.94,,
2025-07-20,8314.2,tax_payment,out,Counterparty_93,20650257.74,2025-06-16,2025-07-20
2025-07-20,2387.54,customer_payment,in,Counterparty_66,20652645.28,,
2025-07-20,233.33,rent,out,Counterparty_42,20652411.95,2025-07-03,2025-08-06
2025-07-20,3967.21,marketing_spend,out,Counterparty_47,20648444.74,2025-06-28,2025-07-30
2025-07-20,281.15,T&E,out,Counterparty_82,20648163.59,2025-06-07,2025-07-16
2025-07-20,5670.72,marketing_spend,out,Counterparty_6,20642492.87,2025-06-18,2025-07-27
2025-07-20,1786.67,asset_sale,in,Counterparty_35,20644279.54,,
2025-07-20,324.43,utilities,out,Counterparty_39,20643955.11,2025-06-26,2025-07-23
2025-07-20,22219.03,utilities,out,Counterparty_24,20621736.08,2025-07-04,2025-07-31
2025-07-20,697.33,rent,out,Counterparty_8,20621038.75,2025-06-09,2025-07-07
2025-07-20,1639.38,supplier_payment,out,Counterparty_68,20619399.37,2025-06-14,2025-07-11
2025-07-20,6903.66,T&E,out,Counterparty_37,20612495.71,2025-06-08,2025-07-14
2025-07-20,12169.61,rent,out,Counterparty_89,20600326.1,2025-06-27,2025-07-25
2025-07-20,4872.62,software_subscription,out,Counterparty_75,20595453.48,2025-06-14,2025-07-10
2025-07-20,1367.5,supplier_payment,out,Counterparty_28,20594085.98,2025-06-28,2025-08-04
2025-07-20,4180.34,utilities,out,Counterparty_14,20589905.64,2025-06-09,2025-07-14
2025-07-20,1493.1,T&E,out,Counterparty_40,20588412.54,2025-06-30,2025-08-02
2025-07-20,125.25,investment_income,in,Counterparty_63,20588537.79,,
2025-07-20,158.47,utilities,out,Counterparty_91,20588379.32,2025-06-15,2025-07-22
2025-07-20,5789.08,payroll,out,Counterparty_48,20582590.24,2025-06-09,2025-07-15
2025-07-20,2634.53,investment_income,in,Counterparty_53,20585224.77,,
2025-07-20,62.09,tax_payment,out,Counterparty_47,20585162.68,2025-07-02,2025-08-09
2025-07-20,291.57,rent,out,Counterparty_59,20584871.11,2025-06-25,2025-07-20
2025-07-20,4878.18,software_subscription,out,Counterparty_55,20579992.93,2025-06-09,2025-07-07
2025-07-20,118.43,credit,in,Counterparty_70,20580111.36,,
2025-07-20,20479.3,credit,in,Counterparty_45,20600590.66,,
2025-07-20,842.83,software_subscription,out,Counterparty_66,20599747.83,2025-06-06,2025-07-10
2025-07-21,8349.17,credit,in,Counterparty_60,20608097.0,,
2025-07-21,2559.12,investment_income,in,Counterparty_54,20610656.12,,
2025-07-21,10659.5,asset_sale,in,Counterparty_44,20621315.62,,
2025-07-21,7098.8,investment_income,in,Counterparty_24,20628414.42,,
2025-07-21,5139.2,refund,in,Counterparty_28,20633553.62,,
2025-07-21,3674.4,marketing_spend,out,Counterparty_36,20629879.22,2025-06-09,2025-07-08
2025-07-21,619.9,customer_payment,in,Counterparty_44,20630499.12,,
2025-07-21,2759.35,credit,in,Counterparty_94,20633258.47,,
2025-07-21,149.31,software_subscription,out,Counterparty_23,20633109.16,2025-07-02,2025-07-30
2025-07-21,1860.37,investment_income,in,Counterparty_47,20634969.53,,
2025-07-21,4363.69,customer_payment,in,Counterparty_75,20639333.22,,
2025-07-21,602.42,credit,in,Counterparty_5,20639935.64,,
2025-07-21,4109.04,refund,in,Counterparty_45,20644044.68,,
2025-07-21,661.33,refund,in,Counterparty_36,20644706.01,,
2025-07-21,946.74,software_subscription,out,Counterparty_95,20643759.27,2025-06-09,2025-07-08
2025-07-21,7832.33,rent,out,Counterparty_90,20635926.94,2025-06-26,2025-07-29
2025-07-21,485.84,refund,in,Counterparty_65,20636412.78,,
2025-07-21,445.88,asset_sale,in,Counterparty_66,20636858.66,,
2025-07-21,870.37,credit,in,Counterparty_93,20637729.03,,
2025-07-21,8575.18,credit,in,Counterparty_87,20646304.21,,
2025-07-21,9958.46,rent,out,Counterparty_50,20636345.75,2025-06-23,2025-07-21
2025-07-21,7030.83,customer_payment,in,Counterparty_91,20643376.58,,
2025-07-21,5616.42,rent,out,Counterparty_86,20637760.16,2025-06-20,2025-07-19
2025-07-21,8018.06,customer_payment,in,Counterparty_16,20645778.22,,
2025-07-21,1427.96,loan_repayment,out,Counterparty_6,20644350.26,2025-06-11,2025-07-06
2025-07-21,2649.05,loan_repayment,out,Counterparty_82,20641701.21,2025-06-21,2025-07-19
2025-07-21,1814.93,T&E,out,Counterparty_44,20639886.28,2025-07-06,2025-08-09
2025-07-21,1580.22,asset_sale,in,Counterparty_22,20641466.5,,
2025-07-21,14948.75,customer_payment,in,Counterparty_96,20656415.25,,
2025-07-21,6556.06,investment_income,in,Counterparty_3,20662971.31,,
2025-07-21,5667.38,asset_sale,in,Counterparty_6,20668638.69,,
2025-07-21,1351.71,tax_payment,out,Counterparty_88,20667286.98,2025-06-29,2025-07-28
2025-07-21,1247.03,refund,in,Counterparty_31,20668534.01,,
2025-07-21,4435.06,refund,in,Counterparty_96,20672969.07,,
2025-07-21,274.75,investment_income,in,Counterparty_85,20673243.82,,
2025-07-21,10494.25,refund,in,Counterparty_78,20683738.07,,
2025-07-21,6457.6,credit,in,Counterparty_48,20690195.67,,
2025-07-21,964.87,utilities,out,Counterparty_91,20689230.8,2025-06-29,2025-07-29
2025-07-21,5686.89,credit,in,Counterparty_89,20694917.69,,
2025-07-21,629.96,customer_payment,in,Counterparty_46,20695547.65,,
2025-07-21,4119.31,software_subscription,out,Counterparty_43,20691428.34,2025-06-12,2025-07-16
2025-07-21,1106.23,tax_payment,out,Counterparty_43,20690322.11,2025-06-28,2025-07-27
2025-07-21,556.23,investment_income,in,Counterparty_98,20690878.34,,
2025-07-21,1351.4,credit,in,Counterparty_87,20692229.74,,
2025-07-21,4239.44,asset_sale,in,Counterparty_95,20696469.18,,
2025-07-21,15573.64,customer_payment,in,Counterparty_73,20712042.82,,
2025-07-21,1572.73,payroll,out,Counterparty_40,20710470.09,2025-07-06,2025-08-07
2025-07-21,14641.14,investment_income,in,Counterparty_2,20725111.23,,
2025-07-21,9996.12,T&E,out,Counterparty_73,20715115.11,2025-06-09,2025-07-16
2025-07-21,2482.27,asset_sale,in,Counterparty_65,20717597.38,,
2025-07-21,5054.78,customer_payment,in,Counterparty_56,20722652.16,,
2025-07-21,284.08,customer_payment,in,Counterparty_25,20722936.24,,
2025-07-21,557.08,refund,in,Counterparty_48,20723493.32,,
2025-07-21,9398.33,tax_payment,out,Counterparty_63,20714094.99,2025-06-13,2025-07-11
2025-07-21,2872.11,asset_sale,in,Counterparty_65,20716967.1,,
2025-07-21,3803.12,refund,in,Counterparty_26,20720770.22,,
2025-07-21,3368.97,credit,in,Counterparty_59,20724139.19,,
2025-07-21,761.99,credit,in,Counterparty_23,20724901.18,,
2025-07-21,12150.39,payroll,out,Counterparty_87,20712750.79,2025-06-14,2025-07-22
2025-07-21,2100.53,supplier_payment,out,Counterparty_47,20710650.26,2025-06-30,2025-07-30
2025-07-21,6406.3,loan_repayment,out,Counterparty_63,20704243.96,2025-06-12,2025-07-15
2025-07-22,160.87,loan_repayment,out,Counterparty_76,20704083.09,2025-06-19,2025-07-18
2025-07-22,4459.14,customer_payment,in,Counterparty_34,20708542.23,,
2025-07-22,858.06,tax_payment,out,Counterparty_54,20707684.17,2025-06-11,2025-07-07
2025-07-22,621.82,payroll,out,Counterparty_22,20707062.35,2025-07-07,2025-08-13
2025-07-22,782.31,customer_payment,in,Counterparty_2,20707844.66,,
2025-07-22,2142.87,rent,out,Counterparty_77,20705701.79,2025-06-08,2025-07-13
2025-07-22,8377.09,refund,in,Counterparty_7,20714078.88,,
2025-07-22,18282.39,asset_sale,in,Counterparty_77,20732361.27,,
2025-07-22,5653.4,loan_repayment,out,Counterparty_52,20726707.87,2025-06-09,2025-07-07
2025-07-22,342.6,asset_sale,in,Counterparty_22,20727050.47,,
2025-07-22,243.22,payroll,out,Counterparty_8,20726807.25,2025-07-06,2025-08-06
2025-07-22,6038.05,rent,out,Counterparty_89,20720769.2,2025-07-07,2025-08-01
2025-07-22,10416.38,utilities,out,Counterparty_77,20710352.82,2025-07-04,2025-08-12
2025-07-22,57.66,asset_sale,in,Counterparty_86,20710410.48,,
2025-07-22,4279.66,investment_income,in,Counterparty_34,20714690.14,,
2025-07-22,417.98,refund,in,Counterparty_3,20715108.12,,
2025-07-22,2544.29,asset_sale,in,Counterparty_79,20717652.41,,
2025-07-22,832.41,supplier_payment,out,Counterparty_39,20716820.0,2025-06-17,2025-07-24
2025-07-22,9145.76,tax_payment,out,Counterparty_11,20707674.24,2025-06-25,2025-08-02
2025-07-22,4922.57,marketing_spend,out,Counterparty_3,20702751.67,2025-06-22,2025-07-27
2025-07-22,1958.63,asset_sale,in,Counterparty_27,20704710.3,,
2025-07-22,4359.21,utilities,out,Counterparty_19,20700351.09,2025-06-19,2025-07-15
2025-07-22,2976.38,payroll,out,Counterparty_17,20697374.71,2025-06-12,2025-07-09
2025-07-22,5144.7,loan_repayment,out,Counterparty_10,20692230.01,2025-06-22,2025-07-17
2025-07-22,4414.03,investment_income,in,Counterparty_60,20696644.04,,
2025-07-22,48.5,loan_repayment,out,Counterparty_39,20696595.54,2025-06-26,2025-07-29
2025-07-22,1659.86,customer_payment,in,Counterparty_76,20698255.4,,
2025-07-22,11678.43,asset_sale,in,Counterparty_54,20709933.83,,
2025-07-22,2600.46,credit,in,Counterparty_93,20712534.29,,
2025-07-22,1382.61,rent,out,Counterparty_13,20711151.68,2025-06-11,2025-07-11
2025-07-22,1452.24,customer_payment,in,Counterparty_18,20712603.92,,
2025-07-22,10508.15,credit,in,Counterparty_86,20723112.07,,
2025-07-22,5066.09,payroll,out,Counterparty_15,20718045.98,2025-06-29,2025-07-25
2025-07-22,0.54,customer_payment,in,Counterparty_65,20718046.52,,
2025-07-22,7329.37,rent,out,Counterparty_63,20710717.15,2025-06-23,2025-08-01
2025-07-22,13456.7,marketing_spend,out,Counterparty_65,20697260.45,2025-07-03,2025-08-01
2025-07-22,6067.3,customer_payment,in,Counterparty_52,20703327.75,,
2025-07-22,1882.29,utilities,out,Counterparty_76,20701445.46,2025-07-04,2025-08-11
2025-07-22,1220.9,tax_payment,out,Counterparty_33,20700224.56,2025-06-08,2025-07-11
2025-07-22,2556.53,customer_payment,in,Counterparty_46,20702781.09,,
2025-07-22,6341.69,customer_payment,in,Counterparty_80,20709122.78,,
2025-07-22,2341.32,asset_sale,in,Counterparty_5,20711464.1,,
2025-07-22,870.96,tax_payment,out,Counterparty_82,20710593.14,2025-07-04,2025-07-29
2025-07-22,14245.83,supplier_payment,out,Counterparty_71,20696347.31,2025-07-01,2025-08-02
2025-07-22,13037.43,investment_income,in,Counterparty_22,20709384.74,,
2025-07-22,2518.04,investment_income,in,Counterparty_76,20711902.78,,
2025-07-22,6488.01,tax_payment,out,Counterparty_51,20705414.77,2025-06-16,2025-07-22
2025-07-22,4250.91,refund,in,Counterparty_72,20709665.68,,
2025-07-22,4435.86,supplier_payment,out,Counterparty_15,20705229.82,2025-06-19,2025-07-20
2025-07-22,5797.68,utilities,out,Counterparty_47,20699432.14,2025-07-04,2025-08-05
2025-07-22,4038.48,refund,in,Counterparty_65,20703470.62,,
2025-07-22,765.81,customer_payment,in,Counterparty_69,20704236.43,,
2025-07-23,1877.45,loan_repayment,out,Counterparty_19,20702358.98,2025-06-10,2025-07-06
2025-07-23,6981.88,software_subscription,out,Counterparty_99,20695377.1,2025-06-18,2025-07-19
2025-07-23,4818.45,supplier_payment,out,Counterparty_21,20690558.65,2025-07-01,2025-07-27
2025-07-23,4997.72,tax_payment,out,Counterparty_36,20685560.93,2025-06-10,2025-07-10
2025-07-23,2455.54,software_subscription,out,Counterparty_41,20683105.39,2025-06-22,2025-07-19
2025-07-23,1003.44,utilities,out,Counterparty_74,20682101.95,2025-06-23,2025-08-01
2025-07-23,3556.39,T&E,out,Counterparty_91,20678545.56,2025-06-24,2025-07-30
2025-07-23,5373.2,supplier_payment,out,Counterparty_63,20673172.36,2025-07-07,2025-08-12
2025-07-23,3914.36,investment_income,in,Counterparty_63,20677086.72,,
2025-07-23,3568.8,asset_sale,in,Counterparty_47,20680655.52,,
2025-07-23,2038.99,loan_repayment,out,Counterparty_75,20678616.53,2025-06-24,2025-07-21
2025-07-23,2179.5,investment_income,in,Counterparty_90,20680796.03,,
2025-07-23,11018.03,customer_payment,in,Counterparty_30,20691814.06,,
2025-07-23,565.89,customer_payment,in,Counterparty_80,20692379.95,,
2025-07-23,2465.65,software_subscription,out,Counterparty_55,20689914.3,2025-06-26,2025-07-24
2025-07-23,6967.2,payroll,out,Counterparty_5,20682947.1,2025-06-12,2025-07-07
2025-07-23,1004.73,investment_income,in,Counterparty_2,20683951.83,,
2025-07-23,12851.22,refund,in,Counterparty_20,20696803.05,,
2025-07-23,10018.01,refund,in,Counterparty_5,20706821.06,,
2025-07-23,130.0,rent,out,Counterparty_5,20706691.06,2025-07-02,2025-07-29
2025-07-23,8330.32,customer_payment,in,Counterparty_76,20715021.38,,
2025-07-23,3382.57,credit,in,Counterparty_21,20718403.95,,
2025-07-23,249.32,loan_repayment,out,Counterparty_36,20718154.63,2025-06-12,2025-07-16
2025-07-23,3971.4,payroll,out,Counterparty_79,20714183.23,2025-06-21,2025-07-24
2025-07-23,1460.14,refund,in,Counterparty_15,20715643.37,,
2025-07-23,747.51,supplier_payment,out,Counterparty_55,20714895.86,2025-06-28,2025-07-31
2025-07-23,11871.45,credit,in,Counterparty_60,20726767.31,,
2025-07-23,201.91,asset_sale,in,Counterparty_12,20726969.22,,
2025-07-23,1334.87,utilities,out,Counterparty_64,20725634.35,2025-06-12,2025-07-08
2025-07-23,1277.92,credit,in,Counterparty_74,20726912.27,,
2025-07-23,18888.7,rent,out,Counterparty_13,20708023.57,2025-06-23,2025-07-29
2025-07-23,8641.3,asset_sale,in,Counterparty_69,20716664.87,,
2025-07-23,673.13,T&E,out,Counterparty_42,20715991.74,2025-06-16,2025-07-22
2025-07-23,6162.14,loan_repayment,out,Counterparty_89,20709829.6,2025-06-17,2025-07-15
2025-07-23,778.41,asset_sale,in,Counterparty_80,20710608.01,,
2025-07-23,16667.72,credit,in,Counterparty_83,20727275.73,,
2025-07-23,3079.81,investment_income,in,Counterparty_85,20730355.54,,
2025-07-23,1529.73,supplier_payment,out,Counterparty_4,20728825.81,2025-06-14,2025-07-21
2025-07-23,3119.06,credit,in,Counterparty_58,20731944.87,,
2025-07-23,9510.44,investment_income,in,Counterparty_7,20741455.31,,
2025-07-23,2564.49,customer_payment,in,Counterparty_61,20744019.8,,
2025-07-23,38792.42,refund,in,Counterparty_67,20782812.22,,
2025-07-23,4188.05,payroll,out,Counterparty_95,20778624.17,2025-07-05,2025-08-05
2025-07-23,5117.57,rent,out,Counterparty_5,20773506.6,2025-06-13,2025-07-17
2025-07-23,6719.6,utilities,out,Counterparty_57,20766787.0,2025-06-23,2025-07-27
2025-07-23,1839.53,utilities,out,Counterparty_80,20764947.47,2025-06-30,2025-07-26
2025-07-23,5750.34,tax_payment,out,Counterparty_66,20759197.13,2025-06-29,2025-07-26
2025-07-23,8916.54,loan_repayment,out,Counterparty_81,20750280.59,2025-06-23,2025-07-30
2025-07-24,9227.88,utilities,out,Counterparty_60,20741052.71,2025-06-28,2025-08-01
2025-07-24,494.7,asset_sale,in,Counterparty_79,20741547.41,,
2025-07-24,4520.06,asset_sale,in,Counterparty_25,20746067.47,,
2025-07-24,10438.4,loan_repayment,out,Counterparty_55,20735629.07,2025-07-08,2025-08-15
2025-07-24,11688.23,software_subscription,out,Counterparty_74,20723940.84,2025-06-26,2025-08-02
2025-07-24,1810.15,investment_income,in,Counterparty_36,20725750.99,,
2025-07-24,7886.09,supplier_payment,out,Counterparty_11,20717864.9,2025-06-19,2025-07-20
2025-07-24,1203.59,investment_income,in,Counterparty_54,20719068.49,,
2025-07-24,1821.15,customer_payment,in,Counterparty_34,20720889.64,,
2025-07-24,16063.8,marketing_spend,out,Counterparty_37,20704825.84,2025-06-23,2025-07-19
2025-07-24,10547.6,marketing_spend,out,Counterparty_44,20694278.24,2025-06-27,2025-07-22
2025-07-24,2161.27,payroll,out,Counterparty_65,20692116.97,2025-06-23,2025-07-25
2025-07-24,588.37,rent,out,Counterparty_88,20691528.6,2025-06-18,2025-07-17
2025-07-24,923.46,supplier_payment,out,Counterparty_74,20690605.14,2025-06-24,2025-07-20
2025-07-24,3909.75,refund,in,Counterparty_40,20694514.89,,
2025-07-24,831.23,payroll,out,Counterparty_88,20693683.66,2025-07-04,2025-08-08
2025-07-24,475.64,rent,out,Counterparty_26,20693208.02,2025-07-05,2025-08-11
2025-07-24,1817.17,customer_payment,in,Counterparty_73,20695025.19,,
2025-07-24,3508.07,asset_sale,in,Counterparty_42,20698533.26,,
2025-07-24,1260.89,payroll,out,Counterparty_45,20697272.37,2025-07-06,2025-08-01
2025-07-24,7363.98,asset_sale,in,Counterparty_52,20704636.35,,
2025-07-24,1814.9,refund,in,Counterparty_46,20706451.25,,
2025-07-24,7824.18,software_subscription,out,Counterparty_91,20698627.07,2025-06-15,2025-07-21
2025-07-24,343.69,asset_sale,in,Counterparty_46,20698970.76,,
2025-07-24,99.42,tax_payment,out,Counterparty_41,20698871.34,2025-06-24,2025-07-26
2025-07-24,34.14,marketing_spend,out,Counterparty_70,20698837.2,2025-06-17,2025-07-17
2025-07-24,1421.06,refund,in,Counterparty_80,20700258.26,,
2025-07-24,2892.78,tax_payment,out,Counterparty_86,20697365.48,2025-06-13,2025-07-22
2025-07-24,5910.5,customer_payment,in,Counterparty_19,20703275.98,,
2025-07-24,14195.83,tax_payment,out,Counterparty_32,20689080.15,2025-07-06,2025-08-09
2025-07-24,5960.42,T&E,out,Counterparty_54,20683119.73,2025-06-29,2025-08-04
2025-07-24,5445.62,utilities,out,Counterparty_9,20677674.11,2025-07-06,2025-08-11
2025-07-24,2561.57,rent,out,Counterparty_18,20675112.54,2025-06-21,2025-07-23
2025-07-24,2713.05,software_subscription,out,Counterparty_3,20672399.49,2025-07-07,2025-08-13
2025-07-24,702.07,credit,in,Counterparty_85,20673101.56,,
2025-07-24,5709.78,rent,out,Counterparty_88,20667391.78,2025-07-03,2025-07-29
2025-07-24,3185.56,marketing_spend,out,Counterparty_69,20664206.22,2025-06-28,2025-08-02
2025-07-24,7129.92,asset_sale,in,Counterparty_79,20671336.14,,
2025-07-24,8080.46,tax_payment,out,Counterparty_83,20663255.68,2025-06-14,2025-07-21
2025-07-24,6429.51,refund,in,Counterparty_37,20669685.19,,
2025-07-24,656.69,credit,in,Counterparty_76,20670341.88,,
2025-07-24,14676.65,rent,out,Counterparty_98,20655665.23,2025-06-12,2025-07-15
2025-07-24,96.96,supplier_payment,out,Counterparty_85,20655568.27,2025-06-11,2025-07-12
2025-07-24,5967.13,software_subscription,out,Counterparty_48,20649601.14,2025-06-11,2025-07-14
2025-07-25,3613.18,customer_payment,in,Counterparty_91,20653214.32,,
2025-07-25,401.11,loan_repayment,out,Counterparty_73,20652813.21,2025-06-20,2025-07-19
2025-07-25,4953.39,loan_repayment,out,Counterparty_16,20647859.82,2025-06-24,2025-07-19
2025-07-25,19110.93,credit,in,Counterparty_25,20666970.75,,
2025-07-25,19802.35,loan_repayment,out,Counterparty_25,20647168.4,2025-06-18,2025-07-27
2025-07-25,5143.75,software_subscription,out,Counterparty_26,20642024.65,2025-06-29,2025-07-31
2025-07-25,13252.47,tax_payment,out,Counterparty_17,20628772.18,2025-07-09,2025-08-17
2025-07-25,9974.24,T&E,out,Counterparty_74,20618797.94,2025-06-16,2025-07-12
2025-07-25,12336.13,customer_payment,in,Counterparty_35,20631134.07,,
2025-07-25,18297.42,refund,in,Counterparty_96,20649431.49,,
2025-07-25,1131.76,asset_sale,in,Counterparty_91,20650563.25,,
2025-07-25,3299.31,utilities,out,Counterparty_1,20647263.94,2025-06-26,2025-07-29
2025-07-25,16440.9,asset_sale,in,Counterparty_88,20663704.84,,
2025-07-25,3469.69,asset_sale,in,Counterparty_95,20667174.53,,
2025-07-25,909.14,payroll,out,Counterparty_56,20666265.39,2025-07-03,2025-08-03
2025-07-25,3939.5,refund,in,Counterparty_29,20670204.89,,
2025-07-25,579.68,refund,in,Counterparty_54,20670784.57,,
2025-07-25,1772.49,customer_payment,in,Counterparty_15,20672557.06,,
2025-07-25,3163.15,marketing_spend,out,Counterparty_40,20669393.91,2025-06-18,2025-07-23
2025-07-25,6171.2,rent,out,Counterparty_51,20663222.71,2025-06-30,2025-08-04
2025-07-25,4943.65,software_subscription,out,Counterparty_37,20658279.06,2025-07-06,2025-08-04
2025-07-25,3032.71,customer_payment,in,Counterparty_44,20661311.77,,
2025-07-25,5288.78,credit,in,Counterparty_74,20666600.55,,
2025-07-25,8720.73,customer_payment,in,Counterparty_34,20675321.28,,
2025-07-25,1613.43,tax_payment,out,Counterparty_30,20673707.85,2025-07-03,2025-07-29
2025-07-25,6257.81,rent,out,Counterparty_14,20667450.04,2025-06-26,2025-07-22
2025-07-25,7974.93,marketing_spend,out,Counterparty_96,20659475.11,2025-06-26,2025-07-26
2025-07-25,2586.7,asset_sale,in,Counterparty_32,20662061.81,,
2025-07-25,6444.25,refund,in,Counterparty_42,20668506.06,,
2025-07-25,4010.83,refund,in,Counterparty_8,20672516.89,,
2025-07-25,302.89,asset_sale,in,Counterparty_40,20672819.78,,
2025-07-25,2521.65,T&E,out,Counterparty_84,20670298.13,2025-06-17,2025-07-20
2025-07-25,2004.41,asset_sale,in,Counterparty_3,20672302.54,,
2025-07-25,3206.51,payroll,out,Counterparty_23,20669096.03,2025-07-07,2025-08-10
2025-07-25,4498.55,refund,in,Counterparty_11,20673594.58,,
2025-07-25,399.28,credit,in,Counterparty_98,20673993.86,,
2025-07-25,255.57,marketing_spend,out,Counterparty_93,20673738.29,2025-06-19,2025-07-24
2025-07-25,1574.0,software_subscription,out,Counterparty_75,20672164.29,2025-07-08,2025-08-03
2025-07-25,2571.38,rent,out,Counterparty_90,20669592.91,2025-07-07,2025-08-13
2025-07-26,4232.18,payroll,out,Counterparty_19,20665360.73,2025-06-25,2025-07-31
2025-07-26,9753.51,credit,in,Counterparty_12,20675114.24,,
2025-07-26,941.09,rent,out,Counterparty_10,20674173.15,2025-06-15,2025-07-15
2025-07-26,2575.7,refund,in,Counterparty_30,20676748.85,,
2025-07-26,3332.21,credit,in,Counterparty_43,20680081.06,,
2025-07-26,2630.74,credit,in,Counterparty_20,20682711.8,,
2025-07-26,2207.43,credit,in,Counterparty_36,20684919.23,,
2025-07-26,1308.19,utilities,out,Counterparty_18,20683611.04,2025-07-02,2025-08-03
2025-07-26,12755.96,software_subscription,out,Counterparty_82,20670855.08,2025-06-16,2025-07-11
2025-07-26,4859.37,marketing_spend,out,Counterparty_26,20665995.71,2025-07-08,2025-08-02
2025-07-26,2691.44,rent,out,Counterparty_99,20663304.27,2025-07-07,2025-08-05
2025-07-26,3662.01,payroll,out,Counterparty_93,20659642.26,2025-06-29,2025-07-29
2025-07-26,1353.52,software_subscription,out,Counterparty_56,20658288.74,2025-06-19,2025-07-18
2025-07-26,1781.89,utilities,out,Counterparty_76,20656506.85,2025-06-29,2025-07-26
2025-07-26,6694.5,supplier_payment,out,Counterparty_41,20649812.35,2025-06-22,2025-07-28
2025-07-26,5388.64,credit,in,Counterparty_35,20655200.99,,
2025-07-26,1863.25,marketing_spend,out,Counterparty_3,20653337.74,2025-06-19,2025-07-27
2025-07-26,4649.01,credit,in,Counterparty_14,20657986.75,,
2025-07-26,9336.52,customer_payment,in,Counterparty_25,20667323.27,,
2025-07-26,4907.05,utilities,out,Counterparty_77,20662416.22,2025-06-22,2025-07-31
2025-07-26,10398.98,T&E,out,Counterparty_50,20652017.24,2025-06-13,2025-07-17
2025-07-26,8526.66,asset_sale,in,Counterparty_78,20660543.9,,
2025-07-26,4754.35,credit,in,Counterparty_67,20665298.25,,
2025-07-26,6641.1,rent,out,Counterparty_50,20658657.15,2025-06-24,2025-07-24
2025-07-26,2567.39,asset_sale,in,Counterparty_36,20661224.54,,
2025-07-26,2055.16,tax_payment,out,Counterparty_59,20659169.38,2025-07-02,2025-07-30
2025-07-26,330.17,payroll,out,Counterparty_77,20658839.21,2025-06-13,2025-07-15
2025-07-26,6807.59,software_subscription,out,Counterparty_68,20652031.62,2025-06-22,2025-07-18
2025-07-26,9504.31,marketing_spend,out,Counterparty_62,20642527.31,2025-06-19,2025-07-19
2025-07-26,2347.26,rent,out,Counterparty_12,20640180.05,2025-06-30,2025-07-29
2025-07-26,4017.86,refund,in,Counterparty_24,20644197.91,,
2025-07-26,850.43,rent,out,Counterparty_76,20643347.48,2025-07-07,2025-08-09
2025-07-26,4833.56,refund,in,Counterparty_57,20648181.04,,
2025-07-26,3655.08,refund,in,Counterparty_24,20651836.12,,
2025-07-26,2643.75,customer_payment,in,Counterparty_14,20654479.87,,
2025-07-26,1659.17,credit,in,Counterparty_19,20656139.04,,
2025-07-26,4361.44,asset_sale,in,Counterparty_55,20660500.48,,
2025-07-26,301.65,supplier_payment,out,Counterparty_5,20660198.83,2025-07-01,2025-08-09
2025-07-26,10592.3,refund,in,Counterparty_67,20670791.13,,
2025-07-26,7268.47,refund,in,Counterparty_43,20678059.6,,
2025-07-26,15172.0,refund,in,Counterparty_66,20693231.6,,
2025-07-26,29106.5,utilities,out,Counterparty_31,20664125.1,2025-06-25,2025-07-20
2025-07-26,10190.63,payroll,out,Counterparty_7,20653934.47,2025-06-13,2025-07-19
2025-07-26,11062.28,software_subscription,out,Counterparty_79,20642872.19,2025-07-11,2025-08-08
2025-07-26,1562.77,asset_sale,in,Counterparty_74,20644434.96,,
2025-07-26,124.25,customer_payment,in,Counterparty_75,20644559.21,,
2025-07-26,531.62,supplier_payment,out,Counterparty_33,20644027.59,2025-06-17,2025-07-12
2025-07-27,178.7,customer_payment,in,Counterparty_10,20644206.29,,
2025-07-27,1021.9,asset_sale,in,Counterparty_14,20645228.19,,
2025-07-27,20765.21,T&E,out,Counterparty_85,20624462.98,2025-06-21,2025-07-22
2025-07-27,3909.42,tax_payment,out,Counterparty_81,20620553.56,2025-06-25,2025-08-01
2025-07-27,2154.43,payroll,out,Counterparty_27,20618399.13,2025-06-21,2025-07-26
2025-07-27,86.71,loan_repayment,out,Counterparty_3,20618312.42,2025-06-13,2025-07-16
2025-07-27,10163.21,rent,out,Counterparty_18,20608149.21,2025-07-03,2025-08-09
2025-07-27,4951.79,loan_repayment,out,Counterparty_86,20603197.42,2025-07-09,2025-08-03
2025-07-27,138.91,rent,out,Counterparty_55,20603058.51,2025-06-30,2025-07-27
2025-07-27,5225.5,payroll,out,Counterparty_83,20597833.01,2025-07-12,2025-08-14
2025-07-27,416.08,software_subscription,out,Counterparty_38,20597416.93,2025-06-15,2025-07-12
2025-07-27,22795.21,software_subscription,out,Counterparty_84,20574621.72,2025-07-05,2025-08-02
2025-07-27,8868.94,customer_payment,in,Counterparty_97,20583490.66,,
2025-07-27,1834.96,customer_payment,in,Counterparty_8,20585325.62,,
2025-07-27,11290.79,software_subscription,out,Counterparty_69,20574034.83,2025-07-07,2025-08-09
2025-07-27,22525.82,asset_sale,in,Counterparty_68,20596560.65,,
2025-07-27,1869.63,loan_repayment,out,Counterparty_15,20594691.02,2025-07-02,2025-07-29
2025-07-27,2036.61,refund,in,Counterparty_39,20596727.63,,
2025-07-27,2583.73,utilities,out,Counterparty_57,20594143.9,2025-06-14,2025-07-20
2025-07-27,10282.99,asset_sale,in,Counterparty_10,20604426.89,,
2025-07-27,28211.77,credit,in,Counterparty_23,20632638.66,,
2025-07-27,13034.72,customer_payment,in,Counterparty_15,20645673.38,,
2025-07-27,136.43,credit,in,Counterparty_39,20645809.81,,
2025-07-27,6052.22,marketing_spend,out,Counterparty_39,20639757.59,2025-06-25,2025-07-20
2025-07-27,337.66,tax_payment,out,Counterparty_42,20639419.93,2025-06-18,2025-07-19
2025-07-27,3122.13,investment_income,in,Counterparty_41,20642542.06,,
2025-07-27,918.69,payroll,out,Counterparty_41,20641623.37,2025-06-30,2025-08-08
2025-07-27,10319.07,tax_payment,out,Counterparty_73,20631304.3,2025-06-25,2025-07-30
2025-07-27,1760.31,credit,in,Counterparty_38,20633064.61,,
2025-07-27,30.44,nsf_fee,out,Counterparty_94,20633034.17,2025-06-13,2025-07-15
2025-07-27,3626.65,tax_payment,out,Counterparty_48,20629407.52,2025-06-27,2025-08-02
2025-07-27,8727.24,payroll,out,Counterparty_20,20620680.28,2025-06-19,2025-07-14
2025-07-27,11258.33,asset_sale,in,Counterparty_56,20631938.61,,
2025-07-27,6376.49,loan_repayment,out,Counterparty_18,20625562.12,2025-07-04,2025-07-31
2025-07-27,4136.84,loan_repayment,out,Counterparty_89,20621425.28,2025-07-02,2025-07-28
2025-07-27,20165.41,refund,in,Counterparty_86,20641590.69,,
2025-07-27,356.86,payroll,out,Counterparty_19,20641233.83,2025-06-20,2025-07-26
2025-07-27,4553.72,refund,in,Counterparty_54,20645787.55,,
2025-07-27,1919.12,tax_payment,out,Counterparty_18,20643868.43,2025-06-13,2025-07-21
2025-07-27,826.6,utilities,out,Counterparty_14,20643041.83,2025-07-04,2025-08-06
2025-07-27,55.14,refund,in,Counterparty_58,20643096.97,,
2025-07-27,2028.08,tax_payment,out,Counterparty_95,20641068.89,2025-06-23,2025-07-21
2025-07-27,1066.32,software_subscription,out,Counterparty_74,20640002.57,2025-06-29,2025-08-01
2025-07-27,2160.27,supplier_payment,out,Counterparty_15,20637842.3,2025-07-06,2025-08-03
2025-07-28,10290.07,credit,in,Counterparty_74,20648132.37,,
2025-07-28,149.17,marketing_spend,out,Counterparty_19,20647983.2,2025-07-11,2025-08-11
2025-07-28,6191.97,tax_payment,out,Counterparty_63,20641791.23,2025-06-20,2025-07-24
2025-07-28,25641.43,tax_payment,out,Counterparty_82,20616149.8,2025-07-04,2025-08-03
2025-07-28,258.11,utilities,out,Counterparty_51,20615891.69,2025-06-28,2025-07-31
2025-07-28,3127.0,refund,in,Counterparty_52,20619018.69,,
2025-07-28,3681.65,investment_income,in,Counterparty_53,20622700.34,,
2025-07-28,395.25,investment_income,in,Counterparty_59,20623095.59,,
2025-07-28,78.96,supplier_payment,out,Counterparty_44,20623016.63,2025-06-22,2025-07-21
2025-07-28,6177.56,refund,in,Counterparty_53,20629194.19,,
2025-07-28,716.67,supplier_payment,out,Counterparty_65,20628477.52,2025-06-21,2025-07-20
2025-07-28,6710.32,software_subscription,out,Counterparty_98,20621767.2,2025-07-07,2025-08-07
2025-07-28,2860.67,payroll,out,Counterparty_51,20618906.53,2025-06-28,2025-07-25
2025-07-28,3362.73,asset_sale,in,Counterparty_52,20622269.26,,
2025-07-28,2503.93,investment_income,in,Counterparty_57,20624773.19,,
2025-07-28,2288.59,refund,in,Counterparty_41,20627061.78,,
2025-07-28,9979.07,asset_sale,in,Counterparty_90,20637040.85,,
2025-07-28,3310.5,marketing_spend,out,Counterparty_46,20633730.35,2025-07-02,2025-07-30
2025-07-28,7575.32,refund,in,Counterparty_47,20641305.67,,
2025-07-28,7003.18,credit,in,Counterparty_22,20648308.85,,
2025-07-28,3494.31,T&E,out,Counterparty_38,20644814.54,2025-06-22,2025-07-18
2025-07-28,22.11,credit,in,Counterparty_78,20644836.65,,
2025-07-28,523.5,tax_payment,out,Counterparty_24,20644313.15,2025-06-24,2025-08-02
2025-07-28,1909.83,tax_payment,out,Counterparty_13,20642403.32,2025-06-16,2025-07-18
2025-07-28,5015.42,tax_payment,out,Counterparty_59,20637387.9,2025-06-14,2025-07-23
2025-07-28,1138.21,T&E,out,Counterparty_7,20636249.69,2025-06-14,2025-07-15
2025-07-28,14171.0,customer_payment,in,Counterparty_2,20650420.69,,
2025-07-28,465.55,loan_repayment,out,Counterparty_3,20649955.14,2025-07-10,2025-08-10
2025-07-28,21771.15,asset_sale,in,Counterparty_74,20671726.29,,
2025-07-28,14940.88,credit,in,Counterparty_70,20686667.17,,
2025-07-28,5691.18,customer_payment,in,Counterparty_72,20692358.35,,
2025-07-28,8765.13,asset_sale,in,Counterparty_1,20701123.48,,
2025-07-28,5820.36,supplier_payment,out,Counterparty_2,20695303.12,2025-06-24,2025-07-25
2025-07-28,759.8,refund,in,Counterparty_80,20696062.92,,
2025-07-28,4612.68,asset_sale,in,Counterparty_45,20700675.6,,
2025-07-28,5180.58,credit,in,Counterparty_91,20705856.18,,
2025-07-28,2207.22,asset_sale,in,Counterparty_4,20708063.4,,
2025-07-28,401.73,marketing_spend,out,Counterparty_50,20707661.67,2025-06-23,2025-07-28
2025-07-28,16716.92,T&E,out,Counterparty_19,20690944.75,2025-07-07,2025-08-11
2025-07-28,1071.3,refund,in,Counterparty_82,20692016.05,,
2025-07-28,3353.74,marketing_spend,out,Counterparty_23,20688662.31,2025-07-13,2025-08-12
2025-07-28,7226.38,investment_income,in,Counterparty_65,20695888.69,,
2025-07-28,3378.19,refund,in,Counterparty_11,20699266.88,,
2025-07-28,1664.01,credit,in,Counterparty_14,20700930.89,,
2025-07-28,571.07,customer_payment,in,Counterparty_84,20701501.96,,
2025-07-28,259.43,refund,in,Counterparty_7,20701761.39,,
2025-07-28,1533.12,refund,in,Counterparty_6,20703294.51,,
2025-07-28,417.15,loan_repayment,out,Counterparty_86,20702877.36,2025-07-11,2025-08-07
2025-07-28,11014.85,asset_sale,in,Counterparty_95,20713892.21,,
2025-07-28,5945.09,software_subscription,out,Counterparty_47,20707947.12,2025-06-30,2025-07-30
2025-07-28,1574.63,credit,in,Counterparty_32,20709521.75,,
2025-07-28,5683.22,supplier_payment,out,Counterparty_3,20703838.53,2025-06-30,2025-07-25
2025-07-28,1345.75,asset_sale,in,Counterparty_85,20705184.28,,
2025-07-28,9643.56,refund,in,Counterparty_20,20714827.84,,
2025-07-28,521.13,payroll,out,Counterparty_2,20714306.71,2025-07-13,2025-08-07
2025-07-28,5310.3,asset_sale,in,Counterparty_62,20719617.01,,
2025-07-28,1395.67,marketing_spend,out,Counterparty_61,20718221.34,2025-06-19,2025-07-18
2025-07-28,749.22,T&E,out,Counterparty_98,20717472.12,2025-07-04,2025-08-02
2025-07-28,1727.62,tax_payment,out,Counterparty_10,20715744.5,2025-07-07,2025-08-08
2025-07-28,1334.45,refund,in,Counterparty_53,20717078.95,,
2025-07-28,1343.05,supplier_payment,out,Counterparty_65,20715735.9,2025-06-14,2025-07-22
2025-07-28,1532.99,T&E,out,Counterparty_34,20714202.91,2025-06-14,2025-07-13
2025-07-28,325.44,supplier_payment,out,Counterparty_40,20713877.47,2025-06-28,2025-07-23
2025-07-28,2814.52,software_subscription,out,Counterparty_57,20711062.95,2025-07-07,2025-08-07
2025-07-29,2670.76,investment_income,in,Counterparty_87,20713733.71,,
2025-07-29,5520.34,refund,in,Counterparty_78,20719254.05,,
2025-07-29,596.15,supplier_payment,out,Counterparty_14,20718657.9,2025-06-16,2025-07-19
2025-07-29,6008.05,asset_sale,in,Counterparty_60,20724665.95,,
2025-07-29,5048.25,supplier_payment,out,Counterparty_30,20719617.7,2025-06-27,2025-07-22
2025-07-29,3258.52,asset_sale,in,Counterparty_81,20722876.22,,
2025-07-29,252.19,T&E,out,Counterparty_38,20722624.03,2025-07-05,2025-08-12
2025-07-29,5072.73,payroll,out,Counterparty_81,20717551.3,2025-06-16,2025-07-13
2025-07-29,4327.91,tax_payment,out,Counterparty_10,20713223.39,2025-07-02,2025-08-02
2025-07-29,3942.22,rent,out,Counterparty_97,20709281.17,2025-06-30,2025-07-27
2025-07-29,8513.18,software_subscription,out,Counterparty_54,20700767.99,2025-06-20,2025-07-23
2025-07-29,5871.9,credit,in,Counterparty_88,20706639.89,,
2025-07-29,1857.45,credit,in,Counterparty_85,20708497.34,,
2025-07-29,400.21,marketing_spend,out,Counterparty_20,20708097.13,2025-06-24,2025-07-24
2025-07-29,19374.79,asset_sale,in,Counterparty_59,20727471.92,,
2025-07-29,5101.57,refund,in,Counterparty_51,20732573.49,,
2025-07-29,3244.34,refund,in,Counterparty_26,20735817.83,,
2025-07-29,281.69,asset_sale,in,Counterparty_58,20736099.52,,
2025-07-29,475.22,payroll,out,Counterparty_71,20735624.3,2025-06-21,2025-07-19
2025-07-29,3660.17,tax_payment,out,Counterparty_50,20731964.13,2025-07-06,2025-08-09
2025-07-29,2848.64,investment_income,in,Counterparty_30,20734812.77,,
2025-07-29,4724.98,customer_payment,in,Counterparty_10,20739537.75,,
2025-07-29,10107.24,refund,in,Counterparty_61,20749644.99,,
2025-07-29,11102.14,tax_payment,out,Counterparty_65,20738542.85,2025-07-13,2025-08-17
2025-07-29,3486.4,loan_repayment,out,Counterparty_35,20735056.45,2025-06-19,2025-07-24
2025-07-29,1447.85,software_subscription,out,Counterparty_79,20733608.6,2025-06-29,2025-07-26
2025-07-29,7625.85,T&E,out,Counterparty_63,20725982.75,2025-06-25,2025-08-01
2025-07-29,1255.8,investment_income,in,Counterparty_79,20727238.55,,
2025-07-29,483.43,investment_income,in,Counterparty_93,20727721.98,,
2025-07-29,8648.58,investment_income,in,Counterparty_29,20736370.56,,
2025-07-29,98.19,asset_sale,in,Counterparty_69,20736468.75,,
2025-07-29,15262.05,investment_income,in,Counterparty_76,20751730.8,,
2025-07-29,3609.75,refund,in,Counterparty_55,20755340.55,,
2025-07-29,222.53,T&E,out,Counterparty_15,20755118.02,2025-07-07,2025-08-05
2025-07-29,637.44,investment_income,in,Counterparty_19,20755755.46,,
2025-07-29,8257.65,investment_income,in,Counterparty_41,20764013.11,,
2025-07-29,589.13,investment_income,in,Counterparty_87,20764602.24,,
2025-07-29,11478.86,marketing_spend,out,Counterparty_41,20753123.38,2025-06-16,2025-07-13
2025-07-29,7983.56,investment_income,in,Counterparty_80,20761106.94,,
2025-07-29,3134.08,investment_income,in,Counterparty_58,20764241.02,,
2025-07-29,7196.7,asset_sale,in,Counterparty_59,20771437.72,,
2025-07-29,1939.6,payroll,out,Counterparty_60,20769498.12,2025-07-05,2025-08-03
2025-07-29,2586.65,payroll,out,Counterparty_66,20766911.47,2025-06-30,2025-08-01
2025-07-29,12944.55,marketing_spend,out,Counterparty_21,20753966.92,2025-07-12,2025-08-15
2025-07-29,17982.69,payroll,out,Counterparty_40,20735984.23,2025-06-26,2025-08-01
2025-07-29,7212.51,supplier_payment,out,Counterparty_25,20728771.72,2025-07-03,2025-07-28
2025-07-29,1133.38,investment_income,in,Counterparty_61,20729905.1,,
2025-07-29,4571.14,customer_payment,in,Counterparty_58,20734476.24,,
2025-07-29,14187.24,software_subscription,out,Counterparty_60,20720289.0,2025-07-06,2025-08-14
2025-07-29,7810.77,payroll,out,Counterparty_14,20712478.23,2025-06-26,2025-07-25
2025-07-29,906.04,refund,in,Counterparty_30,20713384.27,,
2025-07-29,12480.62,asset_sale,in,Counterparty_51,20725864.89,,
2025-07-29,1850.11,investment_income,in,Counterparty_6,20727715.0,,
2025-07-29,5698.33,supplier_payment,out,Counterparty_73,20722016.67,2025-07-08,2025-08-14
2025-07-29,11298.51,supplier_payment,out,Counterparty_30,20710718.16,2025-06-22,2025-07-18
2025-07-30,717.66,asset_sale,in,Counterparty_68,20711435.82,,
2025-07-30,9618.34,software_subscription,out,Counterparty_24,20701817.48,2025-06-29,2025-08-01
2025-07-30,6484.11,rent,out,Counterparty_12,20695333.37,2025-07-07,2025-08-08
2025-07-30,1011.0,utilities,out,Counterparty_73,20694322.37,2025-07-02,2025-08-10
2025-07-30,13745.64,refund,in,Counterparty_6,20708068.01,,
2025-07-30,10337.86,utilities,out,Counterparty_73,20697730.15,2025-06-21,2025-07-17
2025-07-30,213.15,payroll,out,Counterparty_74,20697517.0,2025-06-19,2025-07-26
2025-07-30,5122.02,software_subscription,out,Counterparty_1,20692394.98,2025-07-06,2025-08-13
2025-07-30,2357.97,customer_payment,in,Counterparty_38,20694752.95,,
2025-07-30,1169.32,tax_payment,out,Counterparty_47,20693583.63,2025-07-09,2025-08-08
2025-07-30,6334.36,customer_payment,in,Counterparty_86,20699917.99,,
2025-07-30,1305.33,tax_payment,out,Counterparty_46,20698612.66,2025-07-09,2025-08-10
2025-07-30,2992.85,credit,in,Counterparty_63,20701605.51,,
2025-07-30,795.13,loan_repayment,out,Counterparty_92,20700810.38,2025-07-02,2025-08-07
2025-07-30,531.3,marketing_spend,out,Counterparty_20,20700279.08,2025-07-05,2025-08-09
2025-07-30,8838.79,investment_income,in,Counterparty_32,20709117.87,,
2025-07-30,5136.83,tax_payment,out,Counterparty_97,20703981.04,2025-06-22,2025-07-20
2025-07-30,1052.56,refund,in,Counterparty_98,20705033.6,,
2025-07-30,2440.64,credit,in,Counterparty_67,20707474.24,,
2025-07-30,6305.92,marketing_spend,out,Counterparty_52,20701168.32,2025-06-30,2025-08-04
2025-07-30,4512.25,customer_payment,in,Counterparty_6,20705680.57,,
2025-07-30,1790.29,credit,in,Counterparty_75,20707470.86,,
2025-07-30,3609.82,customer_payment,in,Counterparty_6,20711080.68,,
2025-07-30,2254.74,tax_payment,out,Counterparty_35,20708825.94,2025-07-15,2025-08-19
2025-07-30,17644.58,investment_income,in,Counterparty_83,20726470.52,,
2025-07-30,6217.91,credit,in,Counterparty_59,20732688.43,,
2025-07-30,3213.36,supplier_payment,out,Counterparty_8,20729475.07,2025-07-08,2025-08-07
2025-07-30,2563.87,rent,out,Counterparty_94,20726911.2,2025-07-04,2025-08-09
2025-07-30,2648.89,tax_payment,out,Counterparty_81,20724262.31,2025-06-29,2025-08-01
2025-07-30,12844.48,credit,in,Counterparty_16,20737106.79,,
2025-07-30,2622.85,asset_sale,in,Counterparty_67,20739729.64,,
2025-07-30,4832.64,refund,in,Counterparty_18,20744562.28,,
2025-07-30,21770.61,tax_payment,out,Counterparty_22,20722791.67,2025-06-19,2025-07-19
2025-07-30,392.52,refund,in,Counterparty_59,20723184.19,,
2025-07-30,591.23,marketing_spend,out,Counterparty_43,20722592.96,2025-06-16,2025-07-19
2025-07-30,2700.49,T&E,out,Counterparty_42,20719892.47,2025-07-02,2025-08-05
2025-07-30,4398.14,tax_payment,out,Counterparty_32,20715494.33,2025-07-05,2025-08-12
2025-07-30,1226.3,asset_sale,in,Counterparty_10,20716720.63,,
2025-07-30,5061.4,T&E,out,Counterparty_92,20711659.23,2025-06-27,2025-08-04
2025-07-30,970.79,credit,in,Counterparty_25,20712630.02,,
2025-07-30,354.84,tax_payment,out,Counterparty_77,20712275.18,2025-06-24,2025-07-24
2025-07-30,742.7,refund,in,Counterparty_45,20713017.88,,
2025-07-30,467.75,asset_sale,in,Counterparty_1,20713485.63,,
2025-07-30,14542.73,marketing_spend,out,Counterparty_64,20698942.9,2025-06-20,2025-07-21
2025-07-30,3598.97,investment_income,in,Counterparty_49,20702541.87,,
2025-07-30,4555.64,utilities,out,Counterparty_99,20697986.23,2025-06-25,2025-07-21
2025-07-30,5724.31,rent,out,Counterparty_16,20692261.92,2025-07-15,2025-08-17
2025-07-30,41.52,asset_sale,in,Counterparty_19,20692303.44,,
2025-07-31,1047.43,T&E,out,Counterparty_9,20691256.01,2025-06-24,2025-07-19
2025-07-31,7881.69,investment_income,in,Counterparty_50,20699137.7,,
2025-07-31,49.62,asset_sale,in,Counterparty_47,20699187.32,,
2025-07-31,12588.47,supplier_payment,out,Counterparty_78,20686598.85,2025-06-22,2025-07-19
2025-07-31,5279.64,investment_income,in,Counterparty_30,20691878.49,,
2025-07-31,1052.19,asset_sale,in,Counterparty_13,20692930.68,,
2025-07-31,1878.42,tax_payment,out,Counterparty_75,20691052.26,2025-06-17,2025-07-20
2025-07-31,5844.37,software_subscription,out,Counterparty_62,20685207.89,2025-07-15,2025-08-12
2025-07-31,9772.43,rent,out,Counterparty_46,20675435.46,2025-07-15,2025-08-14
2025-07-31,6846.5,refund,in,Counterparty_11,20682281.96,,
2025-07-31,4715.01,loan_repayment,out,Counterparty_9,20677566.95,2025-07-02,2025-07-30
2025-07-31,3151.47,marketing_spend,out,Counterparty_55,20674415.48,2025-07-14,2025-08-20
2025-07-31,712.75,utilities,out,Counterparty_81,20673702.73,2025-07-11,2025-08-15
2025-07-31,4224.48,investment_income,in,Counterparty_52,20677927.21,,
2025-07-31,625.04,loan_repayment,out,Counterparty_40,20677302.17,2025-07-02,2025-07-28
2025-07-31,3104.3,marketing_spend,out,Counterparty_36,20674197.87,2025-07-12,2025-08-07
2025-07-31,1010.99,supplier_payment,out,Counterparty_92,20673186.88,2025-06-24,2025-07-19
2025-07-31,20343.42,investment_income,in,Counterparty_41,20693530.3,,
2025-07-31,4694.52,tax_payment,out,Counterparty_27,20688835.78,2025-07-15,2025-08-11
2025-07-31,6826.5,marketing_spend,out,Counterparty_36,20682009.28,2025-06-26,2025-07-29
2025-07-31,447.31,loan_repayment,out,Counterparty_10,20681561.97,2025-06-20,2025-07-25
2025-07-31,1107.97,refund,in,Counterparty_61,20682669.94,,
2025-07-31,12043.29,asset_sale,in,Counterparty_65,20694713.23,,
2025-07-31,279.39,payroll,out,Counterparty_75,20694433.84,2025-06-22,2025-07-26
2025-07-31,7963.31,utilities,out,Counterparty_58,20686470.53,2025-06-29,2025-07-29
2025-07-31,4463.06,refund,in,Counterparty_79,20690933.59,,
2025-07-31,2100.07,tax_payment,out,Counterparty_40,20688833.52,2025-06-19,2025-07-27
2025-07-31,4385.1,tax_payment,out,Counterparty_1,20684448.42,2025-07-13,2025-08-19
2025-07-31,5009.6,utilities,out,Counterparty_3,20679438.82,2025-06-27,2025-08-05
2025-07-31,1708.09,refund,in,Counterparty_20,20681146.91,,
2025-07-31,8798.64,refund,in,Counterparty_68,20689945.55,,
2025-07-31,5617.68,marketing_spend,out,Counterparty_82,20684327.87,2025-06-25,2025-07-25
2025-07-31,1215.79,asset_sale,in,Counterparty_36,20685543.66,,
2025-07-31,13077.68,tax_payment,out,Counterparty_95,20672465.98,2025-07-04,2025-08-03
2025-07-31,1305.22,asset_sale,in,Counterparty_71,20673771.2,,
2025-07-31,7460.31,payroll,out,Counterparty_68,20666310.89,2025-07-02,2025-08-01
2025-07-31,4867.09,software_subscription,out,Counterparty_76,20661443.8,2025-07-02,2025-08-08
2025-07-31,957.54,credit,in,Counterparty_95,20662401.34,,
2025-07-31,226.83,supplier_payment,out,Counterparty_9,20662174.51,2025-06-18,2025-07-20
2025-07-31,33.72,rent,out,Counterparty_45,20662140.79,2025-06-22,2025-07-25
2025-07-31,1027.7,credit,in,Counterparty_19,20663168.49,,
2025-07-31,2699.86,refund,in,Counterparty_14,20665868.35,,
2025-07-31,318.06,payroll,out,Counterparty_98,20665550.29,2025-06-19,2025-07-23
2025-07-31,1507.39,refund,in,Counterparty_84,20667057.68,,
